instant,dteday,season,yr,mnth,hr,holiday,weekday,workingday,weathersit,temp,atemp,hum,windspeed,casual,casual_cost,registered,registered_cost,cnt,total_rev
1,2011-01-01,1,0,1,0,0,6,0,1,0.24,0.2879,0.81,0.0,3,45,13,130,16,175
2,2011-01-01,1,0,1,1,0,6,0,1,0.22,0.2727,0.8,0.0,8,120,32,320,40,440
3,2011-01-01,1,0,1,2,0,6,0,1,0.22,0.2727,0.8,0.0,5,75,27,270,32,345
4,2011-01-01,1,0,1,3,0,6,0,1,0.24,0.2879,0.75,0.0,3,45,10,100,13,145
5,2011-01-01,1,0,1,4,0,6,0,1,0.24,0.2879,0.75,0.0,0,0,1,10,1,10
6,2011-01-01,1,0,1,5,0,6,0,2,0.24,0.2576,0.75,0.0896,0,0,1,10,1,10
7,2011-01-01,1,0,1,6,0,6,0,1,0.22,0.2727,0.8,0.0,2,30,0,0,2,30
8,2011-01-01,1,0,1,7,0,6,0,1,0.2,0.2576,0.86,0.0,1,15,2,20,3,35
9,2011-01-01,1,0,1,8,0,6,0,1,0.24,0.2879,0.75,0.0,1,15,7,70,8,85
10,2011-01-01,1,0,1,9,0,6,0,1,0.32,0.3485,0.76,0.0,8,120,6,60,14,180
11,2011-01-01,1,0,1,10,0,6,0,1,0.38,0.3939,0.76,0.2537,12,180,24,240,36,420
12,2011-01-01,1,0,1,11,0,6,0,1,0.36,0.3333,0.81,0.2836,26,390,30,300,56,690
13,2011-01-01,1,0,1,12,0,6,0,1,0.42,0.4242,0.77,0.2836,29,435,55,550,84,985
14,2011-01-01,1,0,1,13,0,6,0,2,0.46,0.4545,0.72,0.2985,47,705,47,470,94,1175
15,2011-01-01,1,0,1,14,0,6,0,2,0.46,0.4545,0.72,0.2836,35,525,71,710,106,1235
16,2011-01-01,1,0,1,15,0,6,0,2,0.44,0.4394,0.77,0.2985,40,600,70,700,110,1300
17,2011-01-01,1,0,1,16,0,6,0,2,0.42,0.4242,0.82,0.2985,41,615,52,520,93,1135
18,2011-01-01,1,0,1,17,0,6,0,2,0.44,0.4394,0.82,0.2836,15,225,52,520,67,745
19,2011-01-01,1,0,1,18,0,6,0,3,0.42,0.4242,0.88,0.2537,9,135,26,260,35,395
20,2011-01-01,1,0,1,19,0,6,0,3,0.42,0.4242,0.88,0.2537,6,90,31,310,37,400
21,2011-01-01,1,0,1,20,0,6,0,2,0.4,0.4091,0.87,0.2537,11,165,25,250,36,415
22,2011-01-01,1,0,1,21,0,6,0,2,0.4,0.4091,0.87,0.194,3,45,31,310,34,355
23,2011-01-01,1,0,1,22,0,6,0,2,0.4,0.4091,0.94,0.2239,11,165,17,170,28,335
24,2011-01-01,1,0,1,23,0,6,0,2,0.46,0.4545,0.88,0.2985,15,225,24,240,39,465
25,2011-01-02,1,0,1,0,0,0,0,2,0.46,0.4545,0.88,0.2985,4,60,13,130,17,190
26,2011-01-02,1,0,1,1,0,0,0,2,0.44,0.4394,0.94,0.2537,1,15,16,160,17,175
27,2011-01-02,1,0,1,2,0,0,0,2,0.42,0.4242,1.0,0.2836,1,15,8,80,9,95
28,2011-01-02,1,0,1,3,0,0,0,2,0.46,0.4545,0.94,0.194,2,30,4,40,6,70
29,2011-01-02,1,0,1,4,0,0,0,2,0.46,0.4545,0.94,0.194,2,30,1,10,3,40
30,2011-01-02,1,0,1,6,0,0,0,3,0.42,0.4242,0.77,0.2985,0,0,2,20,2,20
31,2011-01-02,1,0,1,7,0,0,0,2,0.4,0.4091,0.76,0.194,0,0,1,10,1,10
32,2011-01-02,1,0,1,8,0,0,0,3,0.4,0.4091,0.71,0.2239,0,0,8,80,8,80
33,2011-01-02,1,0,1,9,0,0,0,2,0.38,0.3939,0.76,0.2239,1,15,19,190,20,205
34,2011-01-02,1,0,1,10,0,0,0,2,0.36,0.3485,0.81,0.2239,7,105,46,460,53,565
35,2011-01-02,1,0,1,11,0,0,0,2,0.36,0.3333,0.71,0.2537,16,240,54,540,70,780
36,2011-01-02,1,0,1,12,0,0,0,2,0.36,0.3333,0.66,0.2985,20,300,73,730,93,1030
37,2011-01-02,1,0,1,13,0,0,0,2,0.36,0.3485,0.66,0.1343,11,165,64,640,75,805
38,2011-01-02,1,0,1,14,0,0,0,3,0.36,0.3485,0.76,0.194,4,60,55,550,59,610
39,2011-01-02,1,0,1,15,0,0,0,3,0.34,0.3333,0.81,0.1642,19,285,55,550,74,835
40,2011-01-02,1,0,1,16,0,0,0,3,0.34,0.3333,0.71,0.1642,9,135,67,670,76,805
41,2011-01-02,1,0,1,17,0,0,0,1,0.34,0.3333,0.57,0.194,7,105,58,580,65,685
42,2011-01-02,1,0,1,18,0,0,0,2,0.36,0.3333,0.46,0.3284,10,150,43,430,53,580
43,2011-01-02,1,0,1,19,0,0,0,1,0.32,0.2879,0.42,0.4478,1,15,29,290,30,305
44,2011-01-02,1,0,1,20,0,0,0,1,0.3,0.2727,0.39,0.3582,5,75,17,170,22,245
45,2011-01-02,1,0,1,21,0,0,0,1,0.26,0.2273,0.44,0.3284,11,165,20,200,31,365
46,2011-01-02,1,0,1,22,0,0,0,1,0.24,0.2121,0.44,0.2985,0,0,9,90,9,90
47,2011-01-02,1,0,1,23,0,0,0,1,0.22,0.2273,0.47,0.1642,0,0,8,80,8,80
48,2011-01-03,1,0,1,0,0,1,1,1,0.22,0.197,0.44,0.3582,0,0,5,50,5,50
49,2011-01-03,1,0,1,1,0,1,1,1,0.2,0.1667,0.44,0.4179,0,0,2,20,2,20
50,2011-01-03,1,0,1,4,0,1,1,1,0.16,0.1364,0.47,0.3881,0,0,1,10,1,10
51,2011-01-03,1,0,1,5,0,1,1,1,0.16,0.1364,0.47,0.2836,0,0,3,30,3,30
52,2011-01-03,1,0,1,6,0,1,1,1,0.14,0.1061,0.5,0.3881,0,0,30,300,30,300
53,2011-01-03,1,0,1,7,0,1,1,1,0.14,0.1364,0.5,0.194,1,15,63,630,64,645
54,2011-01-03,1,0,1,8,0,1,1,1,0.14,0.1212,0.5,0.2836,1,15,153,1530,154,1545
55,2011-01-03,1,0,1,9,0,1,1,1,0.16,0.1364,0.43,0.3881,7,105,81,810,88,915
56,2011-01-03,1,0,1,10,0,1,1,1,0.18,0.1667,0.43,0.2537,11,165,33,330,44,495
57,2011-01-03,1,0,1,11,0,1,1,1,0.2,0.1818,0.4,0.3284,10,150,41,410,51,560
58,2011-01-03,1,0,1,12,0,1,1,1,0.22,0.2121,0.35,0.2985,13,195,48,480,61,675
59,2011-01-03,1,0,1,13,0,1,1,1,0.24,0.2121,0.35,0.2836,8,120,53,530,61,650
60,2011-01-03,1,0,1,14,0,1,1,1,0.26,0.2424,0.3,0.2836,11,165,66,660,77,825
61,2011-01-03,1,0,1,15,0,1,1,1,0.26,0.2424,0.3,0.2537,14,210,58,580,72,790
62,2011-01-03,1,0,1,16,0,1,1,1,0.26,0.2424,0.3,0.2537,9,135,67,670,76,805
63,2011-01-03,1,0,1,17,0,1,1,1,0.24,0.2273,0.3,0.2239,11,165,146,1460,157,1625
64,2011-01-03,1,0,1,18,0,1,1,1,0.24,0.2576,0.32,0.1045,9,135,148,1480,157,1615
65,2011-01-03,1,0,1,19,0,1,1,1,0.2,0.2576,0.47,0.0,8,120,102,1020,110,1140
66,2011-01-03,1,0,1,20,0,1,1,1,0.2,0.2273,0.47,0.1045,3,45,49,490,52,535
67,2011-01-03,1,0,1,21,0,1,1,1,0.18,0.197,0.64,0.1343,3,45,49,490,52,535
68,2011-01-03,1,0,1,22,0,1,1,1,0.14,0.1515,0.69,0.1343,0,0,20,200,20,200
69,2011-01-03,1,0,1,23,0,1,1,1,0.18,0.2121,0.55,0.1045,1,15,11,110,12,125
70,2011-01-04,1,0,1,0,0,2,1,1,0.16,0.1818,0.55,0.1045,0,0,5,50,5,50
71,2011-01-04,1,0,1,1,0,2,1,1,0.16,0.1818,0.59,0.1045,0,0,2,20,2,20
72,2011-01-04,1,0,1,2,0,2,1,1,0.14,0.1515,0.63,0.1343,0,0,1,10,1,10
73,2011-01-04,1,0,1,4,0,2,1,1,0.14,0.1818,0.63,0.0896,0,0,2,20,2,20
74,2011-01-04,1,0,1,5,0,2,1,1,0.12,0.1515,0.68,0.1045,0,0,4,40,4,40
75,2011-01-04,1,0,1,6,0,2,1,1,0.12,0.1515,0.74,0.1045,0,0,36,360,36,360
76,2011-01-04,1,0,1,7,0,2,1,1,0.12,0.1515,0.74,0.1343,2,30,92,920,94,950
77,2011-01-04,1,0,1,8,0,2,1,1,0.14,0.1515,0.69,0.1642,2,30,177,1770,179,1800
78,2011-01-04,1,0,1,9,0,2,1,1,0.16,0.1515,0.64,0.2239,2,30,98,980,100,1010
79,2011-01-04,1,0,1,10,0,2,1,2,0.16,0.1364,0.69,0.3284,5,75,37,370,42,445
80,2011-01-04,1,0,1,11,0,2,1,1,0.22,0.2121,0.51,0.2985,7,105,50,500,57,605
81,2011-01-04,1,0,1,12,0,2,1,1,0.22,0.2273,0.51,0.1642,12,180,66,660,78,840
82,2011-01-04,1,0,1,13,0,2,1,1,0.24,0.2273,0.56,0.194,18,270,79,790,97,1060
83,2011-01-04,1,0,1,14,0,2,1,1,0.26,0.2576,0.52,0.2239,9,135,54,540,63,675
84,2011-01-04,1,0,1,15,0,2,1,1,0.28,0.2727,0.52,0.2537,17,255,48,480,65,735
85,2011-01-04,1,0,1,16,0,2,1,1,0.3,0.2879,0.49,0.2537,15,225,68,680,83,905
86,2011-01-04,1,0,1,17,0,2,1,1,0.28,0.2727,0.48,0.2239,10,150,202,2020,212,2170
87,2011-01-04,1,0,1,18,0,2,1,1,0.26,0.2576,0.48,0.194,3,45,179,1790,182,1835
88,2011-01-04,1,0,1,19,0,2,1,1,0.24,0.2576,0.48,0.1045,2,30,110,1100,112,1130
89,2011-01-04,1,0,1,20,0,2,1,1,0.24,0.2576,0.48,0.1045,1,15,53,530,54,545
90,2011-01-04,1,0,1,21,0,2,1,1,0.22,0.2727,0.64,0.0,0,0,48,480,48,480
91,2011-01-04,1,0,1,22,0,2,1,1,0.22,0.2576,0.64,0.0896,1,15,34,340,35,355
92,2011-01-04,1,0,1,23,0,2,1,1,0.2,0.2273,0.69,0.0896,2,30,9,90,11,120
93,2011-01-05,1,0,1,0,0,3,1,1,0.2,0.2576,0.64,0.0,0,0,6,60,6,60
94,2011-01-05,1,0,1,1,0,3,1,1,0.16,0.197,0.74,0.0896,0,0,6,60,6,60
95,2011-01-05,1,0,1,2,0,3,1,1,0.16,0.197,0.74,0.0896,0,0,2,20,2,20
96,2011-01-05,1,0,1,4,0,3,1,1,0.24,0.2273,0.48,0.2239,0,0,2,20,2,20
97,2011-01-05,1,0,1,5,0,3,1,1,0.22,0.2273,0.47,0.1642,0,0,3,30,3,30
98,2011-01-05,1,0,1,6,0,3,1,1,0.2,0.197,0.47,0.2239,0,0,33,330,33,330
99,2011-01-05,1,0,1,7,0,3,1,1,0.18,0.1818,0.43,0.194,1,15,87,870,88,885
100,2011-01-05,1,0,1,8,0,3,1,1,0.2,0.1818,0.4,0.2985,3,45,192,1920,195,1965
101,2011-01-05,1,0,1,9,0,3,1,1,0.22,0.197,0.37,0.3284,6,90,109,1090,115,1180
102,2011-01-05,1,0,1,10,0,3,1,1,0.22,0.197,0.37,0.3284,4,60,53,530,57,590
103,2011-01-05,1,0,1,11,0,3,1,1,0.26,0.2273,0.33,0.3284,12,180,34,340,46,520
104,2011-01-05,1,0,1,12,0,3,1,1,0.26,0.2273,0.33,0.3284,5,75,74,740,79,815
105,2011-01-05,1,0,1,13,0,3,1,1,0.28,0.2576,0.3,0.2985,6,90,65,650,71,740
106,2011-01-05,1,0,1,14,0,3,1,1,0.3,0.2879,0.28,0.194,10,150,52,520,62,670
107,2011-01-05,1,0,1,15,0,3,1,1,0.3,0.2879,0.28,0.194,7,105,55,550,62,655
108,2011-01-05,1,0,1,16,0,3,1,1,0.3,0.3182,0.28,0.0896,4,60,85,850,89,910
109,2011-01-05,1,0,1,17,0,3,1,1,0.24,0.2273,0.38,0.194,4,60,186,1860,190,1920
110,2011-01-05,1,0,1,18,0,3,1,1,0.24,0.2424,0.38,0.1343,3,45,166,1660,169,1705
111,2011-01-05,1,0,1,19,0,3,1,1,0.24,0.2576,0.38,0.1045,5,75,127,1270,132,1345
112,2011-01-05,1,0,1,20,0,3,1,1,0.22,0.2273,0.47,0.1642,7,105,82,820,89,925
113,2011-01-05,1,0,1,21,0,3,1,1,0.2,0.197,0.51,0.194,3,45,40,400,43,445
114,2011-01-05,1,0,1,22,0,3,1,1,0.18,0.197,0.55,0.1343,1,15,41,410,42,425
115,2011-01-05,1,0,1,23,0,3,1,1,0.2,0.2576,0.47,0.0,1,15,18,180,19,195
116,2011-01-06,1,0,1,0,0,4,1,1,0.18,0.2424,0.55,0.0,0,0,11,110,11,110
117,2011-01-06,1,0,1,1,0,4,1,1,0.16,0.2273,0.64,0.0,0,0,4,40,4,40
118,2011-01-06,1,0,1,2,0,4,1,1,0.16,0.2273,0.64,0.0,0,0,2,20,2,20
119,2011-01-06,1,0,1,4,0,4,1,2,0.16,0.197,0.64,0.0896,0,0,1,10,1,10
120,2011-01-06,1,0,1,5,0,4,1,2,0.14,0.1818,0.69,0.0896,0,0,4,40,4,40
121,2011-01-06,1,0,1,6,0,4,1,2,0.14,0.1667,0.63,0.1045,0,0,36,360,36,360
122,2011-01-06,1,0,1,7,0,4,1,2,0.16,0.2273,0.59,0.0,0,0,95,950,95,950
123,2011-01-06,1,0,1,8,0,4,1,1,0.16,0.2273,0.59,0.0,3,45,216,2160,219,2205
124,2011-01-06,1,0,1,9,0,4,1,2,0.18,0.2424,0.51,0.0,6,90,116,1160,122,1250
125,2011-01-06,1,0,1,10,0,4,1,1,0.2,0.2576,0.47,0.0,3,45,42,420,45,465
126,2011-01-06,1,0,1,11,0,4,1,1,0.22,0.2576,0.44,0.0896,2,30,57,570,59,600
127,2011-01-06,1,0,1,12,0,4,1,1,0.26,0.2879,0.35,0.0,6,90,78,780,84,870
128,2011-01-06,1,0,1,13,0,4,1,1,0.26,0.2727,0.35,0.1045,12,180,55,550,67,730
129,2011-01-06,1,0,1,14,0,4,1,1,0.28,0.2727,0.36,0.1642,11,165,59,590,70,755
130,2011-01-06,1,0,1,15,0,4,1,1,0.28,0.2727,0.36,0.0,8,120,54,540,62,660
131,2011-01-06,1,0,1,16,0,4,1,1,0.26,0.2576,0.38,0.1642,12,180,74,740,86,920
132,2011-01-06,1,0,1,17,0,4,1,1,0.22,0.2273,0.51,0.1642,9,135,163,1630,172,1765
133,2011-01-06,1,0,1,18,0,4,1,1,0.22,0.2273,0.51,0.1343,5,75,158,1580,163,1655
134,2011-01-06,1,0,1,19,0,4,1,1,0.22,0.2576,0.55,0.0896,3,45,109,1090,112,1135
135,2011-01-06,1,0,1,20,0,4,1,1,0.2,0.2121,0.51,0.1642,3,45,66,660,69,705
136,2011-01-06,1,0,1,21,0,4,1,2,0.22,0.2121,0.55,0.2239,0,0,48,480,48,480
137,2011-01-06,1,0,1,22,0,4,1,2,0.22,0.2121,0.51,0.2836,1,15,51,510,52,525
138,2011-01-06,1,0,1,23,0,4,1,2,0.2,0.197,0.59,0.194,4,60,19,190,23,250
139,2011-01-07,1,0,1,0,0,5,1,2,0.2,0.197,0.64,0.194,4,60,13,130,17,190
140,2011-01-07,1,0,1,1,0,5,1,2,0.2,0.197,0.69,0.2239,2,30,5,50,7,80
141,2011-01-07,1,0,1,2,0,5,1,2,0.2,0.197,0.69,0.2239,0,0,1,10,1,10
142,2011-01-07,1,0,1,4,0,5,1,2,0.2,0.2121,0.69,0.1343,0,0,1,10,1,10
143,2011-01-07,1,0,1,5,0,5,1,3,0.22,0.2727,0.55,0.0,0,0,5,50,5,50
144,2011-01-07,1,0,1,6,0,5,1,2,0.2,0.2576,0.69,0.0,8,120,26,260,34,380
145,2011-01-07,1,0,1,7,0,5,1,1,0.2,0.2121,0.69,0.1343,8,120,76,760,84,880
146,2011-01-07,1,0,1,8,0,5,1,1,0.2,0.197,0.51,0.2537,20,300,190,1900,210,2200
147,2011-01-07,1,0,1,9,0,5,1,1,0.2,0.1818,0.47,0.2985,9,135,125,1250,134,1385
148,2011-01-07,1,0,1,10,0,5,1,1,0.22,0.197,0.37,0.3284,16,240,47,470,63,710
149,2011-01-07,1,0,1,11,0,5,1,2,0.2,0.197,0.4,0.2239,19,285,48,480,67,765
150,2011-01-07,1,0,1,12,0,5,1,2,0.2,0.197,0.37,0.2537,9,135,50,500,59,635
151,2011-01-07,1,0,1,13,0,5,1,2,0.2,0.1818,0.37,0.2836,9,135,64,640,73,775
152,2011-01-07,1,0,1,14,0,5,1,2,0.2,0.197,0.4,0.2537,7,105,43,430,50,535
153,2011-01-07,1,0,1,15,0,5,1,2,0.2,0.2121,0.37,0.1642,9,135,63,630,72,765
154,2011-01-07,1,0,1,16,0,5,1,2,0.2,0.2121,0.37,0.1642,5,75,82,820,87,895
155,2011-01-07,1,0,1,17,0,5,1,2,0.2,0.2576,0.37,0.0,9,135,178,1780,187,1915
156,2011-01-07,1,0,1,18,0,5,1,1,0.2,0.2273,0.4,0.0896,7,105,116,1160,123,1265
157,2011-01-07,1,0,1,19,0,5,1,1,0.16,0.197,0.55,0.0896,3,45,92,920,95,965
158,2011-01-07,1,0,1,20,0,5,1,1,0.18,0.2121,0.47,0.1045,1,15,50,500,51,515
159,2011-01-07,1,0,1,21,0,5,1,1,0.18,0.197,0.47,0.1343,0,0,39,390,39,390
160,2011-01-07,1,0,1,22,0,5,1,2,0.18,0.197,0.43,0.1642,2,30,34,340,36,370
161,2011-01-07,1,0,1,23,0,5,1,2,0.18,0.197,0.51,0.1642,1,15,14,140,15,155
162,2011-01-08,1,0,1,0,0,6,0,2,0.18,0.197,0.51,0.1642,1,15,24,240,25,255
163,2011-01-08,1,0,1,1,0,6,0,2,0.18,0.2121,0.55,0.0896,1,15,15,150,16,165
164,2011-01-08,1,0,1,2,0,6,0,2,0.18,0.2424,0.55,0.0,3,45,13,130,16,175
165,2011-01-08,1,0,1,3,0,6,0,3,0.18,0.197,0.55,0.1642,0,0,7,70,7,70
166,2011-01-08,1,0,1,4,0,6,0,3,0.18,0.197,0.55,0.1642,0,0,1,10,1,10
167,2011-01-08,1,0,1,5,0,6,0,2,0.16,0.1667,0.74,0.1642,0,0,5,50,5,50
168,2011-01-08,1,0,1,6,0,6,0,2,0.16,0.1667,0.74,0.1642,0,0,2,20,2,20
169,2011-01-08,1,0,1,7,0,6,0,2,0.16,0.1818,0.74,0.1045,1,15,8,80,9,95
170,2011-01-08,1,0,1,8,0,6,0,3,0.16,0.1818,0.93,0.1045,0,0,15,150,15,150
171,2011-01-08,1,0,1,9,0,6,0,3,0.16,0.1818,0.93,0.1045,0,0,20,200,20,200
172,2011-01-08,1,0,1,10,0,6,0,2,0.18,0.197,0.8,0.1642,5,75,56,560,61,635
173,2011-01-08,1,0,1,11,0,6,0,2,0.2,0.1818,0.69,0.3881,2,30,60,600,62,630
174,2011-01-08,1,0,1,12,0,6,0,2,0.2,0.1818,0.59,0.3582,8,120,90,900,98,1020
175,2011-01-08,1,0,1,13,0,6,0,1,0.2,0.1818,0.44,0.3284,7,105,95,950,102,1055
176,2011-01-08,1,0,1,14,0,6,0,1,0.2,0.1667,0.32,0.4925,12,180,83,830,95,1010
177,2011-01-08,1,0,1,15,0,6,0,1,0.2,0.1667,0.32,0.4478,5,75,69,690,74,765
178,2011-01-08,1,0,1,16,0,6,0,1,0.18,0.1364,0.29,0.4478,8,120,68,680,76,800
179,2011-01-08,1,0,1,17,0,6,0,1,0.16,0.1212,0.37,0.5522,5,75,64,640,69,715
180,2011-01-08,1,0,1,18,0,6,0,1,0.14,0.1212,0.39,0.2985,3,45,52,520,55,565
181,2011-01-08,1,0,1,19,0,6,0,1,0.14,0.1212,0.36,0.2537,4,60,26,260,30,320
182,2011-01-08,1,0,1,20,0,6,0,1,0.12,0.1212,0.36,0.2537,0,0,28,280,28,280
183,2011-01-08,1,0,1,21,0,6,0,1,0.12,0.1061,0.39,0.3582,2,30,35,350,37,380
184,2011-01-08,1,0,1,22,0,6,0,1,0.12,0.1061,0.36,0.3881,1,15,33,330,34,345
185,2011-01-08,1,0,1,23,0,6,0,1,0.1,0.0606,0.39,0.4478,0,0,22,220,22,220
186,2011-01-09,1,0,1,0,0,0,0,1,0.1,0.0758,0.42,0.3881,1,15,24,240,25,255
187,2011-01-09,1,0,1,1,0,0,0,1,0.1,0.0606,0.42,0.4627,0,0,12,120,12,120
188,2011-01-09,1,0,1,2,0,0,0,1,0.1,0.0606,0.46,0.4627,0,0,11,110,11,110
189,2011-01-09,1,0,1,3,0,0,0,1,0.1,0.0758,0.46,0.4179,0,0,4,40,4,40
190,2011-01-09,1,0,1,4,0,0,0,1,0.08,0.0909,0.53,0.194,0,0,1,10,1,10
191,2011-01-09,1,0,1,5,0,0,0,1,0.08,0.0909,0.53,0.194,0,0,1,10,1,10
192,2011-01-09,1,0,1,6,0,0,0,1,0.1,0.0909,0.49,0.2836,0,0,1,10,1,10
193,2011-01-09,1,0,1,7,0,0,0,1,0.08,0.0909,0.53,0.194,1,15,5,50,6,65
194,2011-01-09,1,0,1,8,0,0,0,1,0.1,0.0909,0.49,0.2836,0,0,10,100,10,100
195,2011-01-09,1,0,1,9,0,0,0,1,0.12,0.0758,0.46,0.5224,0,0,19,190,19,190
196,2011-01-09,1,0,1,10,0,0,0,1,0.14,0.1061,0.43,0.3881,0,0,49,490,49,490
197,2011-01-09,1,0,1,11,0,0,0,1,0.16,0.1212,0.4,0.5224,2,30,47,470,49,500
198,2011-01-09,1,0,1,12,0,0,0,1,0.18,0.1364,0.37,0.4478,4,60,79,790,83,850
199,2011-01-09,1,0,1,13,0,0,0,1,0.2,0.1667,0.34,0.4478,6,90,69,690,75,780
200,2011-01-09,1,0,1,14,0,0,0,1,0.22,0.1818,0.32,0.4627,8,120,64,640,72,760
201,2011-01-09,1,0,1,15,0,0,0,1,0.22,0.197,0.35,0.3582,5,75,77,770,82,845
202,2011-01-09,1,0,1,16,0,0,0,1,0.2,0.1667,0.34,0.4478,13,195,79,790,92,985
203,2011-01-09,1,0,1,17,0,0,0,1,0.18,0.1515,0.37,0.3881,3,45,59,590,62,635
204,2011-01-09,1,0,1,18,0,0,0,1,0.16,0.1364,0.4,0.3284,4,60,44,440,48,500
205,2011-01-09,1,0,1,19,0,0,0,1,0.16,0.1364,0.43,0.3284,1,15,40,400,41,415
206,2011-01-09,1,0,1,20,0,0,0,1,0.14,0.1212,0.46,0.2537,0,0,38,380,38,380
207,2011-01-09,1,0,1,21,0,0,0,1,0.14,0.1061,0.46,0.4179,1,15,19,190,20,205
208,2011-01-09,1,0,1,22,0,0,0,1,0.14,0.1212,0.46,0.2985,5,75,10,100,15,175
209,2011-01-09,1,0,1,23,0,0,0,1,0.12,0.1364,0.5,0.194,0,0,6,60,6,60
210,2011-01-10,1,0,1,0,0,1,1,1,0.12,0.1212,0.5,0.2836,2,30,3,30,5,60
211,2011-01-10,1,0,1,1,0,1,1,1,0.12,0.1212,0.5,0.2836,1,15,0,0,1,15
212,2011-01-10,1,0,1,2,0,1,1,1,0.12,0.1212,0.5,0.2239,0,0,3,30,3,30
213,2011-01-10,1,0,1,3,0,1,1,1,0.12,0.1212,0.5,0.2239,0,0,1,10,1,10
214,2011-01-10,1,0,1,4,0,1,1,1,0.1,0.1212,0.54,0.1343,1,15,2,20,3,35
215,2011-01-10,1,0,1,5,0,1,1,1,0.1,0.1061,0.54,0.2537,0,0,3,30,3,30
216,2011-01-10,1,0,1,6,0,1,1,1,0.12,0.1212,0.5,0.2836,0,0,31,310,31,310
217,2011-01-10,1,0,1,7,0,1,1,1,0.12,0.1212,0.5,0.2239,2,30,75,750,77,780
218,2011-01-10,1,0,1,8,0,1,1,2,0.12,0.1212,0.5,0.2836,4,60,184,1840,188,1900
219,2011-01-10,1,0,1,9,0,1,1,2,0.14,0.1212,0.5,0.2537,2,30,92,920,94,950
220,2011-01-10,1,0,1,10,0,1,1,2,0.14,0.1212,0.5,0.2985,0,0,31,310,31,310
221,2011-01-10,1,0,1,11,0,1,1,2,0.16,0.1364,0.47,0.2836,2,30,28,280,30,310
222,2011-01-10,1,0,1,12,0,1,1,2,0.2,0.1818,0.4,0.2836,5,75,47,470,52,545
223,2011-01-10,1,0,1,13,0,1,1,2,0.2,0.1818,0.4,0.2836,4,60,50,500,54,560
224,2011-01-10,1,0,1,14,0,1,1,2,0.2,0.197,0.4,0.2239,0,0,47,470,47,470
225,2011-01-10,1,0,1,15,0,1,1,2,0.2,0.197,0.4,0.2239,2,30,43,430,45,460
226,2011-01-10,1,0,1,16,0,1,1,1,0.2,0.2121,0.4,0.1343,4,60,70,700,74,760
227,2011-01-10,1,0,1,17,0,1,1,1,0.2,0.2273,0.4,0.1045,4,60,174,1740,178,1800
228,2011-01-10,1,0,1,18,0,1,1,1,0.2,0.197,0.4,0.2239,1,15,154,1540,155,1555
229,2011-01-10,1,0,1,19,0,1,1,1,0.16,0.1667,0.47,0.1642,3,45,92,920,95,965
230,2011-01-10,1,0,1,20,0,1,1,1,0.16,0.1667,0.5,0.1642,1,15,73,730,74,745
231,2011-01-10,1,0,1,21,0,1,1,1,0.14,0.1364,0.59,0.194,1,15,37,370,38,385
232,2011-01-10,1,0,1,22,0,1,1,1,0.14,0.1515,0.59,0.1642,2,30,22,220,24,250
233,2011-01-10,1,0,1,23,0,1,1,1,0.14,0.1515,0.59,0.1642,0,0,18,180,18,180
234,2011-01-11,1,0,1,0,0,2,1,1,0.14,0.1667,0.59,0.1045,2,30,10,100,12,130
235,2011-01-11,1,0,1,1,0,2,1,1,0.14,0.1515,0.59,0.1642,0,0,3,30,3,30
236,2011-01-11,1,0,1,2,0,2,1,2,0.16,0.1515,0.55,0.194,0,0,3,30,3,30
237,2011-01-11,1,0,1,5,0,2,1,2,0.16,0.1818,0.55,0.1343,0,0,6,60,6,60
238,2011-01-11,1,0,1,6,0,2,1,2,0.16,0.1818,0.55,0.1343,0,0,27,270,27,270
239,2011-01-11,1,0,1,7,0,2,1,2,0.16,0.2273,0.55,0.0,2,30,97,970,99,1000
240,2011-01-11,1,0,1,8,0,2,1,2,0.18,0.2121,0.51,0.0896,3,45,214,2140,217,2185
241,2011-01-11,1,0,1,9,0,2,1,2,0.18,0.197,0.51,0.1642,3,45,127,1270,130,1315
242,2011-01-11,1,0,1,10,0,2,1,2,0.2,0.2121,0.51,0.1642,3,45,51,510,54,555
243,2011-01-11,1,0,1,11,0,2,1,2,0.2,0.2121,0.47,0.1343,4,60,31,310,35,370
244,2011-01-11,1,0,1,12,0,2,1,2,0.2,0.2273,0.51,0.1045,2,30,55,550,57,580
245,2011-01-11,1,0,1,13,0,2,1,2,0.2,0.2273,0.59,0.0896,6,90,46,460,52,550
246,2011-01-11,1,0,1,14,0,2,1,2,0.2,0.2273,0.59,0.0896,3,45,60,600,63,645
247,2011-01-11,1,0,1,15,0,2,1,2,0.16,0.197,0.8,0.0896,2,30,45,450,47,480
248,2011-01-11,1,0,1,16,0,2,1,2,0.16,0.1515,0.86,0.2239,4,60,72,720,76,780
249,2011-01-11,1,0,1,17,0,2,1,2,0.16,0.1515,0.86,0.2239,6,90,130,1300,136,1390
250,2011-01-11,1,0,1,18,0,2,1,3,0.16,0.1818,0.93,0.1045,1,15,94,940,95,955
251,2011-01-11,1,0,1,19,0,2,1,3,0.16,0.2273,0.93,0.0,0,0,51,510,51,510
252,2011-01-11,1,0,1,20,0,2,1,3,0.16,0.1515,0.93,0.194,0,0,32,320,32,320
253,2011-01-11,1,0,1,21,0,2,1,3,0.16,0.197,0.86,0.0896,0,0,20,200,20,200
254,2011-01-11,1,0,1,22,0,2,1,3,0.16,0.1818,0.93,0.1045,1,15,28,280,29,295
255,2011-01-11,1,0,1,23,0,2,1,3,0.16,0.197,0.93,0.0896,1,15,18,180,19,195
256,2011-01-12,1,0,1,0,0,3,1,2,0.16,0.197,0.86,0.0896,0,0,7,70,7,70
257,2011-01-12,1,0,1,1,0,3,1,2,0.16,0.1818,0.86,0.1045,0,0,6,60,6,60
258,2011-01-12,1,0,1,2,0,3,1,1,0.14,0.1515,0.86,0.1343,0,0,1,10,1,10
259,2011-01-12,1,0,1,5,0,3,1,1,0.14,0.1515,0.86,0.1642,0,0,5,50,5,50
260,2011-01-12,1,0,1,6,0,3,1,1,0.12,0.1515,0.93,0.1343,0,0,16,160,16,160
261,2011-01-12,1,0,1,7,0,3,1,1,0.14,0.1515,0.69,0.1343,0,0,54,540,54,540
262,2011-01-12,1,0,1,8,0,3,1,1,0.16,0.1667,0.59,0.1642,3,45,125,1250,128,1295
263,2011-01-12,1,0,1,9,0,3,1,1,0.16,0.1364,0.59,0.3284,3,45,78,780,81,825
264,2011-01-12,1,0,1,10,0,3,1,1,0.18,0.1818,0.55,0.2239,0,0,39,390,39,390
265,2011-01-12,1,0,1,11,0,3,1,1,0.2,0.1818,0.51,0.3881,3,45,32,320,35,365
266,2011-01-12,1,0,1,12,0,3,1,1,0.2,0.1515,0.47,0.5821,3,45,52,520,55,565
267,2011-01-12,1,0,1,13,0,3,1,1,0.22,0.197,0.44,0.3582,0,0,49,490,49,490
268,2011-01-12,1,0,1,14,0,3,1,1,0.2,0.1818,0.47,0.3284,0,0,44,440,44,440
269,2011-01-12,1,0,1,15,0,3,1,1,0.2,0.1667,0.47,0.4179,1,15,48,480,49,495
270,2011-01-12,1,0,1,16,0,3,1,1,0.22,0.197,0.44,0.3284,5,75,63,630,68,705
271,2011-01-12,1,0,1,17,0,3,1,1,0.2,0.1818,0.47,0.3582,0,0,139,1390,139,1390
272,2011-01-12,1,0,1,18,0,3,1,1,0.2,0.1515,0.47,0.5224,2,30,135,1350,137,1380
273,2011-01-12,1,0,1,19,0,3,1,1,0.18,0.1515,0.47,0.4179,1,15,82,820,83,835
274,2011-01-12,1,0,1,20,0,3,1,1,0.16,0.1364,0.5,0.3284,2,30,54,540,56,570
275,2011-01-12,1,0,1,21,0,3,1,1,0.16,0.1364,0.55,0.3284,0,0,57,570,57,570
276,2011-01-12,1,0,1,22,0,3,1,1,0.16,0.1212,0.55,0.4478,1,15,32,320,33,335
277,2011-01-12,1,0,1,23,0,3,1,1,0.14,0.1061,0.59,0.4179,1,15,19,190,20,205
278,2011-01-13,1,0,1,0,0,4,1,1,0.14,0.1212,0.59,0.2836,1,15,6,60,7,75
279,2011-01-13,1,0,1,1,0,4,1,1,0.14,0.1212,0.5,0.2836,0,0,2,20,2,20
280,2011-01-13,1,0,1,2,0,4,1,1,0.14,0.1212,0.5,0.3582,0,0,2,20,2,20
281,2011-01-13,1,0,1,3,0,4,1,1,0.14,0.1212,0.5,0.3284,0,0,3,30,3,30
282,2011-01-13,1,0,1,4,0,4,1,1,0.14,0.1212,0.5,0.2537,0,0,4,40,4,40
283,2011-01-13,1,0,1,5,0,4,1,1,0.14,0.1212,0.5,0.2985,0,0,3,30,3,30
284,2011-01-13,1,0,1,6,0,4,1,1,0.12,0.1515,0.54,0.1343,0,0,28,280,28,280
285,2011-01-13,1,0,1,7,0,4,1,1,0.12,0.1515,0.54,0.1343,0,0,72,720,72,720
286,2011-01-13,1,0,1,8,0,4,1,1,0.14,0.1364,0.5,0.194,5,75,197,1970,202,2045
287,2011-01-13,1,0,1,9,0,4,1,1,0.14,0.1212,0.5,0.3284,2,30,137,1370,139,1400
288,2011-01-13,1,0,1,10,0,4,1,2,0.16,0.1364,0.5,0.3582,2,30,36,360,38,390
289,2011-01-13,1,0,1,11,0,4,1,2,0.2,0.1667,0.44,0.4478,4,60,33,330,37,390
290,2011-01-13,1,0,1,12,0,4,1,1,0.2,0.1667,0.44,0.4179,3,45,49,490,52,535
291,2011-01-13,1,0,1,13,0,4,1,1,0.22,0.197,0.41,0.4478,2,30,81,810,83,840
292,2011-01-13,1,0,1,14,0,4,1,1,0.22,0.197,0.41,0.3881,3,45,39,390,42,435
293,2011-01-13,1,0,1,15,0,4,1,1,0.24,0.2121,0.38,0.2985,5,75,55,550,60,625
294,2011-01-13,1,0,1,16,0,4,1,1,0.24,0.2121,0.38,0.3582,2,30,76,760,78,790
295,2011-01-13,1,0,1,17,0,4,1,1,0.2,0.1818,0.4,0.2836,4,60,158,1580,162,1640
296,2011-01-13,1,0,1,18,0,4,1,1,0.2,0.1818,0.4,0.3284,3,45,141,1410,144,1455
297,2011-01-13,1,0,1,19,0,4,1,1,0.16,0.1515,0.47,0.2537,1,15,98,980,99,995
298,2011-01-13,1,0,1,20,0,4,1,1,0.16,0.1515,0.47,0.2239,0,0,64,640,64,640
299,2011-01-13,1,0,1,21,0,4,1,1,0.14,0.1212,0.46,0.2985,0,0,40,400,40,400
300,2011-01-13,1,0,1,22,0,4,1,1,0.14,0.1212,0.46,0.3284,0,0,30,300,30,300
301,2011-01-13,1,0,1,23,0,4,1,1,0.12,0.1364,0.5,0.194,1,15,14,140,15,155
302,2011-01-14,1,0,1,0,0,5,1,1,0.12,0.1364,0.5,0.194,0,0,14,140,14,140
303,2011-01-14,1,0,1,1,0,5,1,1,0.1,0.1212,0.54,0.1642,0,0,5,50,5,50
304,2011-01-14,1,0,1,2,0,5,1,1,0.1,0.1212,0.54,0.1343,0,0,1,10,1,10
305,2011-01-14,1,0,1,3,0,5,1,1,0.1,0.1364,0.54,0.1045,0,0,1,10,1,10
306,2011-01-14,1,0,1,5,0,5,1,1,0.1,0.1364,0.54,0.0896,0,0,8,80,8,80
307,2011-01-14,1,0,1,6,0,5,1,1,0.1,0.1818,0.54,0.0,0,0,17,170,17,170
308,2011-01-14,1,0,1,7,0,5,1,1,0.1,0.1212,0.74,0.1642,0,0,70,700,70,700
309,2011-01-14,1,0,1,8,0,5,1,1,0.12,0.1667,0.68,0.0,2,30,156,1560,158,1590
310,2011-01-14,1,0,1,9,0,5,1,1,0.14,0.1515,0.69,0.1343,0,0,117,1170,117,1170
311,2011-01-14,1,0,1,10,0,5,1,1,0.18,0.1818,0.55,0.194,4,60,40,400,44,460
312,2011-01-14,1,0,1,11,0,5,1,1,0.18,0.1667,0.51,0.2836,6,90,47,470,53,560
313,2011-01-14,1,0,1,12,0,5,1,1,0.2,0.197,0.44,0.2537,2,30,59,590,61,620
314,2011-01-14,1,0,1,13,0,5,1,1,0.22,0.197,0.37,0.3881,4,60,73,730,77,790
315,2011-01-14,1,0,1,14,0,5,1,1,0.22,0.2121,0.41,0.2836,5,75,59,590,64,665
316,2011-01-14,1,0,1,15,0,5,1,1,0.24,0.2424,0.38,0.1642,9,135,59,590,68,725
317,2011-01-14,1,0,1,16,0,5,1,1,0.22,0.2424,0.41,0.1045,3,45,87,870,90,915
318,2011-01-14,1,0,1,17,0,5,1,1,0.22,0.2273,0.41,0.1642,4,60,155,1550,159,1610
319,2011-01-14,1,0,1,18,0,5,1,1,0.2,0.2576,0.47,0.0,5,75,134,1340,139,1415
320,2011-01-14,1,0,1,19,0,5,1,1,0.16,0.197,0.59,0.0896,3,45,89,890,92,935
321,2011-01-14,1,0,1,20,0,5,1,1,0.18,0.2424,0.59,0.0,0,0,68,680,68,680
322,2011-01-14,1,0,1,21,0,5,1,1,0.16,0.2273,0.69,0.0,4,60,48,480,52,540
323,2011-01-14,1,0,1,22,0,5,1,2,0.16,0.2273,0.69,0.0,2,30,34,340,36,370
324,2011-01-14,1,0,1,23,0,5,1,2,0.18,0.2424,0.55,0.0,1,15,26,260,27,275
325,2011-01-15,1,0,1,0,0,6,0,1,0.18,0.2424,0.55,0.0,3,45,25,250,28,295
326,2011-01-15,1,0,1,1,0,6,0,2,0.16,0.197,0.59,0.0896,2,30,18,180,20,210
327,2011-01-15,1,0,1,2,0,6,0,2,0.16,0.197,0.59,0.0896,0,0,12,120,12,120
328,2011-01-15,1,0,1,3,0,6,0,2,0.16,0.2273,0.59,0.0,1,15,7,70,8,85
329,2011-01-15,1,0,1,4,0,6,0,2,0.16,0.2273,0.59,0.0,0,0,5,50,5,50
330,2011-01-15,1,0,1,5,0,6,0,1,0.16,0.2273,0.59,0.0,0,0,1,10,1,10
331,2011-01-15,1,0,1,6,0,6,0,1,0.14,0.1667,0.63,0.1045,1,15,2,20,3,35
332,2011-01-15,1,0,1,7,0,6,0,1,0.14,0.2121,0.63,0.0,1,15,9,90,10,105
333,2011-01-15,1,0,1,8,0,6,0,1,0.14,0.1515,0.63,0.1343,1,15,22,220,23,235
334,2011-01-15,1,0,1,9,0,6,0,1,0.16,0.1818,0.64,0.1343,2,30,31,310,33,340
335,2011-01-15,1,0,1,10,0,6,0,1,0.18,0.197,0.59,0.1642,2,30,57,570,59,600
336,2011-01-15,1,0,1,11,0,6,0,1,0.2,0.197,0.55,0.2239,18,270,54,540,72,810
337,2011-01-15,1,0,1,12,0,6,0,1,0.24,0.2273,0.48,0.2239,15,225,74,740,89,965
338,2011-01-15,1,0,1,13,0,6,0,1,0.28,0.2576,0.38,0.2985,21,315,80,800,101,1115
339,2011-01-15,1,0,1,14,0,6,0,1,0.3,0.2879,0.39,0.2836,26,390,92,920,118,1310
340,2011-01-15,1,0,1,15,0,6,0,2,0.32,0.3182,0.36,0.194,21,315,108,1080,129,1395
341,2011-01-15,1,0,1,16,0,6,0,2,0.34,0.3333,0.34,0.194,33,495,95,950,128,1445
342,2011-01-15,1,0,1,17,0,6,0,2,0.32,0.303,0.36,0.2836,29,435,54,540,83,975
343,2011-01-15,1,0,1,18,0,6,0,2,0.3,0.2879,0.45,0.2537,15,225,69,690,84,915
344,2011-01-15,1,0,1,19,0,6,0,2,0.32,0.303,0.39,0.2537,14,210,60,600,74,810
345,2011-01-15,1,0,1,20,0,6,0,2,0.32,0.303,0.39,0.2537,6,90,35,350,41,440
346,2011-01-15,1,0,1,21,0,6,0,2,0.32,0.303,0.39,0.2239,6,90,51,510,57,600
347,2011-01-15,1,0,1,22,0,6,0,2,0.3,0.3182,0.42,0.1045,0,0,26,260,26,260
348,2011-01-15,1,0,1,23,0,6,0,1,0.3,0.2879,0.45,0.2836,5,75,39,390,44,465
349,2011-01-16,1,0,1,0,0,0,0,1,0.26,0.303,0.56,0.0,6,90,33,330,39,420
350,2011-01-16,1,0,1,1,0,0,0,1,0.26,0.2727,0.56,0.1343,4,60,19,190,23,250
351,2011-01-16,1,0,1,2,0,0,0,1,0.26,0.2879,0.56,0.0896,3,45,13,130,16,175
352,2011-01-16,1,0,1,3,0,0,0,1,0.22,0.2727,0.69,0.0,9,135,6,60,15,195
353,2011-01-16,1,0,1,4,0,0,0,1,0.26,0.2576,0.56,0.1642,0,0,1,10,1,10
354,2011-01-16,1,0,1,5,0,0,0,2,0.26,0.2576,0.56,0.1642,1,15,1,10,2,25
355,2011-01-16,1,0,1,6,0,0,0,2,0.26,0.2576,0.56,0.1642,0,0,1,10,1,10
356,2011-01-16,1,0,1,7,0,0,0,2,0.24,0.2121,0.56,0.2985,0,0,3,30,3,30
357,2011-01-16,1,0,1,8,0,0,0,1,0.22,0.2121,0.55,0.2836,0,0,18,180,18,180
358,2011-01-16,1,0,1,9,0,0,0,1,0.22,0.2121,0.51,0.2537,3,45,29,290,32,335
359,2011-01-16,1,0,1,10,0,0,0,1,0.22,0.2121,0.51,0.2836,8,120,71,710,79,830
360,2011-01-16,1,0,1,11,0,0,0,1,0.24,0.2273,0.44,0.2537,23,345,70,700,93,1045
361,2011-01-16,1,0,1,12,0,0,0,1,0.24,0.2121,0.41,0.2836,29,435,75,750,104,1185
362,2011-01-16,1,0,1,13,0,0,0,1,0.26,0.2273,0.35,0.2985,23,345,95,950,118,1295
363,2011-01-16,1,0,1,14,0,0,0,1,0.28,0.2727,0.36,0.2537,22,330,69,690,91,1020
364,2011-01-16,1,0,1,15,0,0,0,1,0.26,0.2424,0.38,0.2537,35,525,78,780,113,1305
365,2011-01-16,1,0,1,16,0,0,0,1,0.24,0.2273,0.38,0.2239,22,330,77,770,99,1100
366,2011-01-16,1,0,1,17,0,0,0,1,0.22,0.2121,0.37,0.2537,23,345,82,820,105,1165
367,2011-01-16,1,0,1,18,0,0,0,1,0.2,0.2121,0.4,0.1642,11,165,56,560,67,725
368,2011-01-16,1,0,1,19,0,0,0,1,0.18,0.197,0.47,0.1343,14,210,47,470,61,680
369,2011-01-16,1,0,1,20,0,0,0,1,0.18,0.197,0.47,0.1642,7,105,50,500,57,605
370,2011-01-16,1,0,1,21,0,0,0,1,0.18,0.197,0.51,0.1642,6,90,22,220,28,310
371,2011-01-16,1,0,1,22,0,0,0,2,0.2,0.2121,0.49,0.1343,2,30,19,190,21,220
372,2011-01-16,1,0,1,23,0,0,0,2,0.2,0.2273,0.4,0.1045,0,0,18,180,18,180
373,2011-01-17,1,0,1,0,1,1,0,2,0.2,0.197,0.47,0.2239,1,15,16,160,17,175
374,2011-01-17,1,0,1,1,1,1,0,2,0.2,0.197,0.44,0.194,1,15,15,150,16,165
375,2011-01-17,1,0,1,2,1,1,0,2,0.18,0.1667,0.43,0.2537,0,0,8,80,8,80
376,2011-01-17,1,0,1,3,1,1,0,2,0.18,0.1818,0.43,0.194,0,0,2,20,2,20
377,2011-01-17,1,0,1,4,1,1,0,2,0.18,0.197,0.43,0.1343,1,15,2,20,3,35
378,2011-01-17,1,0,1,5,1,1,0,2,0.18,0.197,0.43,0.1642,0,0,1,10,1,10
379,2011-01-17,1,0,1,6,1,1,0,2,0.18,0.1818,0.43,0.194,0,0,5,50,5,50
380,2011-01-17,1,0,1,7,1,1,0,2,0.16,0.1818,0.5,0.1343,4,60,9,90,13,150
381,2011-01-17,1,0,1,8,1,1,0,2,0.16,0.1515,0.47,0.2239,3,45,30,300,33,345
382,2011-01-17,1,0,1,9,1,1,0,2,0.16,0.1515,0.47,0.2239,8,120,39,390,47,510
383,2011-01-17,1,0,1,10,1,1,0,2,0.16,0.1515,0.5,0.2537,7,105,50,500,57,605
384,2011-01-17,1,0,1,11,1,1,0,2,0.16,0.1515,0.55,0.194,9,135,55,550,64,685
385,2011-01-17,1,0,1,12,1,1,0,2,0.18,0.197,0.47,0.1343,10,150,70,700,80,850
386,2011-01-17,1,0,1,13,1,1,0,2,0.18,0.197,0.47,0.1343,13,195,80,800,93,995
387,2011-01-17,1,0,1,14,1,1,0,2,0.18,0.2121,0.43,0.1045,12,180,74,740,86,920
388,2011-01-17,1,0,1,15,1,1,0,2,0.2,0.2121,0.47,0.1642,21,315,72,720,93,1035
389,2011-01-17,1,0,1,16,1,1,0,2,0.2,0.2121,0.47,0.1642,6,90,76,760,82,850
390,2011-01-17,1,0,1,17,1,1,0,1,0.2,0.197,0.51,0.194,4,60,67,670,71,730
391,2011-01-17,1,0,1,18,1,1,0,2,0.18,0.1667,0.55,0.2537,7,105,85,850,92,955
392,2011-01-17,1,0,1,19,1,1,0,3,0.18,0.1818,0.59,0.194,2,30,58,580,60,610
393,2011-01-17,1,0,1,20,1,1,0,3,0.16,0.1515,0.8,0.194,4,60,29,290,33,350
394,2011-01-17,1,0,1,21,1,1,0,3,0.16,0.1515,0.8,0.194,3,45,24,240,27,285
395,2011-01-17,1,0,1,22,1,1,0,3,0.14,0.1212,0.93,0.2537,0,0,13,130,13,130
396,2011-01-17,1,0,1,23,1,1,0,3,0.16,0.1364,0.86,0.2836,1,15,3,30,4,45
397,2011-01-18,1,0,1,12,0,2,1,2,0.2,0.1818,0.86,0.3284,0,0,3,30,3,30
398,2011-01-18,1,0,1,13,0,2,1,2,0.2,0.197,0.86,0.2239,0,0,22,220,22,220
399,2011-01-18,1,0,1,14,0,2,1,2,0.22,0.2273,0.8,0.1642,2,30,26,260,28,290
400,2011-01-18,1,0,1,15,0,2,1,2,0.22,0.2273,0.87,0.1642,3,45,32,320,35,365
401,2011-01-18,1,0,1,16,0,2,1,2,0.22,0.2273,0.87,0.194,0,0,61,610,61,610
402,2011-01-18,1,0,1,17,0,2,1,2,0.22,0.2273,0.82,0.194,1,15,124,1240,125,1255
403,2011-01-18,1,0,1,18,0,2,1,2,0.22,0.2273,0.8,0.1642,1,15,132,1320,133,1335
404,2011-01-18,1,0,1,19,0,2,1,2,0.22,0.2273,0.8,0.1343,1,15,98,980,99,995
405,2011-01-18,1,0,1,20,0,2,1,2,0.22,0.2727,0.87,0.0,0,0,83,830,83,830
406,2011-01-18,1,0,1,21,0,2,1,2,0.22,0.2424,0.93,0.1045,0,0,41,410,41,410
407,2011-01-18,1,0,1,22,0,2,1,2,0.22,0.2576,0.93,0.0896,0,0,33,330,33,330
408,2011-01-18,1,0,1,23,0,2,1,2,0.22,0.2727,0.93,0.0,1,15,19,190,20,205
409,2011-01-19,1,0,1,0,0,3,1,2,0.22,0.2727,0.93,0.0,0,0,3,30,3,30
410,2011-01-19,1,0,1,1,0,3,1,3,0.22,0.2273,0.93,0.1343,1,15,6,60,7,75
411,2011-01-19,1,0,1,2,0,3,1,3,0.22,0.2273,0.93,0.1343,0,0,3,30,3,30
412,2011-01-19,1,0,1,4,0,3,1,3,0.22,0.2273,0.93,0.1343,1,15,1,10,2,25
413,2011-01-19,1,0,1,5,0,3,1,2,0.22,0.2576,0.93,0.0896,0,0,7,70,7,70
414,2011-01-19,1,0,1,6,0,3,1,2,0.22,0.2576,0.93,0.0896,0,0,32,320,32,320
415,2011-01-19,1,0,1,7,0,3,1,2,0.24,0.2576,0.92,0.1045,1,15,89,890,90,905
416,2011-01-19,1,0,1,8,0,3,1,2,0.24,0.2576,0.93,0.1045,1,15,196,1960,197,1975
417,2011-01-19,1,0,1,9,0,3,1,2,0.24,0.2576,0.93,0.1045,2,30,107,1070,109,1100
418,2011-01-19,1,0,1,10,0,3,1,2,0.26,0.2727,0.93,0.1343,1,15,46,460,47,475
419,2011-01-19,1,0,1,11,0,3,1,2,0.28,0.303,0.87,0.0896,5,75,47,470,52,545
420,2011-01-19,1,0,1,12,0,3,1,2,0.3,0.3182,0.81,0.0896,5,75,65,650,70,725
421,2011-01-19,1,0,1,13,0,3,1,1,0.4,0.4091,0.62,0.2836,11,165,67,670,78,835
422,2011-01-19,1,0,1,14,0,3,1,1,0.4,0.4091,0.58,0.2537,7,105,68,680,75,785
423,2011-01-19,1,0,1,15,0,3,1,1,0.4,0.4091,0.54,0.2836,4,60,78,780,82,840
424,2011-01-19,1,0,1,16,0,3,1,1,0.38,0.3939,0.58,0.3881,10,150,94,940,104,1090
425,2011-01-19,1,0,1,17,0,3,1,1,0.36,0.3333,0.57,0.3284,7,105,190,1900,197,2005
426,2011-01-19,1,0,1,18,0,3,1,1,0.34,0.3182,0.61,0.2836,5,75,156,1560,161,1635
427,2011-01-19,1,0,1,19,0,3,1,1,0.32,0.2879,0.57,0.4179,4,60,108,1080,112,1140
428,2011-01-19,1,0,1,20,0,3,1,1,0.32,0.303,0.49,0.2985,2,30,74,740,76,770
429,2011-01-19,1,0,1,21,0,3,1,1,0.32,0.2879,0.49,0.4179,4,60,55,550,59,610
430,2011-01-19,1,0,1,22,0,3,1,1,0.3,0.303,0.52,0.1642,6,90,53,530,59,620
431,2011-01-19,1,0,1,23,0,3,1,1,0.3,0.2727,0.52,0.4627,1,15,27,270,28,285
432,2011-01-20,1,0,1,0,0,4,1,1,0.26,0.2273,0.56,0.3881,5,75,8,80,13,155
433,2011-01-20,1,0,1,1,0,4,1,1,0.26,0.2727,0.56,0.0,2,30,3,30,5,60
434,2011-01-20,1,0,1,2,0,4,1,1,0.26,0.2727,0.56,0.0,0,0,2,20,2,20
435,2011-01-20,1,0,1,3,0,4,1,1,0.26,0.2576,0.56,0.1642,0,0,1,10,1,10
436,2011-01-20,1,0,1,4,0,4,1,1,0.26,0.2576,0.56,0.1642,0,0,1,10,1,10
437,2011-01-20,1,0,1,5,0,4,1,1,0.24,0.2273,0.6,0.2239,0,0,6,60,6,60
438,2011-01-20,1,0,1,6,0,4,1,1,0.22,0.2121,0.6,0.2239,0,0,35,350,35,350
439,2011-01-20,1,0,1,7,0,4,1,1,0.22,0.2121,0.55,0.2239,1,15,100,1000,101,1015
440,2011-01-20,1,0,1,8,0,4,1,1,0.22,0.2121,0.55,0.2836,2,30,247,2470,249,2500
441,2011-01-20,1,0,1,9,0,4,1,2,0.24,0.2273,0.52,0.2239,3,45,140,1400,143,1445
442,2011-01-20,1,0,1,10,0,4,1,1,0.26,0.2273,0.48,0.2985,1,15,56,560,57,575
443,2011-01-20,1,0,1,11,0,4,1,2,0.28,0.2727,0.45,0.1642,5,75,63,630,68,705
444,2011-01-20,1,0,1,12,0,4,1,2,0.3,0.3333,0.42,0.0,7,105,77,770,84,875
445,2011-01-20,1,0,1,13,0,4,1,2,0.28,0.2879,0.45,0.1045,12,180,86,860,98,1040
446,2011-01-20,1,0,1,14,0,4,1,2,0.3,0.303,0.45,0.1343,6,90,75,750,81,840
447,2011-01-20,1,0,1,15,0,4,1,2,0.32,0.3182,0.45,0.194,8,120,62,620,70,740
448,2011-01-20,1,0,1,16,0,4,1,2,0.3,0.303,0.49,0.1343,8,120,83,830,91,950
449,2011-01-20,1,0,1,17,0,4,1,2,0.3,0.3182,0.49,0.1045,8,120,207,2070,215,2190
450,2011-01-20,1,0,1,18,0,4,1,2,0.26,0.2576,0.56,0.194,1,15,184,1840,185,1855
451,2011-01-20,1,0,1,19,0,4,1,1,0.26,0.2273,0.56,0.3284,6,90,146,1460,152,1550
452,2011-01-20,1,0,1,20,0,4,1,2,0.26,0.2424,0.6,0.2836,2,30,124,1240,126,1270
453,2011-01-20,1,0,1,21,0,4,1,2,0.24,0.2273,0.6,0.2537,3,45,54,540,57,585
454,2011-01-20,1,0,1,22,0,4,1,2,0.24,0.2121,0.65,0.2836,0,0,56,560,56,560
455,2011-01-20,1,0,1,23,0,4,1,2,0.24,0.2121,0.65,0.3284,3,45,28,280,31,325
456,2011-01-21,1,0,1,0,0,5,1,2,0.24,0.2273,0.7,0.2537,1,15,20,200,21,215
457,2011-01-21,1,0,1,1,0,5,1,2,0.24,0.2273,0.7,0.2537,0,0,6,60,6,60
458,2011-01-21,1,0,1,2,0,5,1,3,0.24,0.2424,0.75,0.1642,0,0,2,20,2,20
459,2011-01-21,1,0,1,3,0,5,1,3,0.22,0.2121,0.8,0.2985,0,0,1,10,1,10
460,2011-01-21,1,0,1,4,0,5,1,2,0.22,0.2576,0.87,0.0896,0,0,1,10,1,10
461,2011-01-21,1,0,1,5,0,5,1,1,0.24,0.197,0.6,0.4179,1,15,4,40,5,55
462,2011-01-21,1,0,1,6,0,5,1,1,0.22,0.2121,0.55,0.2537,0,0,27,270,27,270
463,2011-01-21,1,0,1,7,0,5,1,1,0.2,0.1818,0.51,0.2836,2,30,66,660,68,690
464,2011-01-21,1,0,1,8,0,5,1,1,0.2,0.1818,0.47,0.3284,7,105,210,2100,217,2205
465,2011-01-21,1,0,1,9,0,5,1,1,0.2,0.1818,0.51,0.3582,7,105,159,1590,166,1695
466,2011-01-21,1,0,1,10,0,5,1,1,0.2,0.1667,0.47,0.4627,6,90,57,570,63,660
467,2011-01-21,1,0,1,11,0,5,1,1,0.22,0.1818,0.41,0.4627,6,90,53,530,59,620
468,2011-01-21,1,0,1,12,0,5,1,1,0.22,0.1818,0.27,0.5821,11,165,67,670,78,835
469,2011-01-21,1,0,1,13,0,5,1,1,0.2,0.1515,0.21,0.5821,8,120,65,650,73,770
470,2011-01-21,1,0,1,14,0,5,1,1,0.2,0.1515,0.25,0.5224,6,90,56,560,62,650
471,2011-01-21,1,0,1,15,0,5,1,1,0.16,0.1212,0.26,0.4478,4,60,61,610,65,670
472,2011-01-21,1,0,1,16,0,5,1,1,0.16,0.1364,0.26,0.3582,0,0,97,970,97,970
473,2011-01-21,1,0,1,17,0,5,1,1,0.14,0.1212,0.28,0.3582,10,150,151,1510,161,1660
474,2011-01-21,1,0,1,18,0,5,1,1,0.12,0.1212,0.3,0.2537,1,15,119,1190,120,1205
475,2011-01-21,1,0,1,19,0,5,1,1,0.12,0.1061,0.3,0.3284,3,45,93,930,96,975
476,2011-01-21,1,0,1,20,0,5,1,1,0.1,0.0758,0.33,0.4179,1,15,52,520,53,535
477,2011-01-21,1,0,1,21,0,5,1,1,0.08,0.0758,0.38,0.2836,0,0,41,410,41,410
478,2011-01-21,1,0,1,22,0,5,1,1,0.06,0.0303,0.41,0.3881,1,15,33,330,34,345
479,2011-01-21,1,0,1,23,0,5,1,1,0.06,0.0455,0.38,0.3284,0,0,27,270,27,270
480,2011-01-22,1,0,1,0,0,6,0,1,0.04,0.0303,0.45,0.2537,0,0,13,130,13,130
481,2011-01-22,1,0,1,1,0,6,0,2,0.04,0.0,0.41,0.3881,3,45,9,90,12,135
482,2011-01-22,1,0,1,2,0,6,0,2,0.04,0.0303,0.41,0.2537,0,0,11,110,11,110
483,2011-01-22,1,0,1,3,0,6,0,2,0.04,0.0303,0.41,0.2836,1,15,6,60,7,75
484,2011-01-22,1,0,1,4,0,6,0,2,0.02,0.0152,0.48,0.2985,0,0,3,30,3,30
485,2011-01-22,1,0,1,6,0,6,0,2,0.02,0.0303,0.44,0.2239,0,0,2,20,2,20
486,2011-01-22,1,0,1,7,0,6,0,1,0.02,0.0152,0.44,0.2836,0,0,8,80,8,80
487,2011-01-22,1,0,1,8,0,6,0,1,0.02,0.0,0.44,0.3284,1,15,26,260,27,275
488,2011-01-22,1,0,1,9,0,6,0,1,0.04,0.0303,0.41,0.2537,3,45,37,370,40,415
489,2011-01-22,1,0,1,10,0,6,0,2,0.04,0.0606,0.41,0.1642,3,45,50,500,53,545
490,2011-01-22,1,0,1,11,0,6,0,2,0.06,0.0758,0.38,0.1343,4,60,59,590,63,650
491,2011-01-22,1,0,1,12,0,6,0,2,0.06,0.1061,0.38,0.1045,10,150,60,600,70,750
492,2011-01-22,1,0,1,13,0,6,0,1,0.08,0.1667,0.35,0.0,12,180,72,720,84,900
493,2011-01-22,1,0,1,14,0,6,0,1,0.1,0.1364,0.33,0.1045,11,165,64,640,75,805
494,2011-01-22,1,0,1,15,0,6,0,1,0.12,0.1515,0.28,0.0,10,150,93,930,103,1080
495,2011-01-22,1,0,1,16,0,6,0,1,0.12,0.1364,0.28,0.194,11,165,72,720,83,885
496,2011-01-22,1,0,1,17,0,6,0,1,0.12,0.197,0.28,0.0,8,120,59,590,67,710
497,2011-01-22,1,0,1,18,0,6,0,1,0.08,0.0909,0.35,0.194,0,0,54,540,54,540
498,2011-01-22,1,0,1,19,0,6,0,1,0.08,0.1061,0.35,0.1343,6,90,53,530,59,620
499,2011-01-22,1,0,1,20,0,6,0,1,0.06,0.0758,0.45,0.1642,1,15,44,440,45,455
500,2011-01-22,1,0,1,21,0,6,0,1,0.06,0.1061,0.41,0.0896,0,0,39,390,39,390
501,2011-01-22,1,0,1,22,0,6,0,1,0.06,0.1515,0.49,0.0,7,105,23,230,30,335
502,2011-01-22,1,0,1,23,0,6,0,1,0.04,0.0758,0.57,0.1045,2,30,31,310,33,340
503,2011-01-23,1,0,1,0,0,0,0,1,0.04,0.0758,0.57,0.1045,2,30,20,200,22,230
504,2011-01-23,1,0,1,1,0,0,0,1,0.04,0.0758,0.57,0.1045,1,15,12,120,13,135
505,2011-01-23,1,0,1,2,0,0,0,1,0.02,0.0606,0.62,0.1343,3,45,15,150,18,195
506,2011-01-23,1,0,1,3,0,0,0,1,0.02,0.0606,0.62,0.1343,1,15,4,40,5,55
507,2011-01-23,1,0,1,5,0,0,0,2,0.04,0.0758,0.57,0.1045,0,0,3,30,3,30
508,2011-01-23,1,0,1,6,0,0,0,2,0.04,0.0758,0.57,0.1045,0,0,1,10,1,10
509,2011-01-23,1,0,1,7,0,0,0,1,0.08,0.1061,0.58,0.1642,1,15,1,10,2,25
510,2011-01-23,1,0,1,8,0,0,0,1,0.06,0.0758,0.62,0.1642,2,30,17,170,19,200
511,2011-01-23,1,0,1,9,0,0,0,1,0.1,0.0758,0.54,0.3582,3,45,25,250,28,295
512,2011-01-23,1,0,1,10,0,0,0,1,0.14,0.1061,0.46,0.3881,7,105,51,510,58,615
513,2011-01-23,1,0,1,11,0,0,0,1,0.14,0.1364,0.43,0.2239,22,330,77,770,99,1100
514,2011-01-23,1,0,1,12,0,0,0,1,0.16,0.1212,0.37,0.4627,24,360,92,920,116,1280
515,2011-01-23,1,0,1,13,0,0,0,1,0.14,0.1061,0.33,0.3881,12,180,75,750,87,930
516,2011-01-23,1,0,1,14,0,0,0,1,0.16,0.1364,0.28,0.3582,17,255,93,930,110,1185
517,2011-01-23,1,0,1,15,0,0,0,1,0.16,0.1364,0.28,0.3582,13,195,64,640,77,835
518,2011-01-23,1,0,1,16,0,0,0,1,0.16,0.1364,0.26,0.3284,9,135,56,560,65,695
519,2011-01-23,1,0,1,17,0,0,0,1,0.14,0.1061,0.26,0.3881,5,75,50,500,55,575
520,2011-01-23,1,0,1,18,0,0,0,1,0.12,0.1212,0.3,0.2537,5,75,44,440,49,515
521,2011-01-23,1,0,1,19,0,0,0,1,0.12,0.1212,0.3,0.2836,5,75,45,450,50,525
522,2011-01-23,1,0,1,20,0,0,0,1,0.1,0.1061,0.36,0.2537,4,60,31,310,35,370
523,2011-01-23,1,0,1,21,0,0,0,1,0.1,0.1061,0.36,0.194,5,75,20,200,25,275
524,2011-01-23,1,0,1,22,0,0,0,1,0.08,0.0909,0.38,0.194,5,75,23,230,28,305
525,2011-01-23,1,0,1,23,0,0,0,1,0.06,0.0606,0.41,0.2239,4,60,17,170,21,230
526,2011-01-24,1,0,1,0,0,1,1,1,0.06,0.0606,0.41,0.194,0,0,7,70,7,70
527,2011-01-24,1,0,1,1,0,1,1,1,0.04,0.0455,0.45,0.194,0,0,1,10,1,10
528,2011-01-24,1,0,1,3,0,1,1,1,0.04,0.0303,0.45,0.2537,0,0,1,10,1,10
529,2011-01-24,1,0,1,4,0,1,1,1,0.02,0.0606,0.48,0.1343,0,0,1,10,1,10
530,2011-01-24,1,0,1,5,0,1,1,1,0.02,0.0606,0.48,0.1343,0,0,5,50,5,50
531,2011-01-24,1,0,1,6,0,1,1,1,0.02,0.0758,0.48,0.0896,0,0,15,150,15,150
532,2011-01-24,1,0,1,7,0,1,1,1,0.02,0.1212,0.48,0.0,5,75,79,790,84,865
533,2011-01-24,1,0,1,8,0,1,1,1,0.04,0.1364,0.49,0.0,6,90,171,1710,177,1800
534,2011-01-24,1,0,1,9,0,1,1,1,0.06,0.1515,0.41,0.0,4,60,98,980,102,1040
535,2011-01-24,1,0,1,10,0,1,1,1,0.1,0.1364,0.42,0.0,6,90,34,340,40,430
536,2011-01-24,1,0,1,11,0,1,1,1,0.1,0.1212,0.46,0.1343,3,45,43,430,46,475
537,2011-01-24,1,0,1,12,0,1,1,2,0.12,0.1364,0.42,0.194,11,165,52,520,63,685
538,2011-01-24,1,0,1,13,0,1,1,2,0.14,0.1364,0.43,0.2239,6,90,54,540,60,630
539,2011-01-24,1,0,1,14,0,1,1,2,0.14,0.1364,0.46,0.2239,2,30,43,430,45,460
540,2011-01-24,1,0,1,15,0,1,1,1,0.16,0.1667,0.4,0.1642,7,105,50,500,57,605
541,2011-01-24,1,0,1,16,0,1,1,1,0.16,0.1515,0.47,0.2537,4,60,66,660,70,720
542,2011-01-24,1,0,1,17,0,1,1,1,0.14,0.1212,0.5,0.2537,6,90,178,1780,184,1870
543,2011-01-24,1,0,1,18,0,1,1,1,0.14,0.1364,0.59,0.194,8,120,145,1450,153,1570
544,2011-01-24,1,0,1,19,0,1,1,1,0.14,0.1515,0.54,0.1642,5,75,101,1010,106,1085
545,2011-01-24,1,0,1,20,0,1,1,1,0.14,0.1364,0.59,0.194,1,15,80,800,81,815
546,2011-01-24,1,0,1,21,0,1,1,1,0.14,0.1515,0.63,0.1642,6,90,53,530,59,620
547,2011-01-24,1,0,1,22,0,1,1,2,0.14,0.1364,0.63,0.2239,3,45,32,320,35,365
548,2011-01-24,1,0,1,23,0,1,1,2,0.16,0.1515,0.64,0.2537,3,45,21,210,24,255
549,2011-01-25,1,0,1,0,0,2,1,2,0.16,0.1364,0.69,0.2836,3,45,6,60,9,105
550,2011-01-25,1,0,1,1,0,2,1,2,0.16,0.1667,0.69,0.1642,0,0,5,50,5,50
551,2011-01-25,1,0,1,2,0,2,1,1,0.16,0.1515,0.69,0.2239,0,0,2,20,2,20
552,2011-01-25,1,0,1,4,0,2,1,1,0.14,0.1667,0.74,0.1045,0,0,1,10,1,10
553,2011-01-25,1,0,1,5,0,2,1,1,0.14,0.1364,0.74,0.2239,0,0,9,90,9,90
554,2011-01-25,1,0,1,6,0,2,1,1,0.16,0.1818,0.74,0.1045,1,15,35,350,36,365
555,2011-01-25,1,0,1,7,0,2,1,1,0.16,0.1515,0.74,0.2239,5,75,103,1030,108,1105
556,2011-01-25,1,0,1,8,0,2,1,2,0.16,0.1818,0.74,0.1343,5,75,233,2330,238,2405
557,2011-01-25,1,0,1,9,0,2,1,2,0.2,0.2273,0.64,0.0896,10,150,134,1340,144,1490
558,2011-01-25,1,0,1,10,0,2,1,2,0.22,0.2424,0.6,0.1045,6,90,49,490,55,580
559,2011-01-25,1,0,1,11,0,2,1,2,0.24,0.2424,0.6,0.1343,6,90,55,550,61,640
560,2011-01-25,1,0,1,12,0,2,1,2,0.26,0.2879,0.56,0.0896,21,315,85,850,106,1165
561,2011-01-25,1,0,1,13,0,2,1,2,0.26,0.2727,0.56,0.1343,21,315,72,720,93,1035
562,2011-01-25,1,0,1,14,0,2,1,2,0.3,0.3333,0.45,0.0,11,165,57,570,68,735
563,2011-01-25,1,0,1,15,0,2,1,2,0.32,0.3485,0.42,0.0,21,315,63,630,84,945
564,2011-01-25,1,0,1,16,0,2,1,2,0.32,0.3485,0.42,0.0,14,210,102,1020,116,1230
565,2011-01-25,1,0,1,17,0,2,1,1,0.3,0.3333,0.45,0.0,14,210,208,2080,222,2290
566,2011-01-25,1,0,1,18,0,2,1,2,0.3,0.3182,0.49,0.0896,7,105,218,2180,225,2285
567,2011-01-25,1,0,1,19,0,2,1,2,0.26,0.2576,0.65,0.1642,13,195,133,1330,146,1525
568,2011-01-25,1,0,1,20,0,2,1,1,0.24,0.2273,0.65,0.194,16,240,103,1030,119,1270
569,2011-01-25,1,0,1,21,0,2,1,1,0.24,0.2273,0.65,0.194,5,75,40,400,45,475
570,2011-01-25,1,0,1,22,0,2,1,1,0.22,0.2273,0.64,0.1642,4,60,49,490,53,550
571,2011-01-25,1,0,1,23,0,2,1,2,0.22,0.2273,0.64,0.1642,3,45,37,370,40,415
572,2011-01-26,1,0,1,0,0,3,1,2,0.22,0.2273,0.69,0.1343,3,45,14,140,17,185
573,2011-01-26,1,0,1,1,0,3,1,2,0.24,0.2424,0.65,0.1343,0,0,5,50,5,50
574,2011-01-26,1,0,1,2,0,3,1,3,0.22,0.2273,0.69,0.194,3,45,7,70,10,115
575,2011-01-26,1,0,1,5,0,3,1,3,0.2,0.1818,0.86,0.2836,0,0,1,10,1,10
576,2011-01-26,1,0,1,6,0,3,1,3,0.2,0.1818,0.86,0.2836,0,0,8,80,8,80
577,2011-01-26,1,0,1,7,0,3,1,3,0.22,0.2121,0.87,0.2985,1,15,29,290,30,305
578,2011-01-26,1,0,1,8,0,3,1,3,0.22,0.2121,0.87,0.2985,3,45,69,690,72,735
579,2011-01-26,1,0,1,9,0,3,1,3,0.22,0.2121,0.87,0.2985,3,45,55,550,58,595
580,2011-01-26,1,0,1,10,0,3,1,3,0.22,0.2121,0.93,0.2836,2,30,26,260,28,290
581,2011-01-26,1,0,1,11,0,3,1,3,0.22,0.197,0.93,0.3284,6,90,35,350,41,440
582,2011-01-26,1,0,1,12,0,3,1,3,0.22,0.197,0.93,0.3284,7,105,41,410,48,515
583,2011-01-26,1,0,1,13,0,3,1,3,0.22,0.197,0.93,0.3284,4,60,43,430,47,490
584,2011-01-26,1,0,1,14,0,3,1,3,0.22,0.197,0.93,0.3582,0,0,36,360,36,360
585,2011-01-26,1,0,1,15,0,3,1,3,0.22,0.1818,0.93,0.4627,1,15,42,420,43,435
586,2011-01-26,1,0,1,16,0,3,1,4,0.22,0.197,0.93,0.3284,1,15,35,350,36,365
587,2011-01-26,1,0,1,17,0,3,1,3,0.2,0.1818,0.93,0.3582,0,0,26,260,26,260
588,2011-01-27,1,0,1,16,0,4,1,1,0.22,0.2273,0.55,0.194,1,15,23,230,24,245
589,2011-01-27,1,0,1,17,0,4,1,1,0.22,0.2424,0.55,0.1045,2,30,82,820,84,850
590,2011-01-27,1,0,1,18,0,4,1,1,0.2,0.2273,0.69,0.0896,3,45,101,1010,104,1055
591,2011-01-27,1,0,1,19,0,4,1,1,0.2,0.2273,0.69,0.0896,3,45,76,760,79,805
592,2011-01-27,1,0,1,20,0,4,1,1,0.18,0.2121,0.74,0.0896,4,60,55,550,59,610
593,2011-01-27,1,0,1,21,0,4,1,1,0.18,0.2121,0.74,0.0896,2,30,36,360,38,390
594,2011-01-27,1,0,1,22,0,4,1,1,0.18,0.2121,0.74,0.0896,0,0,27,270,27,270
595,2011-01-27,1,0,1,23,0,4,1,1,0.18,0.197,0.8,0.1642,0,0,16,160,16,160
596,2011-01-28,1,0,1,0,0,5,1,2,0.2,0.2121,0.75,0.1343,0,0,9,90,9,90
597,2011-01-28,1,0,1,1,0,5,1,2,0.2,0.2121,0.75,0.1343,1,15,2,20,3,35
598,2011-01-28,1,0,1,2,0,5,1,2,0.2,0.2121,0.75,0.1642,0,0,2,20,2,20
599,2011-01-28,1,0,1,3,0,5,1,2,0.2,0.2273,0.75,0.1045,1,15,0,0,1,15
600,2011-01-28,1,0,1,5,0,5,1,2,0.18,0.2121,0.8,0.1045,0,0,4,40,4,40
601,2011-01-28,1,0,1,6,0,5,1,2,0.18,0.197,0.8,0.1343,0,0,16,160,16,160
602,2011-01-28,1,0,1,7,0,5,1,2,0.16,0.197,0.86,0.0896,2,30,58,580,60,610
603,2011-01-28,1,0,1,8,0,5,1,2,0.16,0.197,0.86,0.0896,2,30,155,1550,157,1580
604,2011-01-28,1,0,1,9,0,5,1,3,0.18,0.2121,0.86,0.0896,6,90,95,950,101,1040
605,2011-01-28,1,0,1,10,0,5,1,3,0.18,0.2121,0.86,0.1045,0,0,49,490,49,490
606,2011-01-28,1,0,1,11,0,5,1,3,0.18,0.2121,0.93,0.1045,0,0,30,300,30,300
607,2011-01-28,1,0,1,12,0,5,1,3,0.18,0.2121,0.93,0.1045,1,15,28,280,29,295
608,2011-01-28,1,0,1,13,0,5,1,3,0.18,0.2121,0.93,0.1045,0,0,31,310,31,310
609,2011-01-28,1,0,1,14,0,5,1,3,0.22,0.2727,0.8,0.0,2,30,36,360,38,390
610,2011-01-28,1,0,1,15,0,5,1,2,0.2,0.2576,0.86,0.0,1,15,40,400,41,415
611,2011-01-28,1,0,1,16,0,5,1,1,0.22,0.2727,0.8,0.0,10,150,70,700,80,850
612,2011-01-28,1,0,1,17,0,5,1,1,0.24,0.2424,0.75,0.1343,2,30,147,1470,149,1500
613,2011-01-28,1,0,1,18,0,5,1,1,0.24,0.2273,0.75,0.194,2,30,107,1070,109,1100
614,2011-01-28,1,0,1,19,0,5,1,2,0.24,0.2424,0.75,0.1343,5,75,84,840,89,915
615,2011-01-28,1,0,1,20,0,5,1,2,0.24,0.2273,0.7,0.194,1,15,61,610,62,625
616,2011-01-28,1,0,1,21,0,5,1,2,0.22,0.2273,0.75,0.1343,1,15,57,570,58,585
617,2011-01-28,1,0,1,22,0,5,1,1,0.24,0.2121,0.65,0.3582,0,0,26,260,26,260
618,2011-01-28,1,0,1,23,0,5,1,1,0.24,0.2273,0.6,0.2239,1,15,22,220,23,235
619,2011-01-29,1,0,1,0,0,6,0,1,0.22,0.197,0.64,0.3582,2,30,26,260,28,290
620,2011-01-29,1,0,1,1,0,6,0,1,0.22,0.2273,0.64,0.194,0,0,20,200,20,200
621,2011-01-29,1,0,1,2,0,6,0,1,0.22,0.2273,0.64,0.1642,0,0,15,150,15,150
622,2011-01-29,1,0,1,3,0,6,0,1,0.2,0.2121,0.64,0.1343,3,45,5,50,8,95
623,2011-01-29,1,0,1,4,0,6,0,1,0.16,0.1818,0.69,0.1045,1,15,2,20,3,35
624,2011-01-29,1,0,1,6,0,6,0,1,0.16,0.1818,0.64,0.1343,0,0,2,20,2,20
625,2011-01-29,1,0,1,7,0,6,0,1,0.16,0.1818,0.59,0.1045,1,15,4,40,5,55
626,2011-01-29,1,0,1,8,0,6,0,1,0.18,0.197,0.55,0.1642,3,45,31,310,34,355
627,2011-01-29,1,0,1,9,0,6,0,1,0.18,0.2121,0.59,0.0896,0,0,34,340,34,340
628,2011-01-29,1,0,1,10,0,6,0,2,0.18,0.2121,0.64,0.1045,4,60,51,510,55,570
629,2011-01-29,1,0,1,11,0,6,0,2,0.18,0.197,0.64,0.1343,4,60,60,600,64,660
630,2011-01-29,1,0,1,12,0,6,0,2,0.2,0.197,0.59,0.194,12,180,66,660,78,840
631,2011-01-29,1,0,1,13,0,6,0,2,0.22,0.2273,0.55,0.1642,9,135,56,560,65,695
632,2011-01-29,1,0,1,14,0,6,0,2,0.22,0.2273,0.6,0.1343,10,150,89,890,99,1040
633,2011-01-29,1,0,1,15,0,6,0,1,0.22,0.2121,0.69,0.2537,22,330,98,980,120,1310
634,2011-01-29,1,0,1,16,0,6,0,1,0.24,0.2424,0.6,0.1642,19,285,88,880,107,1165
635,2011-01-29,1,0,1,17,0,6,0,1,0.24,0.2879,0.6,0.0,9,135,82,820,91,955
636,2011-01-29,1,0,1,18,0,6,0,1,0.22,0.2273,0.69,0.1343,9,135,59,590,68,725
637,2011-01-29,1,0,1,19,0,6,0,2,0.22,0.2121,0.69,0.2537,6,90,52,520,58,610
638,2011-01-29,1,0,1,20,0,6,0,1,0.18,0.2121,0.74,0.0896,1,15,42,420,43,435
639,2011-01-29,1,0,1,21,0,6,0,1,0.18,0.2121,0.74,0.0896,1,15,35,350,36,365
640,2011-01-29,1,0,1,22,0,6,0,1,0.16,0.197,0.8,0.0896,4,60,28,280,32,340
641,2011-01-29,1,0,1,23,0,6,0,1,0.16,0.197,0.8,0.0896,3,45,30,300,33,345
642,2011-01-30,1,0,1,0,0,0,0,1,0.16,0.1818,0.8,0.1045,0,0,33,330,33,330
643,2011-01-30,1,0,1,1,0,0,0,1,0.14,0.2121,0.8,0.0,7,105,22,220,29,325
644,2011-01-30,1,0,1,2,0,0,0,1,0.16,0.2273,0.8,0.0,1,15,10,100,11,115
645,2011-01-30,1,0,1,3,0,0,0,1,0.14,0.2121,0.93,0.0,1,15,7,70,8,85
646,2011-01-30,1,0,1,4,0,0,0,1,0.14,0.2121,0.93,0.0,0,0,1,10,1,10
647,2011-01-30,1,0,1,5,0,0,0,1,0.14,0.2121,0.86,0.0,0,0,3,30,3,30
648,2011-01-30,1,0,1,7,0,0,0,1,0.14,0.2121,0.86,0.0,0,0,3,30,3,30
649,2011-01-30,1,0,1,8,0,0,0,2,0.14,0.2121,0.86,0.0,1,15,11,110,12,125
650,2011-01-30,1,0,1,9,0,0,0,2,0.16,0.2273,0.8,0.0,4,60,34,340,38,400
651,2011-01-30,1,0,1,10,0,0,0,2,0.18,0.2424,0.8,0.0,7,105,57,570,64,675
652,2011-01-30,1,0,1,11,0,0,0,1,0.22,0.2727,0.75,0.0,9,135,50,500,59,635
653,2011-01-30,1,0,1,12,0,0,0,1,0.3,0.3182,0.52,0.1045,10,150,87,870,97,1020
654,2011-01-30,1,0,1,13,0,0,0,1,0.28,0.2879,0.61,0.1045,13,195,71,710,84,905
655,2011-01-30,1,0,1,14,0,0,0,1,0.28,0.303,0.61,0.0896,18,270,104,1040,122,1310
656,2011-01-30,1,0,1,15,0,0,0,1,0.3,0.3333,0.56,0.0,14,210,95,950,109,1160
657,2011-01-30,1,0,1,16,0,0,0,1,0.3,0.3333,0.56,0.0,19,285,104,1040,123,1325
658,2011-01-30,1,0,1,17,0,0,0,1,0.3,0.2879,0.56,0.194,6,90,71,710,77,800
659,2011-01-30,1,0,1,18,0,0,0,1,0.26,0.2576,0.65,0.1642,8,120,57,570,65,690
660,2011-01-30,1,0,1,19,0,0,0,1,0.26,0.2576,0.65,0.194,9,135,46,460,55,595
661,2011-01-30,1,0,1,20,0,0,0,2,0.26,0.2727,0.65,0.1045,3,45,30,300,33,345
662,2011-01-30,1,0,1,21,0,0,0,2,0.24,0.2424,0.7,0.1642,3,45,25,250,28,295
663,2011-01-30,1,0,1,22,0,0,0,2,0.24,0.2273,0.7,0.194,2,30,19,190,21,220
664,2011-01-30,1,0,1,23,0,0,0,2,0.24,0.2121,0.65,0.2836,5,75,16,160,21,235
665,2011-01-31,1,0,1,0,0,1,1,2,0.24,0.2273,0.65,0.2239,1,15,6,60,7,75
666,2011-01-31,1,0,1,1,0,1,1,1,0.22,0.2121,0.64,0.2537,2,30,5,50,7,80
667,2011-01-31,1,0,1,2,0,1,1,1,0.22,0.2273,0.64,0.194,0,0,1,10,1,10
668,2011-01-31,1,0,1,3,0,1,1,1,0.22,0.2273,0.64,0.194,0,0,2,20,2,20
669,2011-01-31,1,0,1,4,0,1,1,1,0.2,0.197,0.59,0.2239,0,0,2,20,2,20
670,2011-01-31,1,0,1,5,0,1,1,1,0.18,0.1667,0.64,0.2836,0,0,8,80,8,80
671,2011-01-31,1,0,1,6,0,1,1,1,0.16,0.1364,0.69,0.3284,0,0,37,370,37,370
672,2011-01-31,1,0,1,7,0,1,1,2,0.16,0.1364,0.64,0.2836,1,15,71,710,72,725
673,2011-01-31,1,0,1,8,0,1,1,2,0.16,0.1364,0.59,0.2836,3,45,182,1820,185,1865
674,2011-01-31,1,0,1,9,0,1,1,2,0.16,0.1364,0.59,0.2985,0,0,112,1120,112,1120
675,2011-01-31,1,0,1,10,0,1,1,2,0.16,0.1515,0.59,0.194,1,15,68,680,69,695
676,2011-01-31,1,0,1,11,0,1,1,2,0.16,0.1515,0.59,0.194,2,30,46,460,48,490
677,2011-01-31,1,0,1,12,0,1,1,2,0.18,0.2121,0.55,0.1045,6,90,62,620,68,710
678,2011-01-31,1,0,1,13,0,1,1,2,0.16,0.2273,0.59,0.0,2,30,52,520,54,550
679,2011-01-31,1,0,1,14,0,1,1,2,0.18,0.197,0.55,0.1343,1,15,85,850,86,865
680,2011-01-31,1,0,1,15,0,1,1,2,0.16,0.1818,0.59,0.1343,3,45,41,410,44,455
681,2011-01-31,1,0,1,16,0,1,1,2,0.16,0.1818,0.56,0.194,3,45,83,830,86,875
682,2011-01-31,1,0,1,17,0,1,1,2,0.16,0.1515,0.59,0.194,6,90,155,1550,161,1640
683,2011-01-31,1,0,1,18,0,1,1,2,0.16,0.1515,0.55,0.2239,3,45,153,1530,156,1575
684,2011-01-31,1,0,1,19,0,1,1,1,0.3,0.3182,0.61,0.1045,3,45,108,1080,111,1125
685,2011-01-31,1,0,1,20,0,1,1,3,0.16,0.1667,0.59,0.1642,0,0,78,780,78,780
686,2011-01-31,1,0,1,21,0,1,1,3,0.16,0.197,0.59,0.0896,3,45,53,530,56,575
687,2011-01-31,1,0,1,22,0,1,1,2,0.16,0.1818,0.59,0.1045,0,0,34,340,34,340
688,2011-01-31,1,0,1,23,0,1,1,2,0.16,0.197,0.64,0.0896,2,30,15,150,17,180
689,2011-02-01,1,0,2,0,0,2,1,2,0.16,0.1818,0.64,0.1045,2,30,6,60,8,90
690,2011-02-01,1,0,2,1,0,2,1,2,0.16,0.1818,0.69,0.1045,0,0,3,30,3,30
691,2011-02-01,1,0,2,2,0,2,1,2,0.16,0.2273,0.69,0.0,0,0,2,20,2,20
692,2011-02-01,1,0,2,3,0,2,1,2,0.16,0.2273,0.69,0.0,0,0,2,20,2,20
693,2011-02-01,1,0,2,5,0,2,1,3,0.14,0.2121,0.93,0.0,0,0,3,30,3,30
694,2011-02-01,1,0,2,6,0,2,1,3,0.14,0.2121,0.93,0.0,0,0,22,220,22,220
695,2011-02-01,1,0,2,7,0,2,1,3,0.16,0.2273,0.93,0.0,0,0,52,520,52,520
696,2011-02-01,1,0,2,8,0,2,1,3,0.16,0.2273,0.93,0.0,3,45,132,1320,135,1365
697,2011-02-01,1,0,2,9,0,2,1,2,0.16,0.2273,0.93,0.0,2,30,114,1140,116,1170
698,2011-02-01,1,0,2,10,0,2,1,2,0.16,0.2273,0.93,0.0,0,0,47,470,47,470
699,2011-02-01,1,0,2,11,0,2,1,2,0.18,0.2424,0.86,0.0,2,30,49,490,51,520
700,2011-02-01,1,0,2,12,0,2,1,2,0.2,0.2576,0.86,0.0,2,30,53,530,55,560
701,2011-02-01,1,0,2,13,0,2,1,2,0.2,0.2576,0.86,0.0,3,45,49,490,52,535
702,2011-02-01,1,0,2,14,0,2,1,2,0.22,0.2576,0.8,0.0896,5,75,49,490,54,565
703,2011-02-01,1,0,2,15,0,2,1,2,0.24,0.2879,0.75,0.0,7,105,45,450,52,555
704,2011-02-01,1,0,2,16,0,2,1,2,0.24,0.2424,0.75,0.1343,3,45,61,610,64,655
705,2011-02-01,1,0,2,17,0,2,1,2,0.24,0.2879,0.75,0.0,4,60,172,1720,176,1780
706,2011-02-01,1,0,2,18,0,2,1,2,0.24,0.2576,0.81,0.1045,3,45,165,1650,168,1695
707,2011-02-01,1,0,2,19,0,2,1,2,0.24,0.2424,0.81,0.1343,3,45,105,1050,108,1095
708,2011-02-01,1,0,2,20,0,2,1,2,0.22,0.2273,0.87,0.1343,5,75,69,690,74,765
709,2011-02-01,1,0,2,21,0,2,1,2,0.22,0.2273,0.87,0.1343,0,0,64,640,64,640
710,2011-02-01,1,0,2,22,0,2,1,2,0.22,0.2576,0.87,0.0896,2,30,34,340,36,370
711,2011-02-01,1,0,2,23,0,2,1,3,0.2,0.197,0.93,0.194,1,15,15,150,16,165
712,2011-02-02,1,0,2,0,0,3,1,3,0.22,0.2424,0.93,0.1045,0,0,2,20,2,20
713,2011-02-02,1,0,2,1,0,3,1,3,0.22,0.2273,0.93,0.194,0,0,3,30,3,30
714,2011-02-02,1,0,2,2,0,3,1,3,0.22,0.2273,0.93,0.1343,4,60,0,0,4,60
715,2011-02-02,1,0,2,3,0,3,1,3,0.22,0.2273,0.93,0.1343,0,0,1,10,1,10
716,2011-02-02,1,0,2,4,0,3,1,3,0.22,0.2121,0.93,0.2836,0,0,1,10,1,10
717,2011-02-02,1,0,2,5,0,3,1,3,0.22,0.2424,0.93,0.1045,0,0,3,30,3,30
718,2011-02-02,1,0,2,6,0,3,1,3,0.22,0.2424,0.93,0.1045,1,15,17,170,18,185
719,2011-02-02,1,0,2,7,0,3,1,3,0.22,0.2121,0.93,0.2239,1,15,48,480,49,495
720,2011-02-02,1,0,2,8,0,3,1,3,0.22,0.2121,0.93,0.2239,1,15,154,1540,155,1555
721,2011-02-02,1,0,2,9,0,3,1,2,0.24,0.2576,0.93,0.0896,4,60,119,1190,123,1250
722,2011-02-02,1,0,2,10,0,3,1,2,0.22,0.2727,1.0,0.0,2,30,59,590,61,620
723,2011-02-02,1,0,2,11,0,3,1,2,0.24,0.2273,0.93,0.194,5,75,47,470,52,545
724,2011-02-02,1,0,2,12,0,3,1,2,0.24,0.2273,0.93,0.2239,3,45,61,610,64,655
725,2011-02-02,1,0,2,13,0,3,1,1,0.34,0.3333,0.93,0.1642,1,15,74,740,75,755
726,2011-02-02,1,0,2,14,0,3,1,1,0.38,0.3939,0.82,0.3881,2,30,61,610,63,640
727,2011-02-02,1,0,2,15,0,3,1,1,0.38,0.3939,0.76,0.3284,10,150,66,660,76,810
728,2011-02-02,1,0,2,16,0,3,1,1,0.36,0.3333,0.71,0.2985,8,120,95,950,103,1070
729,2011-02-02,1,0,2,17,0,3,1,1,0.36,0.3182,0.53,0.5224,7,105,183,1830,190,1935
730,2011-02-02,1,0,2,18,0,3,1,1,0.34,0.2879,0.42,0.5522,7,105,175,1750,182,1855
731,2011-02-02,1,0,2,19,0,3,1,1,0.28,0.2424,0.45,0.4925,3,45,88,880,91,925
732,2011-02-02,1,0,2,20,0,3,1,1,0.24,0.197,0.48,0.5522,4,60,71,710,75,770
733,2011-02-02,1,0,2,21,0,3,1,1,0.22,0.197,0.47,0.3284,1,15,62,620,63,635
734,2011-02-02,1,0,2,22,0,3,1,1,0.22,0.2121,0.44,0.2537,5,75,35,350,40,425
735,2011-02-02,1,0,2,23,0,3,1,1,0.2,0.1667,0.44,0.4478,3,45,29,290,32,335
736,2011-02-03,1,0,2,0,0,4,1,1,0.2,0.1667,0.4,0.4478,1,15,11,110,12,125
737,2011-02-03,1,0,2,1,0,4,1,1,0.2,0.1515,0.44,0.5224,0,0,5,50,5,50
738,2011-02-03,1,0,2,2,0,4,1,1,0.18,0.1667,0.43,0.2537,0,0,2,20,2,20
739,2011-02-03,1,0,2,3,0,4,1,1,0.18,0.1667,0.43,0.2537,0,0,1,10,1,10
740,2011-02-03,1,0,2,5,0,4,1,1,0.16,0.1364,0.5,0.2985,0,0,2,20,2,20
741,2011-02-03,1,0,2,6,0,4,1,1,0.16,0.1364,0.43,0.3582,0,0,39,390,39,390
742,2011-02-03,1,0,2,7,0,4,1,1,0.14,0.1212,0.5,0.3284,1,15,86,860,87,875
743,2011-02-03,1,0,2,8,0,4,1,1,0.14,0.1212,0.5,0.3582,4,60,184,1840,188,1900
744,2011-02-03,1,0,2,9,0,4,1,1,0.16,0.1364,0.47,0.2985,6,90,127,1270,133,1360
745,2011-02-03,1,0,2,10,0,4,1,1,0.18,0.1515,0.43,0.3284,2,30,50,500,52,530
746,2011-02-03,1,0,2,11,0,4,1,1,0.18,0.1364,0.43,0.4478,9,135,55,550,64,685
747,2011-02-03,1,0,2,12,0,4,1,1,0.2,0.1818,0.4,0.3582,2,30,67,670,69,700
748,2011-02-03,1,0,2,13,0,4,1,1,0.2,0.1667,0.4,0.4179,4,60,47,470,51,530
749,2011-02-03,1,0,2,14,0,4,1,1,0.22,0.197,0.37,0.3881,4,60,43,430,47,490
750,2011-02-03,1,0,2,15,0,4,1,1,0.22,0.197,0.37,0.3284,4,60,56,560,60,620
751,2011-02-03,1,0,2,16,0,4,1,1,0.22,0.2121,0.37,0.2537,5,75,73,730,78,805
752,2011-02-03,1,0,2,17,0,4,1,1,0.2,0.197,0.4,0.194,5,75,170,1700,175,1775
753,2011-02-03,1,0,2,18,0,4,1,1,0.2,0.2121,0.4,0.1642,2,30,145,1450,147,1480
754,2011-02-03,1,0,2,19,0,4,1,1,0.2,0.2576,0.4,0.0,4,60,92,920,96,980
755,2011-02-03,1,0,2,20,0,4,1,1,0.2,0.2273,0.47,0.0896,1,15,108,1080,109,1095
756,2011-02-03,1,0,2,21,0,4,1,1,0.18,0.2121,0.55,0.1045,1,15,53,530,54,545
757,2011-02-03,1,0,2,22,0,4,1,1,0.18,0.2121,0.51,0.0896,2,30,39,390,41,420
758,2011-02-03,1,0,2,23,0,4,1,1,0.2,0.2273,0.47,0.1045,4,60,34,340,38,400
759,2011-02-04,1,0,2,0,0,5,1,2,0.2,0.2576,0.44,0.0,3,45,10,100,13,145
760,2011-02-04,1,0,2,1,0,5,1,2,0.16,0.2273,0.59,0.0,0,0,7,70,7,70
761,2011-02-04,1,0,2,2,0,5,1,2,0.14,0.1667,0.63,0.1045,0,0,1,10,1,10
762,2011-02-04,1,0,2,3,0,5,1,2,0.14,0.1667,0.63,0.1045,0,0,1,10,1,10
763,2011-02-04,1,0,2,5,0,5,1,2,0.14,0.1515,0.63,0.1343,0,0,7,70,7,70
764,2011-02-04,1,0,2,6,0,5,1,2,0.16,0.2273,0.55,0.0,2,30,26,260,28,290
765,2011-02-04,1,0,2,7,0,5,1,1,0.14,0.2121,0.59,0.0,0,0,87,870,87,870
766,2011-02-04,1,0,2,8,0,5,1,1,0.14,0.1515,0.74,0.1343,3,45,217,2170,220,2215
767,2011-02-04,1,0,2,9,0,5,1,2,0.16,0.1818,0.8,0.1343,3,45,124,1240,127,1285
768,2011-02-04,1,0,2,10,0,5,1,2,0.2,0.2121,0.51,0.1343,5,75,46,460,51,535
769,2011-02-04,1,0,2,11,0,5,1,1,0.22,0.2273,0.51,0.1642,3,45,61,610,64,655
770,2011-02-04,1,0,2,12,0,5,1,2,0.24,0.2424,0.48,0.1642,8,120,78,780,86,900
771,2011-02-04,1,0,2,13,0,5,1,2,0.26,0.2576,0.5,0.2239,9,135,73,730,82,865
772,2011-02-04,1,0,2,14,0,5,1,2,0.28,0.2727,0.45,0.1642,15,225,76,760,91,985
773,2011-02-04,1,0,2,15,0,5,1,2,0.28,0.2727,0.48,0.2537,9,135,81,810,90,945
774,2011-02-04,1,0,2,16,0,5,1,2,0.3,0.2879,0.42,0.2239,8,120,91,910,99,1030
775,2011-02-04,1,0,2,17,0,5,1,2,0.26,0.2727,0.56,0.1343,10,150,195,1950,205,2100
776,2011-02-04,1,0,2,18,0,5,1,2,0.24,0.2576,0.6,0.1045,3,45,152,1520,155,1565
777,2011-02-04,1,0,2,19,0,5,1,2,0.24,0.2424,0.65,0.1343,1,15,102,1020,103,1035
778,2011-02-04,1,0,2,20,0,5,1,2,0.24,0.2424,0.65,0.1642,2,30,69,690,71,720
779,2011-02-04,1,0,2,21,0,5,1,2,0.24,0.2424,0.7,0.1642,2,30,41,410,43,440
780,2011-02-04,1,0,2,22,0,5,1,2,0.24,0.2424,0.65,0.1642,1,15,45,450,46,465
781,2011-02-04,1,0,2,23,0,5,1,2,0.24,0.2424,0.7,0.1343,1,15,30,300,31,315
782,2011-02-05,1,0,2,0,0,6,0,2,0.24,0.2424,0.7,0.1642,3,45,36,360,39,405
783,2011-02-05,1,0,2,1,0,6,0,2,0.24,0.2424,0.65,0.1642,1,15,17,170,18,185
784,2011-02-05,1,0,2,2,0,6,0,2,0.24,0.2424,0.75,0.1642,5,75,12,120,17,195
785,2011-02-05,1,0,2,3,0,6,0,2,0.24,0.2424,0.75,0.1642,1,15,10,100,11,115
786,2011-02-05,1,0,2,4,0,6,0,3,0.22,0.2273,0.93,0.1343,0,0,8,80,8,80
787,2011-02-05,1,0,2,5,0,6,0,3,0.2,0.2273,1.0,0.0896,0,0,9,90,9,90
788,2011-02-05,1,0,2,6,0,6,0,3,0.2,0.2576,1.0,0.0,0,0,4,40,4,40
789,2011-02-05,1,0,2,7,0,6,0,3,0.22,0.2576,0.93,0.0896,0,0,4,40,4,40
790,2011-02-05,1,0,2,8,0,6,0,3,0.2,0.2273,1.0,0.0896,0,0,10,100,10,100
791,2011-02-05,1,0,2,9,0,6,0,3,0.2,0.2273,1.0,0.0896,3,45,17,170,20,215
792,2011-02-05,1,0,2,10,0,6,0,3,0.2,0.2121,1.0,0.1343,3,45,31,310,34,355
793,2011-02-05,1,0,2,11,0,6,0,3,0.22,0.2273,1.0,0.1343,1,15,46,460,47,475
794,2011-02-05,1,0,2,12,0,6,0,3,0.22,0.2273,1.0,0.1642,10,150,42,420,52,570
795,2011-02-05,1,0,2,13,0,6,0,3,0.22,0.2273,1.0,0.1642,10,150,62,620,72,770
796,2011-02-05,1,0,2,14,0,6,0,3,0.22,0.2727,1.0,0.0,5,75,50,500,55,575
797,2011-02-05,1,0,2,15,0,6,0,3,0.22,0.2727,1.0,0.0,11,165,49,490,60,655
798,2011-02-05,1,0,2,16,0,6,0,3,0.22,0.2273,1.0,0.1343,8,120,63,630,71,750
799,2011-02-05,1,0,2,17,0,6,0,2,0.24,0.2121,1.0,0.2836,14,210,64,640,78,850
800,2011-02-05,1,0,2,18,0,6,0,2,0.28,0.2424,0.93,0.4478,2,30,81,810,83,840
801,2011-02-05,1,0,2,19,0,6,0,2,0.28,0.2424,0.93,0.4478,6,90,78,780,84,870
802,2011-02-05,1,0,2,20,0,6,0,1,0.3,0.2879,0.87,0.2537,5,75,64,640,69,715
803,2011-02-05,1,0,2,21,0,6,0,1,0.26,0.2576,1.0,0.194,3,45,53,530,56,575
804,2011-02-05,1,0,2,22,0,6,0,1,0.26,0.2727,0.93,0.1343,2,30,43,430,45,460
805,2011-02-05,1,0,2,23,0,6,0,1,0.26,0.2576,0.93,0.2239,7,105,52,520,59,625
806,2011-02-06,1,0,2,0,0,0,0,1,0.26,0.2576,0.7,0.194,2,30,37,370,39,400
807,2011-02-06,1,0,2,1,0,0,0,1,0.26,0.2273,0.65,0.4179,4,60,40,400,44,460
808,2011-02-06,1,0,2,2,0,0,0,1,0.26,0.2273,0.6,0.3284,0,0,20,200,20,200
809,2011-02-06,1,0,2,3,0,0,0,1,0.26,0.2879,0.6,0.0896,3,45,10,100,13,145
810,2011-02-06,1,0,2,4,0,0,0,1,0.26,0.2273,0.6,0.3582,0,0,2,20,2,20
811,2011-02-06,1,0,2,5,0,0,0,1,0.26,0.2576,0.6,0.2239,0,0,1,10,1,10
812,2011-02-06,1,0,2,6,0,0,0,1,0.26,0.2576,0.6,0.2239,0,0,1,10,1,10
813,2011-02-06,1,0,2,7,0,0,0,1,0.24,0.2424,0.65,0.1642,0,0,8,80,8,80
814,2011-02-06,1,0,2,8,0,0,0,1,0.24,0.2576,0.65,0.1045,2,30,21,210,23,240
815,2011-02-06,1,0,2,9,0,0,0,1,0.28,0.2879,0.56,0.1045,7,105,38,380,45,485
816,2011-02-06,1,0,2,10,0,0,0,1,0.3,0.2879,0.52,0.2537,15,225,74,740,89,965
817,2011-02-06,1,0,2,11,0,0,0,1,0.32,0.303,0.49,0.2537,28,420,89,890,117,1310
818,2011-02-06,1,0,2,12,0,0,0,1,0.34,0.3333,0.46,0.0,48,720,126,1260,174,1980
819,2011-02-06,1,0,2,13,0,0,0,1,0.34,0.3636,0.46,0.0,47,705,135,1350,182,2055
820,2011-02-06,1,0,2,14,0,0,0,1,0.34,0.3485,0.46,0.0896,47,705,114,1140,161,1845
821,2011-02-06,1,0,2,15,0,0,0,1,0.34,0.3485,0.46,0.0896,52,780,130,1300,182,2080
822,2011-02-06,1,0,2,16,0,0,0,1,0.34,0.3485,0.49,0.1045,42,630,115,1150,157,1780
823,2011-02-06,1,0,2,17,0,0,0,1,0.34,0.3636,0.46,0.0,24,360,97,970,121,1330
824,2011-02-06,1,0,2,18,0,0,0,1,0.3,0.303,0.56,0.1642,13,195,65,650,78,845
825,2011-02-06,1,0,2,19,0,0,0,1,0.28,0.2879,0.61,0.1343,1,15,20,200,21,215
826,2011-02-06,1,0,2,20,0,0,0,1,0.28,0.2879,0.61,0.1045,5,75,21,210,26,285
827,2011-02-06,1,0,2,21,0,0,0,1,0.26,0.303,0.6,0.0,5,75,22,220,27,295
828,2011-02-06,1,0,2,22,0,0,0,1,0.26,0.303,0.6,0.0,5,75,57,570,62,645
829,2011-02-06,1,0,2,23,0,0,0,1,0.24,0.2879,0.65,0.0,4,60,26,260,30,320
830,2011-02-07,1,0,2,0,0,1,1,1,0.24,0.2879,0.65,0.0,1,15,14,140,15,155
831,2011-02-07,1,0,2,1,0,1,1,1,0.22,0.2727,0.75,0.0,1,15,4,40,5,55
832,2011-02-07,1,0,2,2,0,1,1,1,0.2,0.2576,0.8,0.0,0,0,3,30,3,30
833,2011-02-07,1,0,2,3,0,1,1,1,0.2,0.2576,0.86,0.0,0,0,1,10,1,10
834,2011-02-07,1,0,2,4,0,1,1,1,0.2,0.2576,0.86,0.0,1,15,1,10,2,25
835,2011-02-07,1,0,2,5,0,1,1,1,0.2,0.2576,0.86,0.0,1,15,9,90,10,105
836,2011-02-07,1,0,2,6,0,1,1,1,0.18,0.2424,0.93,0.0,1,15,29,290,30,305
837,2011-02-07,1,0,2,7,0,1,1,1,0.18,0.2424,0.86,0.0,6,90,89,890,95,980
838,2011-02-07,1,0,2,8,0,1,1,2,0.16,0.2273,1.0,0.0,7,105,223,2230,230,2335
839,2011-02-07,1,0,2,9,0,1,1,1,0.22,0.2727,0.8,0.0,3,45,115,1150,118,1195
840,2011-02-07,1,0,2,10,0,1,1,1,0.24,0.2576,0.75,0.1045,6,90,49,490,55,580
841,2011-02-07,1,0,2,11,0,1,1,1,0.3,0.3182,0.65,0.0896,11,165,36,360,47,525
842,2011-02-07,1,0,2,12,0,1,1,2,0.32,0.3485,0.62,0.0,7,105,59,590,66,695
843,2011-02-07,1,0,2,13,0,1,1,2,0.36,0.3636,0.57,0.0896,10,150,54,540,64,690
844,2011-02-07,1,0,2,14,0,1,1,2,0.36,0.3636,0.57,0.0896,8,120,52,520,60,640
845,2011-02-07,1,0,2,15,0,1,1,2,0.38,0.3939,0.54,0.0896,4,60,46,460,50,520
846,2011-02-07,1,0,2,16,0,1,1,2,0.36,0.3485,0.57,0.1343,16,240,98,980,114,1220
847,2011-02-07,1,0,2,17,0,1,1,2,0.32,0.3182,0.7,0.1642,9,135,207,2070,216,2205
848,2011-02-07,1,0,2,18,0,1,1,2,0.34,0.3333,0.66,0.1343,5,75,170,1700,175,1775
849,2011-02-07,1,0,2,19,0,1,1,2,0.32,0.3485,0.7,0.0,5,75,123,1230,128,1305
850,2011-02-07,1,0,2,20,0,1,1,2,0.32,0.3333,0.7,0.1045,6,90,82,820,88,910
851,2011-02-07,1,0,2,21,0,1,1,1,0.32,0.3485,0.7,0.0,3,45,75,750,78,795
852,2011-02-07,1,0,2,22,0,1,1,1,0.28,0.303,0.81,0.0896,3,45,34,340,37,385
853,2011-02-07,1,0,2,23,0,1,1,2,0.3,0.3333,0.81,0.0,6,90,19,190,25,280
854,2011-02-08,1,0,2,0,0,2,1,2,0.28,0.3182,0.87,0.0,4,60,6,60,10,120
855,2011-02-08,1,0,2,1,0,2,1,2,0.28,0.3182,0.87,0.0,0,0,4,40,4,40
856,2011-02-08,1,0,2,2,0,2,1,2,0.26,0.2727,0.93,0.1045,1,15,1,10,2,25
857,2011-02-08,1,0,2,3,0,2,1,3,0.28,0.2727,0.93,0.1642,0,0,1,10,1,10
858,2011-02-08,1,0,2,4,0,2,1,1,0.26,0.2576,0.93,0.1642,0,0,3,30,3,30
859,2011-02-08,1,0,2,5,0,2,1,1,0.26,0.2273,0.81,0.3284,0,0,2,20,2,20
860,2011-02-08,1,0,2,6,0,2,1,1,0.26,0.2273,0.7,0.3284,0,0,39,390,39,390
861,2011-02-08,1,0,2,7,0,2,1,1,0.24,0.197,0.65,0.4179,3,45,97,970,100,1015
862,2011-02-08,1,0,2,8,0,2,1,1,0.24,0.197,0.56,0.4925,7,105,236,2360,243,2465
863,2011-02-08,1,0,2,9,0,2,1,1,0.24,0.197,0.52,0.4925,7,105,128,1280,135,1385
864,2011-02-08,1,0,2,10,0,2,1,1,0.22,0.1818,0.47,0.5522,4,60,44,440,48,500
865,2011-02-08,1,0,2,11,0,2,1,1,0.22,0.1818,0.47,0.4627,1,15,49,490,50,505
866,2011-02-08,1,0,2,12,0,2,1,1,0.24,0.197,0.38,0.4925,2,30,63,630,65,660
867,2011-02-08,1,0,2,13,0,2,1,2,0.24,0.197,0.32,0.4478,2,30,48,480,50,510
868,2011-02-08,1,0,2,14,0,2,1,1,0.22,0.197,0.37,0.4179,3,45,61,610,64,655
869,2011-02-08,1,0,2,15,0,2,1,1,0.22,0.197,0.35,0.3881,6,90,45,450,51,540
870,2011-02-08,1,0,2,16,0,2,1,1,0.22,0.1818,0.35,0.5224,4,60,79,790,83,850
871,2011-02-08,1,0,2,17,0,2,1,1,0.22,0.1818,0.32,0.5821,4,60,172,1720,176,1780
872,2011-02-08,1,0,2,18,0,2,1,1,0.2,0.1818,0.32,0.3881,1,15,151,1510,152,1525
873,2011-02-08,1,0,2,19,0,2,1,1,0.16,0.1212,0.4,0.4627,1,15,100,1000,101,1015
874,2011-02-08,1,0,2,20,0,2,1,1,0.16,0.1364,0.4,0.3284,3,45,53,530,56,575
875,2011-02-08,1,0,2,21,0,2,1,1,0.14,0.1061,0.33,0.4627,8,120,46,460,54,580
876,2011-02-08,1,0,2,22,0,2,1,1,0.12,0.1061,0.33,0.3582,0,0,29,290,29,290
877,2011-02-08,1,0,2,23,0,2,1,1,0.12,0.1061,0.33,0.3284,3,45,9,90,12,135
878,2011-02-09,1,0,2,0,0,3,1,1,0.1,0.0758,0.36,0.3582,0,0,17,170,17,170
879,2011-02-09,1,0,2,1,0,3,1,1,0.1,0.1061,0.36,0.2239,0,0,7,70,7,70
880,2011-02-09,1,0,2,2,0,3,1,1,0.08,0.0758,0.38,0.2836,1,15,2,20,3,35
881,2011-02-09,1,0,2,3,0,3,1,1,0.06,0.0758,0.45,0.1343,0,0,2,20,2,20
882,2011-02-09,1,0,2,5,0,3,1,1,0.06,0.1061,0.45,0.1045,0,0,7,70,7,70
883,2011-02-09,1,0,2,6,0,3,1,1,0.06,0.1515,0.45,0.0,0,0,43,430,43,430
884,2011-02-09,1,0,2,7,0,3,1,1,0.06,0.1061,0.49,0.1045,4,60,95,950,99,1010
885,2011-02-09,1,0,2,8,0,3,1,1,0.1,0.1364,0.42,0.0,1,15,198,1980,199,1995
886,2011-02-09,1,0,2,9,0,3,1,1,0.12,0.1364,0.39,0.1642,4,60,119,1190,123,1250
887,2011-02-09,1,0,2,10,0,3,1,1,0.14,0.1818,0.36,0.0,8,120,51,510,59,630
888,2011-02-09,1,0,2,11,0,3,1,2,0.14,0.1515,0.43,0.1642,1,15,40,400,41,415
889,2011-02-09,1,0,2,12,0,3,1,2,0.18,0.1818,0.4,0.2239,4,60,57,570,61,630
890,2011-02-09,1,0,2,13,0,3,1,1,0.18,0.1667,0.4,0.2537,2,30,67,670,69,700
891,2011-02-09,1,0,2,14,0,3,1,1,0.2,0.1818,0.34,0.2985,2,30,56,560,58,590
892,2011-02-09,1,0,2,15,0,3,1,2,0.2,0.1818,0.34,0.2836,3,45,61,610,64,655
893,2011-02-09,1,0,2,16,0,3,1,2,0.2,0.197,0.37,0.2537,7,105,72,720,79,825
894,2011-02-09,1,0,2,17,0,3,1,2,0.2,0.197,0.34,0.2537,9,135,157,1570,166,1705
895,2011-02-09,1,0,2,18,0,3,1,2,0.18,0.1667,0.47,0.2985,2,30,168,1680,170,1710
896,2011-02-09,1,0,2,19,0,3,1,3,0.14,0.1212,0.86,0.2537,1,15,87,870,88,885
897,2011-02-09,1,0,2,20,0,3,1,3,0.14,0.1515,0.86,0.1642,0,0,84,840,84,840
898,2011-02-09,1,0,2,21,0,3,1,2,0.14,0.1515,0.86,0.1642,0,0,83,830,83,830
899,2011-02-09,1,0,2,22,0,3,1,3,0.16,0.1667,0.8,0.1642,4,60,42,420,46,480
900,2011-02-09,1,0,2,23,0,3,1,3,0.16,0.1515,0.8,0.194,0,0,37,370,37,370
901,2011-02-10,1,0,2,0,0,4,1,3,0.14,0.1364,0.86,0.194,0,0,16,160,16,160
902,2011-02-10,1,0,2,1,0,4,1,3,0.14,0.1515,0.8,0.1343,0,0,7,70,7,70
903,2011-02-10,1,0,2,2,0,4,1,3,0.14,0.1515,0.8,0.1343,0,0,3,30,3,30
904,2011-02-10,1,0,2,4,0,4,1,2,0.14,0.1364,0.59,0.2239,0,0,1,10,1,10
905,2011-02-10,1,0,2,5,0,4,1,2,0.12,0.1212,0.5,0.2239,0,0,6,60,6,60
906,2011-02-10,1,0,2,6,0,4,1,2,0.12,0.1212,0.54,0.2836,0,0,26,260,26,260
907,2011-02-10,1,0,2,7,0,4,1,1,0.1,0.0758,0.5,0.4179,0,0,99,990,99,990
908,2011-02-10,1,0,2,8,0,4,1,1,0.1,0.0758,0.49,0.3284,5,75,173,1730,178,1805
909,2011-02-10,1,0,2,9,0,4,1,1,0.12,0.1061,0.42,0.3582,1,15,121,1210,122,1225
910,2011-02-10,1,0,2,10,0,4,1,1,0.12,0.1061,0.42,0.2985,1,15,34,340,35,355
911,2011-02-10,1,0,2,11,0,4,1,1,0.14,0.1212,0.39,0.3582,1,15,44,440,45,455
912,2011-02-10,1,0,2,12,0,4,1,1,0.16,0.1364,0.34,0.3881,4,60,65,650,69,710
913,2011-02-10,1,0,2,13,0,4,1,1,0.18,0.1667,0.29,0.2985,3,45,59,590,62,635
914,2011-02-10,1,0,2,14,0,4,1,1,0.2,0.1818,0.27,0.2836,6,90,42,420,48,510
915,2011-02-10,1,0,2,15,0,4,1,1,0.2,0.197,0.25,0.2537,0,0,50,500,50,500
916,2011-02-10,1,0,2,16,0,4,1,1,0.2,0.1818,0.27,0.2985,4,60,76,760,80,820
917,2011-02-10,1,0,2,17,0,4,1,1,0.18,0.1818,0.26,0.194,6,90,159,1590,165,1680
918,2011-02-10,1,0,2,18,0,4,1,1,0.16,0.1818,0.28,0.1343,3,45,157,1570,160,1615
919,2011-02-10,1,0,2,19,0,4,1,1,0.14,0.1667,0.28,0.1045,2,30,110,1100,112,1130
920,2011-02-10,1,0,2,20,0,4,1,1,0.14,0.1818,0.31,0.0896,4,60,93,930,97,990
921,2011-02-10,1,0,2,21,0,4,1,1,0.14,0.2121,0.39,0.0,2,30,70,700,72,730
922,2011-02-10,1,0,2,22,0,4,1,1,0.12,0.197,0.39,0.0,4,60,47,470,51,530
923,2011-02-10,1,0,2,23,0,4,1,1,0.12,0.1515,0.42,0.1045,1,15,33,330,34,345
924,2011-02-11,1,0,2,0,0,5,1,1,0.1,0.1364,0.49,0.1045,2,30,12,120,14,150
925,2011-02-11,1,0,2,1,0,5,1,1,0.1,0.1364,0.54,0.0896,1,15,6,60,7,75
926,2011-02-11,1,0,2,2,0,5,1,1,0.1,0.1364,0.54,0.0896,0,0,3,30,3,30
927,2011-02-11,1,0,2,5,0,5,1,1,0.08,0.1212,0.63,0.0896,0,0,4,40,4,40
928,2011-02-11,1,0,2,6,0,5,1,1,0.1,0.1818,0.68,0.0,1,15,23,230,24,245
929,2011-02-11,1,0,2,7,0,5,1,1,0.08,0.1667,0.73,0.0,1,15,73,730,74,745
930,2011-02-11,1,0,2,8,0,5,1,1,0.1,0.1212,0.74,0.1642,4,60,212,2120,216,2180
931,2011-02-11,1,0,2,9,0,5,1,1,0.12,0.1212,0.74,0.2239,8,120,132,1320,140,1440
932,2011-02-11,1,0,2,10,0,5,1,1,0.14,0.1364,0.69,0.194,5,75,39,390,44,465
933,2011-02-11,1,0,2,11,0,5,1,1,0.22,0.2273,0.47,0.1343,12,180,52,520,64,700
934,2011-02-11,1,0,2,12,0,5,1,1,0.22,0.2273,0.47,0.1343,7,105,64,640,71,745
935,2011-02-11,1,0,2,13,0,5,1,1,0.24,0.2273,0.35,0.194,21,315,89,890,110,1205
936,2011-02-11,1,0,2,14,0,5,1,1,0.3,0.2879,0.26,0.2537,17,255,67,670,84,925
937,2011-02-11,1,0,2,15,0,5,1,1,0.32,0.3182,0.21,0.1642,12,180,62,620,74,800
938,2011-02-11,1,0,2,16,0,5,1,1,0.3,0.2879,0.28,0.194,14,210,111,1110,125,1320
939,2011-02-11,1,0,2,17,0,5,1,1,0.3,0.3333,0.24,0.0,18,270,193,1930,211,2200
940,2011-02-11,1,0,2,18,0,5,1,1,0.28,0.3182,0.28,0.0,9,135,165,1650,174,1785
941,2011-02-11,1,0,2,19,0,5,1,1,0.26,0.303,0.33,0.0,7,105,94,940,101,1045
942,2011-02-11,1,0,2,20,0,5,1,1,0.22,0.2273,0.55,0.1343,2,30,61,610,63,640
943,2011-02-11,1,0,2,21,0,5,1,1,0.2,0.2121,0.59,0.1343,1,15,46,460,47,475
944,2011-02-11,1,0,2,22,0,5,1,1,0.2,0.2273,0.64,0.0896,2,30,41,410,43,440
945,2011-02-11,1,0,2,23,0,5,1,1,0.18,0.2424,0.69,0.0,5,75,48,480,53,555
946,2011-02-12,1,0,2,0,0,6,0,1,0.16,0.197,0.69,0.0896,3,45,27,270,30,315
947,2011-02-12,1,0,2,1,0,6,0,1,0.14,0.2121,0.86,0.0,2,30,22,220,24,250
948,2011-02-12,1,0,2,2,0,6,0,1,0.14,0.2121,0.8,0.0,2,30,13,130,15,160
949,2011-02-12,1,0,2,3,0,6,0,1,0.12,0.197,0.8,0.0,3,45,7,70,10,115
950,2011-02-12,1,0,2,4,0,6,0,1,0.12,0.1667,0.74,0.0896,0,0,4,40,4,40
951,2011-02-12,1,0,2,5,0,6,0,1,0.12,0.1667,0.74,0.0896,0,0,1,10,1,10
952,2011-02-12,1,0,2,6,0,6,0,1,0.12,0.1364,0.93,0.194,1,15,1,10,2,25
953,2011-02-12,1,0,2,7,0,6,0,1,0.12,0.1515,0.8,0.1045,2,30,9,90,11,120
954,2011-02-12,1,0,2,8,0,6,0,1,0.14,0.1515,0.86,0.1343,2,30,28,280,30,310
955,2011-02-12,1,0,2,9,0,6,0,1,0.16,0.1818,0.64,0.1343,5,75,38,380,43,455
956,2011-02-12,1,0,2,10,0,6,0,1,0.22,0.2121,0.41,0.2537,13,195,71,710,84,905
957,2011-02-12,1,0,2,11,0,6,0,1,0.3,0.2727,0.28,0.3284,30,450,84,840,114,1290
958,2011-02-12,1,0,2,12,0,6,0,1,0.3,0.2727,0.39,0.4627,27,405,93,930,120,1335
959,2011-02-12,1,0,2,13,0,6,0,1,0.3,0.2727,0.39,0.4179,32,480,103,1030,135,1510
960,2011-02-12,1,0,2,14,0,6,0,1,0.34,0.3182,0.31,0.2836,30,450,90,900,120,1350
961,2011-02-12,1,0,2,15,0,6,0,1,0.34,0.303,0.29,0.4179,47,705,127,1270,174,1975
962,2011-02-12,1,0,2,16,0,6,0,1,0.34,0.303,0.29,0.4179,42,630,103,1030,145,1660
963,2011-02-12,1,0,2,17,0,6,0,1,0.32,0.2879,0.31,0.5224,24,360,113,1130,137,1490
964,2011-02-12,1,0,2,18,0,6,0,1,0.28,0.2576,0.38,0.3284,4,60,60,600,64,660
965,2011-02-12,1,0,2,19,0,6,0,1,0.28,0.2727,0.38,0.1642,2,30,39,390,41,420
966,2011-02-12,1,0,2,20,0,6,0,1,0.26,0.2576,0.41,0.2239,1,15,39,390,40,405
967,2011-02-12,1,0,2,21,0,6,0,1,0.26,0.303,0.41,0.0,9,135,42,420,51,555
968,2011-02-12,1,0,2,22,0,6,0,1,0.24,0.2576,0.44,0.0896,6,90,39,390,45,480
969,2011-02-12,1,0,2,23,0,6,0,1,0.22,0.2273,0.51,0.1343,1,15,31,310,32,325
970,2011-02-13,1,0,2,0,0,0,0,1,0.2,0.2273,0.64,0.1045,5,75,34,340,39,415
971,2011-02-13,1,0,2,1,0,0,0,1,0.2,0.2273,0.59,0.0896,1,15,23,230,24,245
972,2011-02-13,1,0,2,2,0,0,0,2,0.2,0.2273,0.75,0.0896,1,15,19,190,20,205
973,2011-02-13,1,0,2,3,0,0,0,2,0.2,0.2273,0.69,0.1045,4,60,8,80,12,140
974,2011-02-13,1,0,2,4,0,0,0,2,0.2,0.2121,0.69,0.1642,0,0,2,20,2,20
975,2011-02-13,1,0,2,6,0,0,0,2,0.2,0.2121,0.69,0.1343,2,30,3,30,5,60
976,2011-02-13,1,0,2,7,0,0,0,2,0.22,0.2727,0.55,0.0,0,0,3,30,3,30
977,2011-02-13,1,0,2,8,0,0,0,2,0.22,0.2273,0.64,0.194,1,15,11,110,12,125
978,2011-02-13,1,0,2,9,0,0,0,2,0.24,0.2273,0.6,0.2239,12,180,35,350,47,530
979,2011-02-13,1,0,2,10,0,0,0,1,0.3,0.2727,0.45,0.3284,19,285,86,860,105,1145
980,2011-02-13,1,0,2,11,0,0,0,1,0.32,0.2879,0.39,0.4478,26,390,86,860,112,1250
981,2011-02-13,1,0,2,12,0,0,0,1,0.36,0.3182,0.32,0.4627,58,870,94,940,152,1810
982,2011-02-13,1,0,2,13,0,0,0,1,0.38,0.3939,0.29,0.3582,62,930,92,920,154,1850
983,2011-02-13,1,0,2,14,0,0,0,2,0.4,0.4091,0.3,0.4179,51,765,110,1100,161,1865
984,2011-02-13,1,0,2,15,0,0,0,2,0.4,0.4091,0.3,0.2985,40,600,122,1220,162,1820
985,2011-02-13,1,0,2,16,0,0,0,2,0.42,0.4242,0.28,0.3284,28,420,106,1060,134,1480
986,2011-02-13,1,0,2,17,0,0,0,1,0.42,0.4242,0.28,0.3284,30,450,95,950,125,1400
987,2011-02-13,1,0,2,18,0,0,0,1,0.4,0.4091,0.32,0.2985,17,255,78,780,95,1035
988,2011-02-13,1,0,2,19,0,0,0,1,0.4,0.4091,0.35,0.2836,11,165,50,500,61,665
989,2011-02-13,1,0,2,20,0,0,0,1,0.4,0.4091,0.35,0.3284,15,225,32,320,47,545
990,2011-02-13,1,0,2,21,0,0,0,1,0.4,0.4091,0.35,0.3582,6,90,45,450,51,540
991,2011-02-13,1,0,2,22,0,0,0,1,0.4,0.4091,0.35,0.2985,5,75,31,310,36,385
992,2011-02-13,1,0,2,23,0,0,0,1,0.4,0.4091,0.35,0.3582,3,45,27,270,30,315
993,2011-02-14,1,0,2,0,0,1,1,1,0.38,0.3939,0.37,0.3582,3,45,8,80,11,125
994,2011-02-14,1,0,2,1,0,1,1,1,0.38,0.3939,0.37,0.3582,1,15,6,60,7,75
995,2011-02-14,1,0,2,2,0,1,1,1,0.36,0.3333,0.4,0.2985,0,0,2,20,2,20
996,2011-02-14,1,0,2,3,0,1,1,1,0.34,0.3182,0.46,0.2239,1,15,1,10,2,25
997,2011-02-14,1,0,2,4,0,1,1,1,0.32,0.303,0.53,0.2836,0,0,2,20,2,20
998,2011-02-14,1,0,2,5,0,1,1,1,0.32,0.303,0.53,0.2836,0,0,3,30,3,30
999,2011-02-14,1,0,2,6,0,1,1,1,0.34,0.303,0.46,0.2985,1,15,25,250,26,265
1000,2011-02-14,1,0,2,7,0,1,1,1,0.34,0.303,0.46,0.2985,2,30,96,960,98,990
1001,2011-02-14,1,0,2,8,0,1,1,1,0.38,0.3939,0.4,0.4627,7,105,249,2490,256,2595
1002,2011-02-14,1,0,2,9,0,1,1,1,0.4,0.4091,0.37,0.3881,8,120,122,1220,130,1340
1003,2011-02-14,1,0,2,10,0,1,1,1,0.44,0.4394,0.33,0.2239,9,135,46,460,55,595
1004,2011-02-14,1,0,2,11,0,1,1,1,0.52,0.5,0.23,0.2537,10,150,43,430,53,580
1005,2011-02-14,1,0,2,12,0,1,1,1,0.56,0.5303,0.22,0.4478,27,405,99,990,126,1395
1006,2011-02-14,1,0,2,13,0,1,1,1,0.58,0.5455,0.19,0.3881,27,405,93,930,120,1335
1007,2011-02-14,1,0,2,14,0,1,1,1,0.6,0.5909,0.15,0.4925,14,210,76,760,90,970
1008,2011-02-14,1,0,2,15,0,1,1,1,0.56,0.5303,0.21,0.6567,19,285,71,710,90,995
1009,2011-02-14,1,0,2,16,0,1,1,1,0.52,0.5,0.27,0.4627,16,240,102,1020,118,1260
1010,2011-02-14,1,0,2,17,0,1,1,1,0.46,0.4545,0.33,0.6119,25,375,218,2180,243,2555
1011,2011-02-14,1,0,2,18,0,1,1,1,0.4,0.4091,0.4,0.6119,11,165,194,1940,205,2105
1012,2011-02-14,1,0,2,19,0,1,1,1,0.38,0.3939,0.43,0.4925,12,180,86,860,98,1040
1013,2011-02-14,1,0,2,20,0,1,1,1,0.36,0.3182,0.46,0.4627,5,75,65,650,70,725
1014,2011-02-14,1,0,2,21,0,1,1,1,0.36,0.3182,0.5,0.5224,8,120,35,350,43,470
1015,2011-02-14,1,0,2,22,0,1,1,1,0.34,0.2879,0.46,0.6567,1,15,44,440,45,455
1016,2011-02-14,1,0,2,23,0,1,1,1,0.32,0.2879,0.49,0.4925,1,15,19,190,20,205
1017,2011-02-15,1,0,2,0,0,2,1,1,0.3,0.2727,0.49,0.4179,7,105,12,120,19,225
1018,2011-02-15,1,0,2,1,0,2,1,1,0.3,0.2424,0.42,0.7761,0,0,5,50,5,50
1019,2011-02-15,1,0,2,2,0,2,1,1,0.28,0.2273,0.41,0.6866,1,15,2,20,3,35
1020,2011-02-15,1,0,2,4,0,2,1,1,0.22,0.1818,0.37,0.5224,0,0,1,10,1,10
1021,2011-02-15,1,0,2,5,0,2,1,1,0.22,0.1818,0.32,0.4627,0,0,4,40,4,40
1022,2011-02-15,1,0,2,6,0,2,1,1,0.2,0.1818,0.32,0.3284,0,0,30,300,30,300
1023,2011-02-15,1,0,2,7,0,2,1,1,0.2,0.1818,0.32,0.3582,2,30,103,1030,105,1060
1024,2011-02-15,1,0,2,8,0,2,1,1,0.2,0.1818,0.32,0.3582,10,150,213,2130,223,2280
1025,2011-02-15,1,0,2,9,0,2,1,1,0.22,0.197,0.29,0.4478,2,30,108,1080,110,1110
1026,2011-02-15,1,0,2,10,0,2,1,1,0.24,0.2121,0.27,0.2836,5,75,47,470,52,545
1027,2011-02-15,1,0,2,11,0,2,1,1,0.26,0.2424,0.25,0.2537,11,165,46,460,57,625
1028,2011-02-15,1,0,2,12,0,2,1,1,0.28,0.2727,0.24,0.2537,6,90,65,650,71,740
1029,2011-02-15,1,0,2,13,0,2,1,1,0.32,0.303,0.21,0.2239,14,210,68,680,82,890
1030,2011-02-15,1,0,2,14,0,2,1,1,0.34,0.3182,0.19,0.2239,10,150,69,690,79,840
1031,2011-02-15,1,0,2,15,0,2,1,1,0.34,0.3333,0.19,0.1642,11,165,74,740,85,905
1032,2011-02-15,1,0,2,16,0,2,1,1,0.34,0.3182,0.19,0.2537,21,315,77,770,98,1085
1033,2011-02-15,1,0,2,17,0,2,1,1,0.32,0.303,0.22,0.2239,15,225,191,1910,206,2135
1034,2011-02-15,1,0,2,18,0,2,1,1,0.3,0.303,0.22,0.1343,14,210,198,1980,212,2190
1035,2011-02-15,1,0,2,19,0,2,1,1,0.28,0.2879,0.26,0.1343,3,45,142,1420,145,1465
1036,2011-02-15,1,0,2,20,0,2,1,1,0.26,0.2727,0.33,0.1045,3,45,98,980,101,1025
1037,2011-02-15,1,0,2,21,0,2,1,1,0.24,0.2879,0.52,0.0,5,75,61,610,66,685
1038,2011-02-15,1,0,2,22,0,2,1,1,0.24,0.2879,0.44,0.0,0,0,41,410,41,410
1039,2011-02-15,1,0,2,23,0,2,1,2,0.22,0.2576,0.44,0.0896,0,0,20,200,20,200
1040,2011-02-16,1,0,2,0,0,3,1,1,0.22,0.2576,0.41,0.0896,0,0,15,150,15,150
1041,2011-02-16,1,0,2,1,0,3,1,1,0.2,0.2273,0.44,0.0896,0,0,9,90,9,90
1042,2011-02-16,1,0,2,3,0,3,1,2,0.2,0.197,0.47,0.194,0,0,1,10,1,10
1043,2011-02-16,1,0,2,4,0,3,1,1,0.2,0.197,0.51,0.194,0,0,1,10,1,10
1044,2011-02-16,1,0,2,5,0,3,1,1,0.2,0.197,0.47,0.194,0,0,5,50,5,50
1045,2011-02-16,1,0,2,6,0,3,1,1,0.2,0.197,0.55,0.2239,1,15,32,320,33,335
1046,2011-02-16,1,0,2,7,0,3,1,2,0.2,0.197,0.55,0.2239,5,75,103,1030,108,1105
1047,2011-02-16,1,0,2,8,0,3,1,2,0.22,0.2273,0.55,0.1642,6,90,224,2240,230,2330
1048,2011-02-16,1,0,2,9,0,3,1,1,0.24,0.2121,0.52,0.2836,2,30,122,1220,124,1250
1049,2011-02-16,1,0,2,10,0,3,1,1,0.26,0.2273,0.41,0.3881,14,210,55,550,69,760
1050,2011-02-16,1,0,2,11,0,3,1,1,0.34,0.303,0.34,0.2985,7,105,59,590,66,695
1051,2011-02-16,1,0,2,12,0,3,1,1,0.38,0.3939,0.32,0.3284,14,210,72,720,86,930
1052,2011-02-16,1,0,2,13,0,3,1,1,0.42,0.4242,0.3,0.3582,13,195,80,800,93,995
1053,2011-02-16,1,0,2,14,0,3,1,1,0.46,0.4545,0.28,0.4179,17,255,65,650,82,905
1054,2011-02-16,1,0,2,15,0,3,1,1,0.46,0.4545,0.28,0.4179,35,525,82,820,117,1345
1055,2011-02-16,1,0,2,16,0,3,1,1,0.46,0.4545,0.31,0.3881,26,390,96,960,122,1350
1056,2011-02-16,1,0,2,17,0,3,1,1,0.46,0.4545,0.28,0.2836,11,165,244,2440,255,2605
1057,2011-02-16,1,0,2,18,0,3,1,1,0.4,0.4091,0.4,0.2239,20,300,202,2020,222,2320
1058,2011-02-16,1,0,2,19,0,3,1,1,0.34,0.3182,0.53,0.2239,18,270,143,1430,161,1700
1059,2011-02-16,1,0,2,20,0,3,1,1,0.38,0.3939,0.43,0.194,10,150,108,1080,118,1230
1060,2011-02-16,1,0,2,21,0,3,1,1,0.36,0.3485,0.46,0.194,5,75,87,870,92,945
1061,2011-02-16,1,0,2,22,0,3,1,1,0.34,0.3333,0.53,0.194,12,180,61,610,73,790
1062,2011-02-16,1,0,2,23,0,3,1,1,0.38,0.3939,0.4,0.2239,2,30,31,310,33,340
1063,2011-02-17,1,0,2,0,0,4,1,1,0.34,0.3333,0.53,0.194,1,15,16,160,17,175
1064,2011-02-17,1,0,2,1,0,4,1,1,0.34,0.3182,0.53,0.2239,0,0,6,60,6,60
1065,2011-02-17,1,0,2,2,0,4,1,2,0.34,0.3182,0.53,0.2239,2,30,4,40,6,70
1066,2011-02-17,1,0,2,3,0,4,1,1,0.34,0.3333,0.53,0.194,3,45,1,10,4,55
1067,2011-02-17,1,0,2,4,0,4,1,1,0.32,0.3182,0.57,0.194,3,45,1,10,4,55
1068,2011-02-17,1,0,2,5,0,4,1,1,0.32,0.3333,0.66,0.0896,1,15,11,110,12,125
1069,2011-02-17,1,0,2,6,0,4,1,1,0.3,0.303,0.7,0.1343,3,45,44,440,47,485
1070,2011-02-17,1,0,2,7,0,4,1,1,0.32,0.3333,0.57,0.1045,7,105,119,1190,126,1295
1071,2011-02-17,1,0,2,8,0,4,1,1,0.32,0.3333,0.57,0.0896,18,270,267,2670,285,2940
1072,2011-02-17,1,0,2,9,0,4,1,1,0.36,0.3485,0.57,0.194,16,240,163,1630,179,1870
1073,2011-02-17,1,0,2,10,0,4,1,1,0.38,0.3939,0.54,0.194,18,270,70,700,88,970
1074,2011-02-17,1,0,2,11,0,4,1,2,0.44,0.4394,0.44,0.2537,19,285,71,710,90,995
1075,2011-02-17,1,0,2,12,0,4,1,1,0.48,0.4697,0.41,0.2239,15,225,86,860,101,1085
1076,2011-02-17,1,0,2,13,0,4,1,1,0.54,0.5152,0.34,0.2239,15,225,108,1080,123,1305
1077,2011-02-17,1,0,2,14,0,4,1,1,0.6,0.6212,0.31,0.2239,26,390,55,550,81,940
1078,2011-02-17,1,0,2,15,0,4,1,1,0.6,0.6061,0.28,0.2537,15,225,91,910,106,1135
1079,2011-02-17,1,0,2,16,0,4,1,2,0.56,0.5303,0.35,0.2985,29,435,117,1170,146,1605
1080,2011-02-17,1,0,2,17,0,4,1,2,0.58,0.5455,0.32,0.2985,18,270,256,2560,274,2830
1081,2011-02-17,1,0,2,18,0,4,1,2,0.54,0.5152,0.42,0.2836,11,165,211,2110,222,2275
1082,2011-02-17,1,0,2,19,0,4,1,1,0.48,0.4697,0.55,0.3284,14,210,161,1610,175,1820
1083,2011-02-17,1,0,2,20,0,4,1,1,0.48,0.4697,0.59,0.3284,8,120,131,1310,139,1430
1084,2011-02-17,1,0,2,21,0,4,1,1,0.52,0.5,0.55,0.3881,5,75,119,1190,124,1265
1085,2011-02-17,1,0,2,22,0,4,1,1,0.5,0.4848,0.59,0.2836,8,120,68,680,76,800
1086,2011-02-17,1,0,2,23,0,4,1,1,0.46,0.4545,0.67,0.2985,4,60,40,400,44,460
1087,2011-02-18,1,0,2,0,0,5,1,1,0.44,0.4394,0.72,0.2836,12,180,20,200,32,380
1088,2011-02-18,1,0,2,1,0,5,1,1,0.44,0.4394,0.72,0.2239,1,15,7,70,8,85
1089,2011-02-18,1,0,2,2,0,5,1,1,0.44,0.4394,0.72,0.2836,2,30,5,50,7,80
1090,2011-02-18,1,0,2,3,0,5,1,1,0.46,0.4545,0.67,0.2537,2,30,6,60,8,90
1091,2011-02-18,1,0,2,4,0,5,1,1,0.46,0.4545,0.67,0.2537,0,0,1,10,1,10
1092,2011-02-18,1,0,2,5,0,5,1,2,0.46,0.4545,0.67,0.1045,1,15,6,60,7,75
1093,2011-02-18,1,0,2,6,0,5,1,2,0.44,0.4394,0.72,0.1642,2,30,48,480,50,510
1094,2011-02-18,1,0,2,7,0,5,1,2,0.42,0.4242,0.77,0.2239,8,120,108,1080,116,1200
1095,2011-02-18,1,0,2,8,0,5,1,2,0.42,0.4242,0.77,0.194,26,390,246,2460,272,2850
1096,2011-02-18,1,0,2,9,0,5,1,2,0.42,0.4242,0.77,0.194,15,225,154,1540,169,1765
1097,2011-02-18,1,0,2,10,0,5,1,2,0.44,0.4394,0.72,0.2239,17,255,78,780,95,1035
1098,2011-02-18,1,0,2,11,0,5,1,1,0.44,0.4394,0.72,0.1642,31,465,82,820,113,1285
1099,2011-02-18,1,0,2,12,0,5,1,1,0.5,0.4848,0.59,0.194,59,885,126,1260,185,2145
1100,2011-02-18,1,0,2,13,0,5,1,1,0.6,0.6212,0.43,0.194,45,675,131,1310,176,1985
1101,2011-02-18,1,0,2,14,0,5,1,1,0.66,0.6212,0.36,0.2985,73,1095,118,1180,191,2275
1102,2011-02-18,1,0,2,15,0,5,1,1,0.66,0.6212,0.36,0.3284,55,825,117,1170,172,1995
1103,2011-02-18,1,0,2,16,0,5,1,1,0.66,0.6212,0.36,0.2836,68,1020,164,1640,232,2660
1104,2011-02-18,1,0,2,17,0,5,1,1,0.66,0.6212,0.34,0.3582,52,780,275,2750,327,3530
1105,2011-02-18,1,0,2,18,0,5,1,1,0.64,0.6212,0.33,0.3284,29,435,195,1950,224,2385
1106,2011-02-18,1,0,2,19,0,5,1,1,0.62,0.6212,0.29,0.5821,16,240,146,1460,162,1700
1107,2011-02-18,1,0,2,20,0,5,1,1,0.6,0.6212,0.31,0.194,19,285,105,1050,124,1335
1108,2011-02-18,1,0,2,21,0,5,1,1,0.58,0.5455,0.21,0.4925,11,165,61,610,72,775
1109,2011-02-18,1,0,2,22,0,5,1,1,0.54,0.5152,0.1,0.2537,19,285,88,880,107,1165
1110,2011-02-18,1,0,2,23,0,5,1,1,0.52,0.5,0.08,0.2836,16,240,61,610,77,850
1111,2011-02-19,1,0,2,0,0,6,0,1,0.48,0.4697,0.12,0.4925,6,90,23,230,29,320
1112,2011-02-19,1,0,2,1,0,6,0,1,0.46,0.4545,0.14,0.4179,10,150,21,210,31,360
1113,2011-02-19,1,0,2,2,0,6,0,1,0.44,0.4394,0.13,0.3881,3,45,14,140,17,185
1114,2011-02-19,1,0,2,3,0,6,0,1,0.42,0.4242,0.14,0.2985,0,0,7,70,7,70
1115,2011-02-19,1,0,2,4,0,6,0,1,0.4,0.4091,0.15,0.3284,0,0,3,30,3,30
1116,2011-02-19,1,0,2,5,0,6,0,1,0.4,0.4091,0.15,0.3284,0,0,3,30,3,30
1117,2011-02-19,1,0,2,6,0,6,0,1,0.4,0.4091,0.17,0.4179,3,45,3,30,6,75
1118,2011-02-19,1,0,2,7,0,6,0,1,0.38,0.3939,0.17,0.5224,6,90,16,160,22,250
1119,2011-02-19,1,0,2,8,0,6,0,1,0.38,0.3939,0.17,0.5821,9,135,36,360,45,495
1120,2011-02-19,1,0,2,9,0,6,0,1,0.4,0.4091,0.16,0.6567,18,270,37,370,55,640
1121,2011-02-19,1,0,2,10,0,6,0,1,0.42,0.4242,0.16,0.5821,34,510,72,720,106,1230
1122,2011-02-19,1,0,2,11,0,6,0,1,0.44,0.4394,0.16,0.5821,47,705,76,760,123,1465
1123,2011-02-19,1,0,2,12,0,6,0,1,0.44,0.4394,0.18,0.4925,38,570,81,810,119,1380
1124,2011-02-19,1,0,2,13,0,6,0,1,0.44,0.4394,0.16,0.6119,52,780,103,1030,155,1810
1125,2011-02-19,1,0,2,14,0,6,0,1,0.46,0.4545,0.15,0.6567,102,1530,94,940,196,2470
1126,2011-02-19,1,0,2,15,0,6,0,1,0.44,0.4394,0.16,0.7463,84,1260,87,870,171,2130
1127,2011-02-19,1,0,2,16,0,6,0,1,0.44,0.4394,0.16,0.6418,39,585,81,810,120,1395
1128,2011-02-19,1,0,2,17,0,6,0,1,0.42,0.4242,0.19,0.6119,36,540,91,910,127,1450
1129,2011-02-19,1,0,2,18,0,6,0,1,0.36,0.3182,0.25,0.4478,21,315,67,670,88,985
1130,2011-02-19,1,0,2,19,0,6,0,1,0.34,0.303,0.29,0.3582,5,75,54,540,59,615
1131,2011-02-19,1,0,2,20,0,6,0,1,0.32,0.2879,0.28,0.5224,9,135,38,380,47,515
1132,2011-02-19,1,0,2,21,0,6,0,1,0.32,0.2727,0.26,0.5522,4,60,29,290,33,350
1133,2011-02-19,1,0,2,22,0,6,0,1,0.3,0.2576,0.28,0.4925,2,30,42,420,44,450
1134,2011-02-19,1,0,2,23,0,6,0,1,0.28,0.2424,0.33,0.4478,4,60,25,250,29,310
1135,2011-02-20,1,0,2,0,0,0,0,1,0.26,0.2121,0.35,0.4478,3,45,14,140,17,185
1136,2011-02-20,1,0,2,1,0,0,0,1,0.24,0.197,0.41,0.4627,5,75,11,110,16,185
1137,2011-02-20,1,0,2,2,0,0,0,1,0.24,0.197,0.41,0.5522,0,0,17,170,17,170
1138,2011-02-20,1,0,2,3,0,0,0,1,0.22,0.1818,0.44,0.5522,9,135,9,90,18,225
1139,2011-02-20,1,0,2,4,0,0,0,1,0.22,0.1818,0.44,0.5522,0,0,1,10,1,10
1140,2011-02-20,1,0,2,6,0,0,0,1,0.2,0.1818,0.47,0.2985,1,15,1,10,2,25
1141,2011-02-20,1,0,2,7,0,0,0,1,0.18,0.1667,0.51,0.2537,0,0,2,20,2,20
1142,2011-02-20,1,0,2,8,0,0,0,1,0.2,0.2273,0.51,0.1045,2,30,22,220,24,250
1143,2011-02-20,1,0,2,9,0,0,0,1,0.22,0.2121,0.47,0.2836,7,105,48,480,55,585
1144,2011-02-20,1,0,2,10,0,0,0,2,0.26,0.2576,0.41,0.194,34,510,70,700,104,1210
1145,2011-02-20,1,0,2,11,0,0,0,2,0.3,0.303,0.33,0.1642,72,1080,89,890,161,1970
1146,2011-02-20,1,0,2,12,0,0,0,1,0.3,0.3182,0.33,0.1045,62,930,120,1200,182,2130
1147,2011-02-20,1,0,2,13,0,0,0,1,0.34,0.3333,0.29,0.0,76,1140,122,1220,198,2360
1148,2011-02-20,1,0,2,14,0,0,0,1,0.36,0.3485,0.27,0.1642,108,1620,104,1040,212,2660
1149,2011-02-20,1,0,2,15,0,0,0,1,0.36,0.3636,0.27,0.0896,66,990,102,1020,168,2010
1150,2011-02-20,1,0,2,16,0,0,0,1,0.36,0.3636,0.29,0.0896,59,885,88,880,147,1765
1151,2011-02-20,1,0,2,17,0,0,0,1,0.34,0.3485,0.33,0.1642,60,900,86,860,146,1760
1152,2011-02-20,1,0,2,18,0,0,0,2,0.34,0.3333,0.36,0.1343,30,450,71,710,101,1160
1153,2011-02-20,1,0,2,19,0,0,0,2,0.34,0.3333,0.36,0.1343,3,45,39,390,42,435
1154,2011-02-20,1,0,2,20,0,0,0,2,0.34,0.3636,0.42,0.0,12,180,30,300,42,480
1155,2011-02-20,1,0,2,21,0,0,0,2,0.32,0.3485,0.53,0.0,17,255,39,390,56,645
1156,2011-02-20,1,0,2,22,0,0,0,2,0.32,0.303,0.57,0.2239,4,60,43,430,47,490
1157,2011-02-20,1,0,2,23,0,0,0,2,0.3,0.303,0.61,0.1642,9,135,45,450,54,585
1158,2011-02-21,1,0,2,0,1,1,0,2,0.34,0.303,0.42,0.3284,7,105,30,300,37,405
1159,2011-02-21,1,0,2,1,1,1,0,2,0.34,0.303,0.42,0.3284,2,30,11,110,13,140
1160,2011-02-21,1,0,2,2,1,1,0,2,0.34,0.303,0.42,0.3284,1,15,3,30,4,45
1161,2011-02-21,1,0,2,3,1,1,0,2,0.34,0.303,0.42,0.2985,2,30,3,30,5,60
1162,2011-02-21,1,0,2,4,1,1,0,1,0.32,0.3182,0.45,0.1642,1,15,0,0,1,15
1163,2011-02-21,1,0,2,5,1,1,0,2,0.34,0.3636,0.36,0.0,1,15,2,20,3,35
1164,2011-02-21,1,0,2,6,1,1,0,2,0.42,0.4242,0.26,0.2985,2,30,6,60,8,90
1165,2011-02-21,1,0,2,7,1,1,0,2,0.42,0.4242,0.26,0.2836,3,45,16,160,19,205
1166,2011-02-21,1,0,2,8,1,1,0,2,0.32,0.303,0.57,0.2985,7,105,56,560,63,665
1167,2011-02-21,1,0,2,9,1,1,0,2,0.32,0.303,0.57,0.2836,11,165,46,460,57,625
1168,2011-02-21,1,0,2,10,1,1,0,2,0.32,0.303,0.57,0.2537,29,435,52,520,81,955
1169,2011-02-21,1,0,2,11,1,1,0,2,0.32,0.3333,0.57,0.1045,20,300,70,700,90,1000
1170,2011-02-21,1,0,2,12,1,1,0,2,0.32,0.3182,0.66,0.194,26,390,67,670,93,1060
1171,2011-02-21,1,0,2,13,1,1,0,3,0.3,0.2727,0.81,0.3284,28,420,75,750,103,1170
1172,2011-02-21,1,0,2,14,1,1,0,2,0.32,0.303,0.76,0.2537,15,225,101,1010,116,1235
1173,2011-02-21,1,0,2,15,1,1,0,2,0.3,0.2727,0.7,0.4478,11,165,76,760,87,925
1174,2011-02-21,1,0,2,16,1,1,0,3,0.28,0.2424,0.75,0.4179,8,120,48,480,56,600
1175,2011-02-21,1,0,2,17,1,1,0,2,0.28,0.2576,0.75,0.3881,18,270,62,620,80,890
1176,2011-02-21,1,0,2,18,1,1,0,2,0.24,0.2121,0.87,0.3582,2,30,64,640,66,670
1177,2011-02-21,1,0,2,19,1,1,0,2,0.24,0.2121,0.87,0.3582,0,0,49,490,49,490
1178,2011-02-21,1,0,2,20,1,1,0,3,0.24,0.2121,0.81,0.3881,0,0,29,290,29,290
1179,2011-02-21,1,0,2,21,1,1,0,3,0.22,0.197,0.75,0.4478,1,15,33,330,34,345
1180,2011-02-21,1,0,2,22,1,1,0,3,0.2,0.1667,0.75,0.4179,0,0,11,110,11,110
1181,2011-02-21,1,0,2,23,1,1,0,3,0.2,0.1667,0.75,0.4179,0,0,2,20,2,20
1182,2011-02-22,1,0,2,6,0,2,1,2,0.12,0.1212,0.8,0.2836,0,0,7,70,7,70
1183,2011-02-22,1,0,2,7,0,2,1,2,0.12,0.1212,0.8,0.2836,0,0,40,400,40,400
1184,2011-02-22,1,0,2,8,0,2,1,2,0.12,0.1212,0.8,0.2537,7,105,107,1070,114,1175
1185,2011-02-22,1,0,2,9,0,2,1,2,0.14,0.1212,0.74,0.2537,5,75,101,1010,106,1085
1186,2011-02-22,1,0,2,10,0,2,1,1,0.16,0.1818,0.69,0.0,0,0,44,440,44,440
1187,2011-02-22,1,0,2,11,0,2,1,1,0.16,0.2273,0.64,0.0,7,105,43,430,50,535
1188,2011-02-22,1,0,2,12,0,2,1,1,0.2,0.2273,0.59,0.1045,7,105,48,480,55,585
1189,2011-02-22,1,0,2,13,0,2,1,1,0.22,0.2273,0.55,0.1642,3,45,52,520,55,565
1190,2011-02-22,1,0,2,14,0,2,1,1,0.22,0.2273,0.55,0.194,9,135,49,490,58,625
1191,2011-02-22,1,0,2,15,0,2,1,1,0.24,0.2273,0.48,0.194,2,30,67,670,69,700
1192,2011-02-22,1,0,2,16,0,2,1,1,0.22,0.2273,0.51,0.1642,7,105,79,790,86,895
1193,2011-02-22,1,0,2,17,0,2,1,1,0.22,0.2121,0.51,0.2239,8,120,188,1880,196,2000
1194,2011-02-22,1,0,2,18,0,2,1,1,0.22,0.2273,0.47,0.1343,6,90,161,1610,167,1700
1195,2011-02-22,1,0,2,19,0,2,1,1,0.2,0.1818,0.47,0.2836,4,60,114,1140,118,1200
1196,2011-02-22,1,0,2,20,0,2,1,1,0.2,0.197,0.47,0.2239,3,45,102,1020,105,1065
1197,2011-02-22,1,0,2,21,0,2,1,1,0.2,0.197,0.47,0.2537,2,30,80,800,82,830
1198,2011-02-22,1,0,2,22,0,2,1,1,0.16,0.1515,0.43,0.2537,1,15,76,760,77,775
1199,2011-02-22,1,0,2,23,0,2,1,1,0.16,0.1515,0.43,0.2537,3,45,18,180,21,225
1200,2011-02-23,1,0,2,0,0,3,1,1,0.14,0.1364,0.5,0.194,0,0,6,60,6,60
1201,2011-02-23,1,0,2,1,0,3,1,1,0.14,0.1515,0.46,0.1642,0,0,4,40,4,40
1202,2011-02-23,1,0,2,2,0,3,1,1,0.12,0.1515,0.5,0.1343,0,0,1,10,1,10
1203,2011-02-23,1,0,2,3,0,3,1,1,0.12,0.1364,0.5,0.1642,0,0,2,20,2,20
1204,2011-02-23,1,0,2,5,0,3,1,1,0.12,0.1515,0.5,0.1045,0,0,8,80,8,80
1205,2011-02-23,1,0,2,6,0,3,1,1,0.12,0.1515,0.5,0.1045,0,0,36,360,36,360
1206,2011-02-23,1,0,2,7,0,3,1,1,0.12,0.1515,0.54,0.1343,2,30,94,940,96,970
1207,2011-02-23,1,0,2,8,0,3,1,1,0.14,0.1515,0.54,0.1642,8,120,227,2270,235,2390
1208,2011-02-23,1,0,2,9,0,3,1,1,0.18,0.2121,0.51,0.0896,9,135,130,1300,139,1435
1209,2011-02-23,1,0,2,10,0,3,1,1,0.2,0.2576,0.4,0.0,4,60,47,470,51,530
1210,2011-02-23,1,0,2,11,0,3,1,1,0.24,0.2576,0.41,0.1045,16,240,53,530,69,770
1211,2011-02-23,1,0,2,12,0,3,1,1,0.26,0.2879,0.35,0.0896,11,165,56,560,67,725
1212,2011-02-23,1,0,2,13,0,3,1,1,0.3,0.3182,0.28,0.0896,9,135,78,780,87,915
1213,2011-02-23,1,0,2,14,0,3,1,1,0.32,0.3333,0.29,0.1045,17,255,61,610,78,865
1214,2011-02-23,1,0,2,15,0,3,1,1,0.34,0.3485,0.25,0.0896,18,270,54,540,72,810
1215,2011-02-23,1,0,2,16,0,3,1,1,0.34,0.3636,0.25,0.0,15,225,79,790,94,1015
1216,2011-02-23,1,0,2,17,0,3,1,1,0.34,0.3485,0.25,0.0896,15,225,207,2070,222,2295
1217,2011-02-23,1,0,2,18,0,3,1,1,0.32,0.3333,0.26,0.0896,3,45,206,2060,209,2105
1218,2011-02-23,1,0,2,19,0,3,1,1,0.3,0.3333,0.33,0.0,6,90,135,1350,141,1440
1219,2011-02-23,1,0,2,20,0,3,1,1,0.24,0.2424,0.6,0.1642,2,30,107,1070,109,1100
1220,2011-02-23,1,0,2,21,0,3,1,1,0.24,0.2879,0.48,0.0,2,30,89,890,91,920
1221,2011-02-23,1,0,2,22,0,3,1,1,0.24,0.2879,0.48,0.0,1,15,60,600,61,615
1222,2011-02-23,1,0,2,23,0,3,1,1,0.22,0.2576,0.55,0.0896,1,15,38,380,39,395
1223,2011-02-24,1,0,2,0,0,4,1,1,0.22,0.2576,0.55,0.0896,0,0,11,110,11,110
1224,2011-02-24,1,0,2,1,0,4,1,1,0.22,0.2576,0.6,0.0896,0,0,7,70,7,70
1225,2011-02-24,1,0,2,2,0,4,1,1,0.2,0.2273,0.64,0.0896,0,0,4,40,4,40
1226,2011-02-24,1,0,2,3,0,4,1,1,0.2,0.2121,0.64,0.1343,0,0,2,20,2,20
1227,2011-02-24,1,0,2,5,0,4,1,1,0.2,0.2121,0.69,0.1343,1,15,3,30,4,45
1228,2011-02-24,1,0,2,6,0,4,1,1,0.2,0.197,0.69,0.194,0,0,58,580,58,580
1229,2011-02-24,1,0,2,7,0,4,1,1,0.2,0.197,0.72,0.194,0,0,104,1040,104,1040
1230,2011-02-24,1,0,2,8,0,4,1,1,0.24,0.2273,0.7,0.2239,8,120,244,2440,252,2560
1231,2011-02-24,1,0,2,9,0,4,1,2,0.24,0.2121,0.75,0.2985,4,60,133,1330,137,1390
1232,2011-02-24,1,0,2,10,0,4,1,2,0.26,0.2424,0.7,0.2836,8,120,49,490,57,610
1233,2011-02-24,1,0,2,11,0,4,1,2,0.32,0.2879,0.57,0.3881,8,120,71,710,79,830
1234,2011-02-24,1,0,2,12,0,4,1,2,0.36,0.3333,0.53,0.3582,10,150,85,850,95,1000
1235,2011-02-24,1,0,2,13,0,4,1,2,0.38,0.3939,0.54,0.2985,16,240,72,720,88,960
1236,2011-02-24,1,0,2,14,0,4,1,2,0.4,0.4091,0.5,0.2985,2,30,67,670,69,700
1237,2011-02-24,1,0,2,15,0,4,1,3,0.4,0.4091,0.54,0.3881,5,75,58,580,63,655
1238,2011-02-24,1,0,2,16,0,4,1,3,0.38,0.3939,0.62,0.2836,4,60,67,670,71,730
1239,2011-02-24,1,0,2,17,0,4,1,3,0.36,0.3485,0.66,0.194,9,135,168,1680,177,1815
1240,2011-02-24,1,0,2,18,0,4,1,2,0.34,0.303,0.87,0.3284,5,75,132,1320,137,1395
1241,2011-02-24,1,0,2,19,0,4,1,3,0.34,0.303,0.93,0.2985,3,45,112,1120,115,1165
1242,2011-02-24,1,0,2,20,0,4,1,2,0.34,0.303,0.93,0.3582,2,30,87,870,89,900
1243,2011-02-24,1,0,2,21,0,4,1,2,0.34,0.303,0.87,0.3284,7,105,76,760,83,865
1244,2011-02-24,1,0,2,22,0,4,1,3,0.34,0.3182,0.87,0.2836,5,75,50,500,55,575
1245,2011-02-24,1,0,2,23,0,4,1,2,0.32,0.303,0.93,0.2239,3,45,47,470,50,515
1246,2011-02-25,1,0,2,0,0,5,1,3,0.32,0.3485,0.93,0.0,1,15,8,80,9,95
1247,2011-02-25,1,0,2,1,0,5,1,2,0.32,0.3485,1.0,0.0,1,15,9,90,10,105
1248,2011-02-25,1,0,2,2,0,5,1,2,0.32,0.3485,1.0,0.0,0,0,3,30,3,30
1249,2011-02-25,1,0,2,3,0,5,1,2,0.32,0.3333,0.93,0.1045,1,15,1,10,2,25
1250,2011-02-25,1,0,2,5,0,5,1,2,0.32,0.3333,0.93,0.1045,1,15,5,50,6,65
1251,2011-02-25,1,0,2,6,0,5,1,3,0.34,0.3485,0.93,0.0896,0,0,11,110,11,110
1252,2011-02-25,1,0,2,7,0,5,1,3,0.34,0.3333,1.0,0.1343,1,15,34,340,35,355
1253,2011-02-25,1,0,2,8,0,5,1,3,0.36,0.3485,0.93,0.1343,3,45,70,700,73,745
1254,2011-02-25,1,0,2,9,0,5,1,3,0.34,0.303,0.93,0.3582,3,45,111,1110,114,1155
1255,2011-02-25,1,0,2,10,0,5,1,3,0.42,0.4242,0.94,0.3284,7,105,42,420,49,525
1256,2011-02-25,1,0,2,11,0,5,1,1,0.52,0.5,0.77,0.4478,9,135,50,500,59,635
1257,2011-02-25,1,0,2,12,0,5,1,3,0.54,0.5152,0.6,0.4627,20,300,95,950,115,1250
1258,2011-02-25,1,0,2,13,0,5,1,3,0.54,0.5152,0.6,0.4627,6,90,77,770,83,860
1259,2011-02-25,1,0,2,14,0,5,1,3,0.56,0.5303,0.56,0.6119,14,210,71,710,85,920
1260,2011-02-25,1,0,2,15,0,5,1,1,0.46,0.4545,0.41,0.806,5,75,50,500,55,575
1261,2011-02-25,1,0,2,16,0,5,1,1,0.32,0.2879,0.49,0.4627,11,165,91,910,102,1075
1262,2011-02-25,1,0,2,17,0,5,1,1,0.32,0.2727,0.49,0.7463,8,120,181,1810,189,1930
1263,2011-02-25,1,0,2,18,0,5,1,1,0.32,0.2879,0.49,0.4925,7,105,150,1500,157,1605
1264,2011-02-25,1,0,2,19,0,5,1,1,0.3,0.2727,0.52,0.4478,4,60,86,860,90,920
1265,2011-02-25,1,0,2,20,0,5,1,1,0.3,0.2576,0.49,0.6119,2,30,60,600,62,630
1266,2011-02-25,1,0,2,21,0,5,1,1,0.28,0.2576,0.48,0.3881,7,105,56,560,63,665
1267,2011-02-25,1,0,2,22,0,5,1,1,0.26,0.2121,0.48,0.4478,7,105,43,430,50,535
1268,2011-02-25,1,0,2,23,0,5,1,1,0.26,0.2273,0.48,0.3284,2,30,37,370,39,400
1269,2011-02-26,1,0,2,0,0,6,0,1,0.24,0.2273,0.52,0.194,3,45,25,250,28,295
1270,2011-02-26,1,0,2,1,0,6,0,1,0.24,0.2121,0.52,0.2985,2,30,25,250,27,280
1271,2011-02-26,1,0,2,2,0,6,0,1,0.22,0.197,0.6,0.3582,3,45,9,90,12,135
1272,2011-02-26,1,0,2,3,0,6,0,1,0.22,0.2273,0.55,0.1343,1,15,7,70,8,85
1273,2011-02-26,1,0,2,4,0,6,0,2,0.22,0.2576,0.6,0.0896,1,15,1,10,2,25
1274,2011-02-26,1,0,2,5,0,6,0,2,0.22,0.2424,0.64,0.1045,1,15,9,90,10,105
1275,2011-02-26,1,0,2,6,0,6,0,1,0.22,0.2727,0.6,0.0,1,15,6,60,7,75
1276,2011-02-26,1,0,2,7,0,6,0,1,0.22,0.2576,0.6,0.0896,1,15,21,210,22,225
1277,2011-02-26,1,0,2,8,0,6,0,2,0.24,0.2879,0.6,0.0,2,30,55,550,57,580
1278,2011-02-26,1,0,2,9,0,6,0,2,0.26,0.2576,0.56,0.1642,9,135,65,650,74,785
1279,2011-02-26,1,0,2,10,0,6,0,2,0.3,0.303,0.49,0.1343,14,210,71,710,85,920
1280,2011-02-26,1,0,2,11,0,6,0,1,0.3,0.3333,0.45,0.0,26,390,100,1000,126,1390
1281,2011-02-26,1,0,2,12,0,6,0,2,0.32,0.3182,0.45,0.1642,45,675,115,1150,160,1825
1282,2011-02-26,1,0,2,13,0,6,0,2,0.34,0.3182,0.42,0.2537,38,570,136,1360,174,1930
1283,2011-02-26,1,0,2,14,0,6,0,2,0.34,0.303,0.36,0.3284,57,855,154,1540,211,2395
1284,2011-02-26,1,0,2,15,0,6,0,2,0.36,0.3333,0.4,0.2836,40,600,125,1250,165,1850
1285,2011-02-26,1,0,2,16,0,6,0,1,0.36,0.3333,0.46,0.2836,41,615,130,1300,171,1915
1286,2011-02-26,1,0,2,17,0,6,0,1,0.36,0.3485,0.43,0.2239,53,795,130,1300,183,2095
1287,2011-02-26,1,0,2,18,0,6,0,1,0.34,0.3333,0.46,0.194,26,390,111,1110,137,1500
1288,2011-02-26,1,0,2,19,0,6,0,1,0.32,0.303,0.49,0.2537,30,450,64,640,94,1090
1289,2011-02-26,1,0,2,20,0,6,0,1,0.3,0.303,0.56,0.1642,8,120,60,600,68,720
1290,2011-02-26,1,0,2,21,0,6,0,1,0.28,0.2727,0.65,0.2537,9,135,59,590,68,725
1291,2011-02-26,1,0,2,22,0,6,0,1,0.28,0.2727,0.75,0.2239,8,120,38,380,46,500
1292,2011-02-26,1,0,2,23,0,6,0,1,0.28,0.2576,0.75,0.2836,5,75,29,290,34,365
1293,2011-02-27,1,0,2,0,0,0,0,1,0.26,0.2424,0.87,0.2836,8,120,26,260,34,380
1294,2011-02-27,1,0,2,1,0,0,0,1,0.26,0.2576,0.87,0.194,7,105,30,300,37,405
1295,2011-02-27,1,0,2,2,0,0,0,1,0.26,0.2727,0.87,0.1343,2,30,20,200,22,230
1296,2011-02-27,1,0,2,3,0,0,0,1,0.26,0.2879,0.87,0.0896,3,45,8,80,11,125
1297,2011-02-27,1,0,2,4,0,0,0,1,0.24,0.2424,0.87,0.1343,0,0,2,20,2,20
1298,2011-02-27,1,0,2,6,0,0,0,1,0.24,0.2879,0.87,0.0,2,30,1,10,3,40
1299,2011-02-27,1,0,2,7,0,0,0,1,0.24,0.2424,0.87,0.1343,6,90,8,80,14,170
1300,2011-02-27,1,0,2,8,0,0,0,1,0.26,0.303,0.87,0.0,9,135,26,260,35,395
1301,2011-02-27,1,0,2,9,0,0,0,1,0.28,0.303,0.87,0.0896,17,255,42,420,59,675
1302,2011-02-27,1,0,2,10,0,0,0,1,0.3,0.303,0.81,0.1642,24,360,79,790,103,1150
1303,2011-02-27,1,0,2,11,0,0,0,1,0.36,0.3485,0.62,0.1343,33,495,92,920,125,1415
1304,2011-02-27,1,0,2,12,0,0,0,1,0.4,0.4091,0.54,0.0896,61,915,132,1320,193,2235
1305,2011-02-27,1,0,2,13,0,0,0,1,0.42,0.4242,0.47,0.0,90,1350,169,1690,259,3040
1306,2011-02-27,1,0,2,14,0,0,0,1,0.44,0.4394,0.47,0.0896,105,1575,177,1770,282,3345
1307,2011-02-27,1,0,2,15,0,0,0,1,0.46,0.4545,0.44,0.1343,98,1470,163,1630,261,3100
1308,2011-02-27,1,0,2,16,0,0,0,1,0.48,0.4697,0.44,0.1642,98,1470,170,1700,268,3170
1309,2011-02-27,1,0,2,17,0,0,0,1,0.42,0.4242,0.54,0.194,66,990,121,1210,187,2200
1310,2011-02-27,1,0,2,18,0,0,0,1,0.4,0.4091,0.54,0.194,24,360,103,1030,127,1390
1311,2011-02-27,1,0,2,19,0,0,0,1,0.4,0.4091,0.54,0.1343,16,240,86,860,102,1100
1312,2011-02-27,1,0,2,20,0,0,0,1,0.4,0.4091,0.54,0.0896,9,135,72,720,81,855
1313,2011-02-27,1,0,2,21,0,0,0,1,0.38,0.3939,0.62,0.1642,8,120,61,610,69,730
1314,2011-02-27,1,0,2,22,0,0,0,2,0.38,0.3939,0.62,0.1045,2,30,67,670,69,700
1315,2011-02-27,1,0,2,23,0,0,0,2,0.36,0.3485,0.62,0.1642,6,90,53,530,59,620
1316,2011-02-28,1,0,2,0,0,1,1,2,0.36,0.3636,0.66,0.1045,5,75,25,250,30,325
1317,2011-02-28,1,0,2,1,0,1,1,3,0.34,0.303,0.87,0.3582,1,15,7,70,8,85
1318,2011-02-28,1,0,2,3,0,1,1,3,0.32,0.3182,0.93,0.1642,0,0,1,10,1,10
1319,2011-02-28,1,0,2,5,0,1,1,2,0.34,0.3636,0.93,0.0,1,15,4,40,5,55
1320,2011-02-28,1,0,2,6,0,1,1,2,0.34,0.3485,0.96,0.1045,1,15,27,270,28,285
1321,2011-02-28,1,0,2,7,0,1,1,2,0.36,0.3636,0.93,0.1045,2,30,90,900,92,930
1322,2011-02-28,1,0,2,8,0,1,1,2,0.34,0.303,0.93,0.2985,13,195,242,2420,255,2615
1323,2011-02-28,1,0,2,9,0,1,1,1,0.42,0.4242,0.82,0.2836,15,225,127,1270,142,1495
1324,2011-02-28,1,0,2,10,0,1,1,2,0.52,0.5,0.72,0.4925,13,195,79,790,92,985
1325,2011-02-28,1,0,2,11,0,1,1,2,0.56,0.5303,0.64,0.2985,13,195,74,740,87,935
1326,2011-02-28,1,0,2,12,0,1,1,2,0.56,0.5303,0.64,0.2985,0,0,36,360,36,360
1327,2011-02-28,1,0,2,13,0,1,1,3,0.46,0.4545,0.94,0.2239,1,15,31,310,32,325
1328,2011-02-28,1,0,2,14,0,1,1,3,0.42,0.4242,1.0,0.2985,1,15,24,240,25,255
1329,2011-02-28,1,0,2,15,0,1,1,3,0.42,0.4242,1.0,0.2985,0,0,35,350,35,350
1330,2011-02-28,1,0,2,16,0,1,1,3,0.42,0.4242,1.0,0.1343,2,30,40,400,42,430
1331,2011-02-28,1,0,2,17,0,1,1,3,0.4,0.4091,1.0,0.2985,2,30,77,770,79,800
1332,2011-02-28,1,0,2,18,0,1,1,3,0.46,0.4545,0.94,0.194,4,60,127,1270,131,1330
1333,2011-02-28,1,0,2,19,0,1,1,3,0.44,0.4394,0.88,0.6119,1,15,79,790,80,805
1334,2011-02-28,1,0,2,20,0,1,1,3,0.44,0.4394,0.88,0.6119,0,0,45,450,45,450
1335,2011-02-28,1,0,2,21,0,1,1,2,0.38,0.3939,0.87,0.3881,2,30,78,780,80,810
1336,2011-02-28,1,0,2,22,0,1,1,3,0.34,0.303,0.93,0.4179,4,60,72,720,76,780
1337,2011-02-28,1,0,2,23,0,1,1,2,0.32,0.2879,0.81,0.3881,0,0,45,450,45,450
1338,2011-03-01,1,0,3,0,0,2,1,1,0.3,0.2727,0.7,0.4627,0,0,7,70,7,70
1339,2011-03-01,1,0,3,1,0,2,1,1,0.26,0.2273,0.7,0.3582,0,0,3,30,3,30
1340,2011-03-01,1,0,3,2,0,2,1,1,0.24,0.2121,0.65,0.3881,0,0,4,40,4,40
1341,2011-03-01,1,0,3,3,0,2,1,1,0.22,0.2121,0.69,0.2836,0,0,2,20,2,20
1342,2011-03-01,1,0,3,4,0,2,1,1,0.22,0.2121,0.69,0.2537,0,0,1,10,1,10
1343,2011-03-01,1,0,3,5,0,2,1,1,0.2,0.1818,0.64,0.2836,1,15,1,10,2,25
1344,2011-03-01,1,0,3,6,0,2,1,1,0.2,0.1818,0.59,0.2985,0,0,46,460,46,460
1345,2011-03-01,1,0,3,7,0,2,1,1,0.2,0.1818,0.59,0.3284,2,30,105,1050,107,1080
1346,2011-03-01,1,0,3,8,0,2,1,1,0.2,0.1818,0.59,0.3881,10,150,204,2040,214,2190
1347,2011-03-01,1,0,3,9,0,2,1,1,0.22,0.197,0.55,0.4179,8,120,116,1160,124,1280
1348,2011-03-01,1,0,3,10,0,2,1,1,0.24,0.2121,0.52,0.2836,13,195,55,550,68,745
1349,2011-03-01,1,0,3,11,0,2,1,1,0.28,0.2727,0.45,0.2537,8,120,48,480,56,600
1350,2011-03-01,1,0,3,12,0,2,1,1,0.3,0.303,0.39,0.1343,6,90,80,800,86,890
1351,2011-03-01,1,0,3,13,0,2,1,1,0.32,0.3485,0.39,0.0,13,195,65,650,78,845
1352,2011-03-01,1,0,3,14,0,2,1,1,0.32,0.3333,0.36,0.1343,18,270,61,610,79,880
1353,2011-03-01,1,0,3,15,0,2,1,1,0.34,0.3636,0.34,0.0,7,105,57,570,64,675
1354,2011-03-01,1,0,3,16,0,2,1,1,0.34,0.3485,0.34,0.0896,10,150,92,920,102,1070
1355,2011-03-01,1,0,3,17,0,2,1,1,0.34,0.3485,0.34,0.0896,12,180,230,2300,242,2480
1356,2011-03-01,1,0,3,18,0,2,1,1,0.32,0.3182,0.39,0.194,10,150,214,2140,224,2290
1357,2011-03-01,1,0,3,19,0,2,1,1,0.3,0.303,0.49,0.1343,4,60,115,1150,119,1210
1358,2011-03-01,1,0,3,20,0,2,1,1,0.3,0.3182,0.61,0.0896,2,30,86,860,88,890
1359,2011-03-01,1,0,3,21,0,2,1,1,0.26,0.303,0.56,0.0,8,120,55,550,63,670
1360,2011-03-01,1,0,3,22,0,2,1,1,0.24,0.2727,0.62,0.1045,3,45,44,440,47,485
1361,2011-03-01,1,0,3,23,0,2,1,1,0.24,0.2273,0.65,0.2239,2,30,23,230,25,260
1362,2011-03-02,1,0,3,0,0,3,1,1,0.22,0.2273,0.69,0.1642,3,45,5,50,8,95
1363,2011-03-02,1,0,3,1,0,3,1,1,0.22,0.2273,0.69,0.194,0,0,4,40,4,40
1364,2011-03-02,1,0,3,2,0,3,1,1,0.22,0.2273,0.69,0.194,0,0,2,20,2,20
1365,2011-03-02,1,0,3,3,0,3,1,1,0.22,0.2121,0.69,0.2836,3,45,1,10,4,55
1366,2011-03-02,1,0,3,4,0,3,1,1,0.2,0.2121,0.75,0.1343,1,15,0,0,1,15
1367,2011-03-02,1,0,3,5,0,3,1,1,0.22,0.2121,0.69,0.2239,0,0,5,50,5,50
1368,2011-03-02,1,0,3,6,0,3,1,1,0.22,0.2121,0.55,0.2537,1,15,39,390,40,405
1369,2011-03-02,1,0,3,7,0,3,1,1,0.22,0.2121,0.64,0.2537,2,30,108,1080,110,1110
1370,2011-03-02,1,0,3,8,0,3,1,1,0.24,0.2121,0.65,0.2836,13,195,243,2430,256,2625
1371,2011-03-02,1,0,3,9,0,3,1,1,0.28,0.2576,0.56,0.2985,7,105,141,1410,148,1515
1372,2011-03-02,1,0,3,10,0,3,1,1,0.32,0.303,0.49,0.2836,11,165,65,650,76,815
1373,2011-03-02,1,0,3,11,0,3,1,1,0.34,0.303,0.53,0.3284,8,120,65,650,73,770
1374,2011-03-02,1,0,3,12,0,3,1,1,0.4,0.4091,0.43,0.194,20,300,62,620,82,920
1375,2011-03-02,1,0,3,13,0,3,1,1,0.5,0.4848,0.25,0.0,35,525,90,900,125,1425
1376,2011-03-02,1,0,3,14,0,3,1,1,0.52,0.5,0.23,0.2985,21,315,75,750,96,1065
1377,2011-03-02,1,0,3,15,0,3,1,1,0.54,0.5152,0.19,0.4179,19,285,91,910,110,1195
1378,2011-03-02,1,0,3,16,0,3,1,1,0.54,0.5152,0.19,0.3284,27,405,112,1120,139,1525
1379,2011-03-02,1,0,3,17,0,3,1,1,0.5,0.4848,0.23,0.2836,30,450,238,2380,268,2830
1380,2011-03-02,1,0,3,18,0,3,1,1,0.46,0.4545,0.23,0.4925,8,120,193,1930,201,2050
1381,2011-03-02,1,0,3,19,0,3,1,1,0.4,0.4091,0.28,0.5224,6,90,144,1440,150,1530
1382,2011-03-02,1,0,3,20,0,3,1,1,0.36,0.3333,0.29,0.4179,9,135,86,860,95,995
1383,2011-03-02,1,0,3,21,0,3,1,1,0.34,0.2879,0.29,0.4627,3,45,68,680,71,725
1384,2011-03-02,1,0,3,22,0,3,1,1,0.3,0.2576,0.26,0.5522,4,60,44,440,48,500
1385,2011-03-02,1,0,3,23,0,3,1,1,0.26,0.2121,0.3,0.5224,0,0,22,220,22,220
1386,2011-03-03,1,0,3,0,0,4,1,1,0.24,0.197,0.3,0.4627,3,45,10,100,13,145
1387,2011-03-03,1,0,3,1,0,4,1,1,0.24,0.197,0.3,0.4627,0,0,1,10,1,10
1388,2011-03-03,1,0,3,2,0,4,1,1,0.2,0.1667,0.27,0.4627,1,15,2,20,3,35
1389,2011-03-03,1,0,3,3,0,4,1,1,0.2,0.1667,0.27,0.4627,0,0,1,10,1,10
1390,2011-03-03,1,0,3,4,0,4,1,1,0.16,0.1212,0.31,0.4925,0,0,1,10,1,10
1391,2011-03-03,1,0,3,5,0,4,1,1,0.14,0.1212,0.33,0.2985,1,15,7,70,8,85
1392,2011-03-03,1,0,3,6,0,4,1,1,0.14,0.1212,0.33,0.2985,1,15,34,340,35,355
1393,2011-03-03,1,0,3,7,0,4,1,1,0.12,0.0909,0.42,0.4179,1,15,110,1100,111,1115
1394,2011-03-03,1,0,3,8,0,4,1,1,0.14,0.1212,0.39,0.2985,4,60,216,2160,220,2220
1395,2011-03-03,1,0,3,9,0,4,1,1,0.16,0.1364,0.37,0.2836,10,150,135,1350,145,1500
1396,2011-03-03,1,0,3,10,0,4,1,1,0.18,0.1818,0.29,0.194,7,105,49,490,56,595
1397,2011-03-03,1,0,3,11,0,4,1,1,0.2,0.2273,0.29,0.0896,10,150,40,400,50,550
1398,2011-03-03,1,0,3,12,0,4,1,1,0.22,0.2273,0.25,0.1343,7,105,65,650,72,755
1399,2011-03-03,1,0,3,13,0,4,1,1,0.22,0.2576,0.25,0.0896,13,195,67,670,80,865
1400,2011-03-03,1,0,3,14,0,4,1,1,0.24,0.2576,0.21,0.1045,18,270,60,600,78,870
1401,2011-03-03,1,0,3,15,0,4,1,1,0.24,0.2879,0.23,0.0,6,90,62,620,68,710
1402,2011-03-03,1,0,3,16,0,4,1,1,0.26,0.303,0.23,0.0,6,90,65,650,71,740
1403,2011-03-03,1,0,3,17,0,4,1,1,0.26,0.303,0.22,0.0,17,255,185,1850,202,2105
1404,2011-03-03,1,0,3,18,0,4,1,1,0.24,0.2121,0.35,0.3284,6,90,161,1610,167,1700
1405,2011-03-03,1,0,3,19,0,4,1,1,0.2,0.197,0.4,0.2537,5,75,101,1010,106,1085
1406,2011-03-03,1,0,3,20,0,4,1,1,0.2,0.2273,0.4,0.0896,1,15,69,690,70,705
1407,2011-03-03,1,0,3,21,0,4,1,1,0.18,0.2121,0.4,0.1045,3,45,48,480,51,525
1408,2011-03-03,1,0,3,22,0,4,1,1,0.2,0.2576,0.4,0.0,3,45,50,500,53,545
1409,2011-03-03,1,0,3,23,0,4,1,2,0.18,0.2121,0.43,0.0896,0,0,23,230,23,230
1410,2011-03-04,1,0,3,0,0,5,1,2,0.2,0.197,0.55,0.194,0,0,12,120,12,120
1411,2011-03-04,1,0,3,1,0,5,1,2,0.18,0.1818,0.64,0.194,0,0,4,40,4,40
1412,2011-03-04,1,0,3,2,0,5,1,2,0.18,0.1818,0.64,0.194,0,0,2,20,2,20
1413,2011-03-04,1,0,3,3,0,5,1,2,0.18,0.1667,0.74,0.2537,0,0,1,10,1,10
1414,2011-03-04,1,0,3,4,0,5,1,2,0.18,0.1818,0.74,0.194,1,15,0,0,1,15
1415,2011-03-04,1,0,3,5,0,5,1,2,0.16,0.1818,0.74,0.1343,0,0,7,70,7,70
1416,2011-03-04,1,0,3,6,0,5,1,2,0.16,0.197,0.74,0.0896,1,15,28,280,29,295
1417,2011-03-04,1,0,3,7,0,5,1,1,0.16,0.1818,0.8,0.1343,0,0,83,830,83,830
1418,2011-03-04,1,0,3,8,0,5,1,1,0.18,0.197,0.74,0.1343,6,90,222,2220,228,2310
1419,2011-03-04,1,0,3,9,0,5,1,1,0.22,0.2273,0.6,0.1343,12,180,138,1380,150,1560
1420,2011-03-04,1,0,3,10,0,5,1,1,0.24,0.2273,0.6,0.2537,10,150,56,560,66,710
1421,2011-03-04,1,0,3,11,0,5,1,1,0.28,0.2727,0.52,0.2239,16,240,73,730,89,970
1422,2011-03-04,1,0,3,12,0,5,1,1,0.32,0.303,0.43,0.1642,10,150,87,870,97,1020
1423,2011-03-04,1,0,3,13,0,5,1,1,0.34,0.3182,0.42,0.2239,13,195,74,740,87,935
1424,2011-03-04,1,0,3,14,0,5,1,1,0.36,0.3333,0.4,0.2836,30,450,65,650,95,1100
1425,2011-03-04,1,0,3,15,0,5,1,1,0.36,0.3333,0.4,0.2985,31,465,75,750,106,1215
1426,2011-03-04,1,0,3,16,0,5,1,1,0.36,0.3485,0.46,0.194,17,255,101,1010,118,1265
1427,2011-03-04,1,0,3,17,0,5,1,2,0.36,0.3333,0.5,0.2537,22,330,206,2060,228,2390
1428,2011-03-04,1,0,3,18,0,5,1,2,0.34,0.303,0.53,0.2985,15,225,172,1720,187,1945
1429,2011-03-04,1,0,3,19,0,5,1,1,0.32,0.303,0.61,0.2537,5,75,102,1020,107,1095
1430,2011-03-04,1,0,3,20,0,5,1,2,0.3,0.2879,0.7,0.194,9,135,78,780,87,915
1431,2011-03-04,1,0,3,21,0,5,1,2,0.3,0.2879,0.7,0.2239,6,90,64,640,70,730
1432,2011-03-04,1,0,3,22,0,5,1,1,0.3,0.2879,0.7,0.194,4,60,40,400,44,460
1433,2011-03-04,1,0,3,23,0,5,1,2,0.3,0.303,0.75,0.1642,6,90,40,400,46,490
1434,2011-03-05,1,0,3,0,0,6,0,2,0.28,0.2879,0.81,0.1045,4,60,15,150,19,210
1435,2011-03-05,1,0,3,1,0,6,0,2,0.3,0.3182,0.81,0.1045,5,75,20,200,25,275
1436,2011-03-05,1,0,3,2,0,6,0,2,0.3,0.2879,0.87,0.194,5,75,15,150,20,225
1437,2011-03-05,1,0,3,3,0,6,0,2,0.3,0.2879,0.87,0.194,0,0,2,20,2,20
1438,2011-03-05,1,0,3,4,0,6,0,2,0.3,0.303,0.93,0.1642,0,0,1,10,1,10
1439,2011-03-05,1,0,3,5,0,6,0,2,0.3,0.303,1.0,0.1343,0,0,3,30,3,30
1440,2011-03-05,1,0,3,6,0,6,0,2,0.3,0.2879,1.0,0.2239,1,15,3,30,4,45
1441,2011-03-05,1,0,3,7,0,6,0,2,0.3,0.2727,1.0,0.2985,5,75,10,100,15,175
1442,2011-03-05,1,0,3,8,0,6,0,2,0.3,0.2727,1.0,0.2985,11,165,34,340,45,505
1443,2011-03-05,1,0,3,9,0,6,0,2,0.32,0.303,0.93,0.2239,15,225,48,480,63,705
1444,2011-03-05,1,0,3,10,0,6,0,2,0.34,0.3333,0.93,0.194,34,510,69,690,103,1200
1445,2011-03-05,1,0,3,11,0,6,0,2,0.4,0.4091,0.76,0.2239,43,645,116,1160,159,1805
1446,2011-03-05,1,0,3,12,0,6,0,2,0.44,0.4394,0.67,0.2537,46,690,121,1210,167,1900
1447,2011-03-05,1,0,3,13,0,6,0,2,0.46,0.4545,0.67,0.2836,60,900,130,1300,190,2200
1448,2011-03-05,1,0,3,14,0,6,0,2,0.48,0.4697,0.59,0.2836,80,1200,118,1180,198,2380
1449,2011-03-05,1,0,3,15,0,6,0,2,0.46,0.4545,0.63,0.2985,83,1245,122,1220,205,2465
1450,2011-03-05,1,0,3,16,0,6,0,2,0.48,0.4697,0.59,0.2985,74,1110,130,1300,204,2410
1451,2011-03-05,1,0,3,17,0,6,0,2,0.48,0.4697,0.59,0.3582,60,900,104,1040,164,1940
1452,2011-03-05,1,0,3,18,0,6,0,2,0.48,0.4697,0.59,0.3284,37,555,115,1150,152,1705
1453,2011-03-05,1,0,3,19,0,6,0,2,0.46,0.4545,0.67,0.3284,27,405,62,620,89,1025
1454,2011-03-05,1,0,3,20,0,6,0,2,0.44,0.4394,0.77,0.3284,12,180,58,580,70,760
1455,2011-03-05,1,0,3,21,0,6,0,2,0.44,0.4394,0.72,0.3284,12,180,60,600,72,780
1456,2011-03-05,1,0,3,22,0,6,0,2,0.42,0.4242,0.77,0.2985,16,240,47,470,63,710
1457,2011-03-05,1,0,3,23,0,6,0,2,0.44,0.4394,0.77,0.2985,10,150,34,340,44,490
1458,2011-03-06,1,0,3,0,0,0,0,2,0.42,0.4242,0.77,0.3582,11,165,41,410,52,575
1459,2011-03-06,1,0,3,1,0,0,0,2,0.42,0.4242,0.77,0.2836,12,180,27,270,39,450
1460,2011-03-06,1,0,3,2,0,0,0,2,0.4,0.4091,0.82,0.2836,5,75,27,270,32,345
1461,2011-03-06,1,0,3,3,0,0,0,2,0.42,0.4242,0.82,0.2985,2,30,9,90,11,120
1462,2011-03-06,1,0,3,4,0,0,0,2,0.42,0.4242,0.88,0.3582,0,0,3,30,3,30
1463,2011-03-06,1,0,3,6,0,0,0,2,0.42,0.4242,0.94,0.3582,1,15,1,10,2,25
1464,2011-03-06,1,0,3,7,0,0,0,3,0.42,0.4242,1.0,0.4478,0,0,5,50,5,50
1465,2011-03-06,1,0,3,8,0,0,0,2,0.4,0.4091,1.0,0.2985,1,15,8,80,9,95
1466,2011-03-06,1,0,3,9,0,0,0,2,0.42,0.4242,1.0,0.2836,4,60,18,180,22,240
1467,2011-03-06,1,0,3,10,0,0,0,2,0.42,0.4242,1.0,0.2985,4,60,27,270,31,330
1468,2011-03-06,1,0,3,11,0,0,0,2,0.42,0.4242,1.0,0.2239,18,270,44,440,62,710
1469,2011-03-06,1,0,3,12,0,0,0,2,0.46,0.4545,0.94,0.3284,10,150,69,690,79,840
1470,2011-03-06,1,0,3,13,0,0,0,2,0.46,0.4545,0.94,0.3582,22,330,83,830,105,1160
1471,2011-03-06,1,0,3,14,0,0,0,3,0.44,0.4394,1.0,0.2239,12,180,27,270,39,450
1472,2011-03-06,1,0,3,15,0,0,0,3,0.44,0.4394,1.0,0.2239,3,45,4,40,7,85
1473,2011-03-06,1,0,3,16,0,0,0,3,0.36,0.3333,1.0,0.2836,3,45,8,80,11,125
1474,2011-03-06,1,0,3,17,0,0,0,3,0.34,0.303,1.0,0.2985,2,30,23,230,25,260
1475,2011-03-06,1,0,3,18,0,0,0,3,0.32,0.2879,1.0,0.3582,0,0,23,230,23,230
1476,2011-03-06,1,0,3,19,0,0,0,3,0.3,0.2576,1.0,0.4925,0,0,11,110,11,110
1477,2011-03-06,1,0,3,20,0,0,0,3,0.28,0.2424,1.0,0.4179,3,45,8,80,11,125
1478,2011-03-06,1,0,3,21,0,0,0,3,0.24,0.1818,0.93,0.6119,1,15,6,60,7,75
1479,2011-03-06,1,0,3,22,0,0,0,2,0.22,0.197,1.0,0.3881,0,0,10,100,10,100
1480,2011-03-06,1,0,3,23,0,0,0,2,0.22,0.197,1.0,0.4179,0,0,9,90,9,90
1481,2011-03-07,1,0,3,0,0,1,1,3,0.2,0.1818,1.0,0.3284,0,0,4,40,4,40
1482,2011-03-07,1,0,3,1,0,1,1,3,0.2,0.1818,1.0,0.3284,0,0,2,20,2,20
1483,2011-03-07,1,0,3,3,0,1,1,1,0.2,0.1515,0.8,0.5821,0,0,1,10,1,10
1484,2011-03-07,1,0,3,4,0,1,1,1,0.2,0.1515,0.8,0.5224,1,15,0,0,1,15
1485,2011-03-07,1,0,3,5,0,1,1,1,0.2,0.1818,0.75,0.3582,0,0,1,10,1,10
1486,2011-03-07,1,0,3,6,0,1,1,1,0.2,0.1818,0.75,0.3881,3,45,31,310,34,355
1487,2011-03-07,1,0,3,7,0,1,1,1,0.2,0.1667,0.75,0.4179,3,45,88,880,91,925
1488,2011-03-07,1,0,3,8,0,1,1,1,0.2,0.1818,0.75,0.3881,11,165,200,2000,211,2165
1489,2011-03-07,1,0,3,9,0,1,1,1,0.22,0.1818,0.64,0.4627,5,75,129,1290,134,1365
1490,2011-03-07,1,0,3,10,0,1,1,1,0.24,0.2121,0.6,0.2985,15,225,43,430,58,655
1491,2011-03-07,1,0,3,11,0,1,1,1,0.26,0.2121,0.48,0.4478,19,285,41,410,60,695
1492,2011-03-07,1,0,3,12,0,1,1,1,0.3,0.2727,0.42,0.4179,28,420,68,680,96,1100
1493,2011-03-07,1,0,3,13,0,1,1,1,0.32,0.2879,0.36,0.3881,16,240,54,540,70,780
1494,2011-03-07,1,0,3,14,0,1,1,1,0.32,0.2879,0.36,0.4179,21,315,56,560,77,875
1495,2011-03-07,1,0,3,15,0,1,1,1,0.34,0.303,0.31,0.3881,32,480,64,640,96,1120
1496,2011-03-07,1,0,3,16,0,1,1,1,0.34,0.303,0.31,0.3582,26,390,96,960,122,1350
1497,2011-03-07,1,0,3,17,0,1,1,1,0.34,0.303,0.29,0.3582,27,405,206,2060,233,2465
1498,2011-03-07,1,0,3,18,0,1,1,1,0.32,0.303,0.31,0.2239,19,285,214,2140,233,2425
1499,2011-03-07,1,0,3,19,0,1,1,1,0.3,0.2879,0.33,0.2239,11,165,134,1340,145,1505
1500,2011-03-07,1,0,3,20,0,1,1,1,0.3,0.303,0.33,0.1642,5,75,87,870,92,945
1501,2011-03-07,1,0,3,21,0,1,1,1,0.28,0.2727,0.38,0.2239,1,15,53,530,54,545
1502,2011-03-07,1,0,3,22,0,1,1,1,0.26,0.2576,0.48,0.1642,1,15,34,340,35,355
1503,2011-03-07,1,0,3,23,0,1,1,1,0.28,0.3182,0.48,0.0,0,0,22,220,22,220
1504,2011-03-08,1,0,3,0,0,2,1,1,0.26,0.2879,0.48,0.0896,1,15,9,90,10,105
1505,2011-03-08,1,0,3,1,0,2,1,1,0.24,0.2424,0.52,0.1343,0,0,4,40,4,40
1506,2011-03-08,1,0,3,2,0,2,1,1,0.24,0.2424,0.52,0.1343,1,15,0,0,1,15
1507,2011-03-08,1,0,3,3,0,2,1,1,0.24,0.2576,0.52,0.0896,5,75,2,20,7,95
1508,2011-03-08,1,0,3,4,0,2,1,1,0.22,0.2727,0.64,0.0,0,0,2,20,2,20
1509,2011-03-08,1,0,3,5,0,2,1,1,0.2,0.2273,0.69,0.1045,2,30,8,80,10,110
1510,2011-03-08,1,0,3,6,0,2,1,1,0.2,0.2576,0.59,0.0,3,45,42,420,45,465
1511,2011-03-08,1,0,3,7,0,2,1,1,0.18,0.197,0.64,0.1343,9,135,119,1190,128,1325
1512,2011-03-08,1,0,3,8,0,2,1,1,0.22,0.2273,0.55,0.194,10,150,247,2470,257,2620
1513,2011-03-08,1,0,3,9,0,2,1,1,0.26,0.2576,0.41,0.1642,11,165,140,1400,151,1565
1514,2011-03-08,1,0,3,10,0,2,1,2,0.3,0.2879,0.33,0.194,25,375,46,460,71,835
1515,2011-03-08,1,0,3,11,0,2,1,2,0.36,0.3485,0.25,0.1642,26,390,52,520,78,910
1516,2011-03-08,1,0,3,12,0,2,1,2,0.36,0.3788,0.23,0.0,29,435,70,700,99,1135
1517,2011-03-08,1,0,3,13,0,2,1,2,0.38,0.3939,0.25,0.1045,25,375,73,730,98,1105
1518,2011-03-08,1,0,3,14,0,2,1,2,0.38,0.3939,0.2,0.0,16,240,56,560,72,800
1519,2011-03-08,1,0,3,15,0,2,1,2,0.36,0.3788,0.18,0.0,35,525,77,770,112,1295
1520,2011-03-08,1,0,3,16,0,2,1,1,0.38,0.3939,0.27,0.1642,26,390,82,820,108,1210
1521,2011-03-08,1,0,3,17,0,2,1,1,0.36,0.3485,0.27,0.2239,39,585,209,2090,248,2675
1522,2011-03-08,1,0,3,18,0,2,1,1,0.34,0.3333,0.27,0.194,21,315,214,2140,235,2455
1523,2011-03-08,1,0,3,19,0,2,1,1,0.34,0.3485,0.31,0.1045,9,135,141,1410,150,1545
1524,2011-03-08,1,0,3,20,0,2,1,1,0.32,0.3333,0.39,0.0896,2,30,74,740,76,770
1525,2011-03-08,1,0,3,21,0,2,1,1,0.3,0.2879,0.49,0.194,7,105,68,680,75,785
1526,2011-03-08,1,0,3,22,0,2,1,1,0.3,0.2879,0.49,0.2239,11,165,44,440,55,605
1527,2011-03-08,1,0,3,23,0,2,1,1,0.28,0.2727,0.61,0.194,3,45,38,380,41,425
1528,2011-03-09,1,0,3,0,0,3,1,1,0.26,0.2879,0.65,0.0896,0,0,9,90,9,90
1529,2011-03-09,1,0,3,1,0,3,1,1,0.26,0.2727,0.52,0.1343,0,0,4,40,4,40
1530,2011-03-09,1,0,3,2,0,3,1,1,0.26,0.2727,0.52,0.1343,1,15,1,10,2,25
1531,2011-03-09,1,0,3,3,0,3,1,1,0.24,0.2576,0.7,0.0896,1,15,2,20,3,35
1532,2011-03-09,1,0,3,4,0,3,1,1,0.24,0.2576,0.75,0.1045,0,0,2,20,2,20
1533,2011-03-09,1,0,3,5,0,3,1,2,0.24,0.2424,0.81,0.1343,1,15,7,70,8,85
1534,2011-03-09,1,0,3,6,0,3,1,2,0.24,0.2576,0.85,0.1045,5,75,44,440,49,515
1535,2011-03-09,1,0,3,7,0,3,1,2,0.24,0.2424,0.87,0.1642,18,270,123,1230,141,1500
1536,2011-03-09,1,0,3,8,0,3,1,2,0.24,0.2424,0.87,0.1343,11,165,238,2380,249,2545
1537,2011-03-09,1,0,3,9,0,3,1,2,0.26,0.2424,0.87,0.2537,5,75,136,1360,141,1435
1538,2011-03-09,1,0,3,10,0,3,1,2,0.3,0.2879,0.75,0.2537,8,120,49,490,57,610
1539,2011-03-09,1,0,3,11,0,3,1,2,0.32,0.2879,0.76,0.3881,15,225,44,440,59,665
1540,2011-03-09,1,0,3,12,0,3,1,2,0.32,0.303,0.76,0.2537,14,210,84,840,98,1050
1541,2011-03-09,1,0,3,13,0,3,1,2,0.32,0.2879,0.76,0.3582,17,255,82,820,99,1075
1542,2011-03-09,1,0,3,14,0,3,1,2,0.34,0.303,0.76,0.2985,10,150,61,610,71,760
1543,2011-03-09,1,0,3,15,0,3,1,2,0.36,0.3333,0.71,0.2985,15,225,64,640,79,865
1544,2011-03-09,1,0,3,16,0,3,1,2,0.34,0.303,0.76,0.3284,10,150,102,1020,112,1170
1545,2011-03-09,1,0,3,17,0,3,1,2,0.34,0.303,0.76,0.2985,18,270,176,1760,194,2030
1546,2011-03-09,1,0,3,18,0,3,1,2,0.34,0.3182,0.76,0.2537,12,180,176,1760,188,1940
1547,2011-03-09,1,0,3,19,0,3,1,2,0.34,0.303,0.76,0.3284,11,165,123,1230,134,1395
1548,2011-03-09,1,0,3,20,0,3,1,2,0.32,0.3182,0.87,0.194,4,60,87,870,91,930
1549,2011-03-09,1,0,3,21,0,3,1,2,0.32,0.303,0.93,0.3284,10,150,52,520,62,670
1550,2011-03-09,1,0,3,22,0,3,1,3,0.32,0.3182,0.93,0.1642,4,60,17,170,21,230
1551,2011-03-09,1,0,3,23,0,3,1,3,0.34,0.3333,0.93,0.194,1,15,17,170,18,185
1552,2011-03-10,1,0,3,0,0,4,1,3,0.34,0.3182,0.0,0.2537,3,45,0,0,3,45
1553,2011-03-10,1,0,3,1,0,4,1,3,0.34,0.3182,0.0,0.2537,0,0,2,20,2,20
1554,2011-03-10,1,0,3,2,0,4,1,3,0.34,0.3182,0.0,0.2537,0,0,1,10,1,10
1555,2011-03-10,1,0,3,5,0,4,1,3,0.36,0.3485,0.0,0.194,1,15,2,20,3,35
1556,2011-03-10,1,0,3,6,0,4,1,3,0.36,0.3333,0.0,0.3284,0,0,12,120,12,120
1557,2011-03-10,1,0,3,7,0,4,1,3,0.38,0.3939,0.0,0.2239,1,15,36,360,37,375
1558,2011-03-10,1,0,3,8,0,4,1,3,0.38,0.3939,0.0,0.2836,1,15,43,430,44,445
1559,2011-03-10,1,0,3,9,0,4,1,3,0.4,0.4091,0.0,0.2239,1,15,23,230,24,245
1560,2011-03-10,1,0,3,10,0,4,1,3,0.4,0.4091,0.0,0.1642,0,0,17,170,17,170
1561,2011-03-10,1,0,3,11,0,4,1,3,0.4,0.4091,0.0,0.2537,6,90,5,50,11,140
1562,2011-03-10,1,0,3,12,0,4,1,3,0.42,0.4242,0.0,0.2239,4,60,30,300,34,360
1563,2011-03-10,1,0,3,13,0,4,1,3,0.42,0.4242,0.0,0.2239,1,15,11,110,12,125
1564,2011-03-10,1,0,3,14,0,4,1,3,0.44,0.4394,0.0,0.2985,0,0,12,120,12,120
1565,2011-03-10,1,0,3,15,0,4,1,3,0.44,0.4394,0.0,0.2239,3,45,11,110,14,155
1566,2011-03-10,1,0,3,16,0,4,1,3,0.42,0.4242,0.0,0.2537,1,15,20,200,21,215
1567,2011-03-10,1,0,3,17,0,4,1,2,0.44,0.4394,0.0,0.3881,2,30,109,1090,111,1120
1568,2011-03-10,1,0,3,18,0,4,1,3,0.44,0.4394,0.0,0.3582,2,30,80,800,82,830
1569,2011-03-10,1,0,3,19,0,4,1,3,0.44,0.4394,0.0,0.5821,5,75,51,510,56,585
1570,2011-03-10,1,0,3,20,0,4,1,3,0.36,0.3333,0.0,0.3284,9,135,29,290,38,425
1571,2011-03-10,1,0,3,21,0,4,1,3,0.36,0.3485,0.0,0.2239,1,15,27,270,28,285
1572,2011-03-10,1,0,3,22,0,4,1,2,0.34,0.3333,0.0,0.1343,4,60,30,300,34,360
1573,2011-03-10,1,0,3,23,0,4,1,3,0.34,0.3485,0.0,0.0896,1,15,26,260,27,275
1574,2011-03-11,1,0,3,0,0,5,1,2,0.34,0.3485,1.0,0.0896,0,0,6,60,6,60
1575,2011-03-11,1,0,3,1,0,5,1,3,0.34,0.3485,1.0,0.1045,0,0,8,80,8,80
1576,2011-03-11,1,0,3,2,0,5,1,3,0.34,0.3485,1.0,0.1045,2,30,3,30,5,60
1577,2011-03-11,1,0,3,3,0,5,1,2,0.32,0.3333,0.93,0.0896,0,0,2,20,2,20
1578,2011-03-11,1,0,3,5,0,5,1,1,0.3,0.2879,0.81,0.2239,1,15,6,60,7,75
1579,2011-03-11,1,0,3,6,0,5,1,1,0.26,0.2424,0.81,0.2836,1,15,31,310,32,325
1580,2011-03-11,1,0,3,7,0,5,1,1,0.26,0.2576,0.7,0.194,10,150,104,1040,114,1190
1581,2011-03-11,1,0,3,8,0,5,1,1,0.28,0.2727,0.7,0.2537,15,225,244,2440,259,2665
1582,2011-03-11,1,0,3,9,0,5,1,2,0.3,0.2879,0.61,0.2836,13,195,143,1430,156,1625
1583,2011-03-11,1,0,3,10,0,5,1,2,0.32,0.303,0.57,0.2985,18,270,60,600,78,870
1584,2011-03-11,1,0,3,11,0,5,1,2,0.32,0.303,0.57,0.2985,14,210,67,670,81,880
1585,2011-03-11,1,0,3,12,0,5,1,2,0.34,0.3182,0.53,0.2537,15,225,96,960,111,1185
1586,2011-03-11,1,0,3,13,0,5,1,1,0.36,0.3333,0.53,0.2537,15,225,92,920,107,1145
1587,2011-03-11,1,0,3,14,0,5,1,2,0.36,0.3333,0.5,0.3582,25,375,64,640,89,1015
1588,2011-03-11,1,0,3,15,0,5,1,2,0.34,0.3182,0.53,0.2537,21,315,64,640,85,955
1589,2011-03-11,1,0,3,16,0,5,1,2,0.34,0.303,0.49,0.2985,18,270,95,950,113,1220
1590,2011-03-11,1,0,3,17,0,5,1,1,0.34,0.3182,0.49,0.2239,23,345,200,2000,223,2345
1591,2011-03-11,1,0,3,18,0,5,1,1,0.32,0.303,0.49,0.3284,19,285,134,1340,153,1625
1592,2011-03-11,1,0,3,19,0,5,1,1,0.3,0.2727,0.56,0.3284,7,105,111,1110,118,1215
1593,2011-03-11,1,0,3,20,0,5,1,1,0.3,0.303,0.56,0.1642,6,90,70,700,76,790
1594,2011-03-11,1,0,3,21,0,5,1,2,0.3,0.2879,0.52,0.2537,10,150,43,430,53,580
1595,2011-03-11,1,0,3,22,0,5,1,1,0.3,0.303,0.52,0.1642,11,165,53,530,64,695
1596,2011-03-11,1,0,3,23,0,5,1,1,0.3,0.2879,0.52,0.2537,3,45,34,340,37,385
1597,2011-03-12,1,0,3,0,0,6,0,1,0.26,0.2727,0.6,0.1343,4,60,30,300,34,360
1598,2011-03-12,1,0,3,1,0,6,0,1,0.24,0.2273,0.65,0.194,3,45,15,150,18,195
1599,2011-03-12,1,0,3,2,0,6,0,1,0.24,0.2273,0.65,0.194,0,0,14,140,14,140
1600,2011-03-12,1,0,3,3,0,6,0,1,0.24,0.2273,0.65,0.2537,1,15,6,60,7,75
1601,2011-03-12,1,0,3,4,0,6,0,1,0.24,0.2273,0.65,0.2537,0,0,1,10,1,10
1602,2011-03-12,1,0,3,5,0,6,0,1,0.22,0.2273,0.69,0.194,0,0,2,20,2,20
1603,2011-03-12,1,0,3,6,0,6,0,1,0.22,0.2121,0.75,0.2537,2,30,2,20,4,50
1604,2011-03-12,1,0,3,7,0,6,0,1,0.24,0.2273,0.7,0.194,4,60,19,190,23,250
1605,2011-03-12,1,0,3,8,0,6,0,1,0.26,0.2576,0.65,0.1642,9,135,44,440,53,575
1606,2011-03-12,1,0,3,9,0,6,0,1,0.28,0.2879,0.65,0.1045,25,375,76,760,101,1135
1607,2011-03-12,1,0,3,10,0,6,0,1,0.32,0.303,0.66,0.2239,21,315,78,780,99,1095
1608,2011-03-12,1,0,3,11,0,6,0,1,0.34,0.303,0.49,0.3284,36,540,83,830,119,1370
1609,2011-03-12,1,0,3,12,0,6,0,1,0.34,0.3182,0.53,0.2836,51,765,107,1070,158,1835
1610,2011-03-12,1,0,3,13,0,6,0,1,0.36,0.3333,0.51,0.3582,62,930,95,950,157,1880
1611,2011-03-12,1,0,3,14,0,6,0,1,0.4,0.4091,0.5,0.4478,70,1050,96,960,166,2010
1612,2011-03-12,1,0,3,15,0,6,0,1,0.42,0.4242,0.44,0.4925,81,1215,101,1010,182,2225
1613,2011-03-12,1,0,3,16,0,6,0,1,0.46,0.4545,0.41,0.4478,100,1500,144,1440,244,2940
1614,2011-03-12,1,0,3,17,0,6,0,1,0.46,0.4545,0.44,0.3284,99,1485,114,1140,213,2625
1615,2011-03-12,1,0,3,18,0,6,0,1,0.42,0.4242,0.54,0.1642,54,810,91,910,145,1720
1616,2011-03-12,1,0,3,19,0,6,0,1,0.42,0.4242,0.54,0.0896,26,390,86,860,112,1250
1617,2011-03-12,1,0,3,20,0,6,0,1,0.4,0.4091,0.58,0.1045,22,330,64,640,86,970
1618,2011-03-12,1,0,3,21,0,6,0,1,0.38,0.3939,0.62,0.0,36,540,46,460,82,1000
1619,2011-03-12,1,0,3,22,0,6,0,1,0.36,0.3788,0.71,0.0,7,105,56,560,63,665
1620,2011-03-12,1,0,3,23,0,6,0,1,0.38,0.3939,0.66,0.0896,11,165,38,380,49,545
1621,2011-03-13,1,0,3,0,0,0,0,1,0.38,0.3939,0.62,0.1045,3,45,35,350,38,395
1622,2011-03-13,1,0,3,1,0,0,0,1,0.36,0.3485,0.66,0.1343,10,150,23,230,33,380
1623,2011-03-13,1,0,3,3,0,0,0,1,0.34,0.3333,0.76,0.1343,6,90,17,170,23,260
1624,2011-03-13,1,0,3,4,0,0,0,1,0.34,0.3333,0.66,0.1642,4,60,9,90,13,150
1625,2011-03-13,1,0,3,5,0,0,0,1,0.36,0.3485,0.62,0.1343,0,0,3,30,3,30
1626,2011-03-13,1,0,3,6,0,0,0,1,0.34,0.3636,0.66,0.0,0,0,2,20,2,20
1627,2011-03-13,1,0,3,7,0,0,0,1,0.36,0.3485,0.62,0.194,2,30,8,80,10,110
1628,2011-03-13,1,0,3,8,0,0,0,1,0.4,0.4091,0.5,0.2985,11,165,23,230,34,395
1629,2011-03-13,1,0,3,9,0,0,0,1,0.4,0.4091,0.5,0.4179,8,120,36,360,44,480
1630,2011-03-13,1,0,3,10,0,0,0,1,0.42,0.4242,0.47,0.2537,36,540,86,860,122,1400
1631,2011-03-13,1,0,3,11,0,0,0,1,0.44,0.4394,0.41,0.4179,88,1320,93,930,181,2250
1632,2011-03-13,1,0,3,12,0,0,0,1,0.46,0.4545,0.38,0.3881,74,1110,120,1200,194,2310
1633,2011-03-13,1,0,3,13,0,0,0,1,0.46,0.4545,0.38,0.3881,97,1455,124,1240,221,2695
1634,2011-03-13,1,0,3,14,0,0,0,1,0.46,0.4545,0.41,0.2985,144,2160,106,1060,250,3220
1635,2011-03-13,1,0,3,15,0,0,0,1,0.48,0.4697,0.39,0.3284,149,2235,155,1550,304,3785
1636,2011-03-13,1,0,3,16,0,0,0,1,0.46,0.4545,0.41,0.3881,124,1860,132,1320,256,3180
1637,2011-03-13,1,0,3,17,0,0,0,1,0.44,0.4394,0.41,0.3582,98,1470,143,1430,241,2900
1638,2011-03-13,1,0,3,18,0,0,0,1,0.4,0.4091,0.43,0.3582,55,825,92,920,147,1745
1639,2011-03-13,1,0,3,19,0,0,0,1,0.36,0.3333,0.5,0.3582,28,420,73,730,101,1150
1640,2011-03-13,1,0,3,20,0,0,0,1,0.32,0.303,0.57,0.2985,23,345,54,540,77,885
1641,2011-03-13,1,0,3,21,0,0,0,1,0.3,0.2879,0.56,0.2537,9,135,49,490,58,625
1642,2011-03-13,1,0,3,22,0,0,0,1,0.3,0.2727,0.56,0.3284,8,120,29,290,37,410
1643,2011-03-13,1,0,3,23,0,0,0,1,0.26,0.2576,0.65,0.2239,5,75,23,230,28,305
1644,2011-03-14,1,0,3,0,0,1,1,1,0.26,0.2727,0.65,0.1045,4,60,7,70,11,130
1645,2011-03-14,1,0,3,1,0,1,1,1,0.26,0.2879,0.65,0.0896,0,0,1,10,1,10
1646,2011-03-14,1,0,3,2,0,1,1,1,0.26,0.2879,0.65,0.0896,0,0,1,10,1,10
1647,2011-03-14,1,0,3,3,0,1,1,1,0.26,0.2727,0.65,0.1343,0,0,3,30,3,30
1648,2011-03-14,1,0,3,5,0,1,1,1,0.24,0.2424,0.7,0.1343,0,0,8,80,8,80
1649,2011-03-14,1,0,3,6,0,1,1,1,0.26,0.2727,0.65,0.1343,1,15,27,270,28,285
1650,2011-03-14,1,0,3,7,0,1,1,2,0.28,0.3182,0.61,0.0,4,60,84,840,88,900
1651,2011-03-14,1,0,3,8,0,1,1,2,0.3,0.303,0.56,0.1343,24,360,217,2170,241,2530
1652,2011-03-14,1,0,3,9,0,1,1,1,0.32,0.303,0.53,0.3284,13,195,127,1270,140,1465
1653,2011-03-14,1,0,3,10,0,1,1,1,0.34,0.3182,0.42,0.2537,27,405,57,570,84,975
1654,2011-03-14,1,0,3,11,0,1,1,1,0.36,0.3333,0.4,0.2537,26,390,45,450,71,840
1655,2011-03-14,1,0,3,12,0,1,1,1,0.38,0.3939,0.37,0.0,40,600,54,540,94,1140
1656,2011-03-14,1,0,3,13,0,1,1,1,0.38,0.3939,0.36,0.3284,24,360,51,510,75,870
1657,2011-03-14,1,0,3,14,0,1,1,2,0.38,0.3939,0.34,0.0,27,405,52,520,79,925
1658,2011-03-14,1,0,3,15,0,1,1,1,0.38,0.3939,0.37,0.1642,24,360,77,770,101,1130
1659,2011-03-14,1,0,3,16,0,1,1,1,0.4,0.4091,0.35,0.1045,27,405,80,800,107,1205
1660,2011-03-14,1,0,3,17,0,1,1,1,0.38,0.3939,0.4,0.194,42,630,229,2290,271,2920
1661,2011-03-14,1,0,3,18,0,1,1,1,0.36,0.3636,0.4,0.1045,25,375,210,2100,235,2475
1662,2011-03-14,1,0,3,19,0,1,1,1,0.36,0.3485,0.43,0.1343,17,255,133,1330,150,1585
1663,2011-03-14,1,0,3,20,0,1,1,1,0.34,0.3182,0.46,0.2239,23,345,106,1060,129,1405
1664,2011-03-14,1,0,3,21,0,1,1,1,0.34,0.3333,0.46,0.1343,5,75,58,580,63,655
1665,2011-03-14,1,0,3,22,0,1,1,1,0.32,0.3333,0.49,0.1045,4,60,43,430,47,490
1666,2011-03-14,1,0,3,23,0,1,1,1,0.32,0.3485,0.53,0.0,2,30,17,170,19,200
1667,2011-03-15,1,0,3,0,0,2,1,1,0.32,0.3485,0.53,0.0,7,105,7,70,14,175
1668,2011-03-15,1,0,3,1,0,2,1,1,0.3,0.303,0.62,0.0896,4,60,6,60,10,120
1669,2011-03-15,1,0,3,2,0,2,1,1,0.3,0.303,0.62,0.0896,1,15,2,20,3,35
1670,2011-03-15,1,0,3,4,0,2,1,1,0.24,0.2576,0.75,0.0896,1,15,1,10,2,25
1671,2011-03-15,1,0,3,5,0,2,1,1,0.24,0.2273,0.75,0.194,0,0,11,110,11,110
1672,2011-03-15,1,0,3,6,0,2,1,1,0.22,0.2273,0.8,0.194,3,45,32,320,35,365
1673,2011-03-15,1,0,3,7,0,2,1,1,0.24,0.2424,0.75,0.1642,10,150,109,1090,119,1240
1674,2011-03-15,1,0,3,8,0,2,1,1,0.26,0.2879,0.7,0.0896,23,345,259,2590,282,2935
1675,2011-03-15,1,0,3,9,0,2,1,2,0.3,0.3333,0.7,0.0,10,150,147,1470,157,1620
1676,2011-03-15,1,0,3,10,0,2,1,2,0.32,0.3182,0.66,0.194,22,330,56,560,78,890
1677,2011-03-15,1,0,3,11,0,2,1,2,0.34,0.3182,0.57,0.2239,27,405,51,510,78,915
1678,2011-03-15,1,0,3,12,0,2,1,2,0.36,0.3485,0.5,0.2239,32,480,70,700,102,1180
1679,2011-03-15,1,0,3,13,0,2,1,2,0.36,0.3333,0.57,0.2836,23,345,74,740,97,1085
1680,2011-03-15,1,0,3,14,0,2,1,2,0.38,0.3939,0.46,0.2985,14,210,74,740,88,950
1681,2011-03-15,1,0,3,15,0,2,1,2,0.38,0.3939,0.43,0.2836,24,360,66,660,90,1020
1682,2011-03-15,1,0,3,16,0,2,1,2,0.38,0.3939,0.46,0.3284,21,315,93,930,114,1245
1683,2011-03-15,1,0,3,17,0,2,1,2,0.36,0.3485,0.62,0.194,22,330,195,1950,217,2280
1684,2011-03-15,1,0,3,18,0,2,1,2,0.36,0.3333,0.62,0.2985,18,270,207,2070,225,2340
1685,2011-03-15,1,0,3,19,0,2,1,2,0.34,0.3182,0.71,0.2836,14,210,138,1380,152,1590
1686,2011-03-15,1,0,3,20,0,2,1,2,0.34,0.3182,0.71,0.2836,9,135,79,790,88,925
1687,2011-03-15,1,0,3,21,0,2,1,3,0.32,0.3333,0.81,0.1045,2,30,53,530,55,560
1688,2011-03-15,1,0,3,22,0,2,1,2,0.32,0.3182,0.87,0.1642,1,15,20,200,21,215
1689,2011-03-15,1,0,3,23,0,2,1,2,0.32,0.3182,0.87,0.1642,1,15,17,170,18,185
1690,2011-03-16,1,0,3,0,0,3,1,3,0.3,0.2879,0.93,0.2537,0,0,8,80,8,80
1691,2011-03-16,1,0,3,1,0,3,1,3,0.3,0.2727,1.0,0.2985,1,15,2,20,3,35
1692,2011-03-16,1,0,3,3,0,3,1,2,0.28,0.2727,1.0,0.2239,1,15,2,20,3,35
1693,2011-03-16,1,0,3,4,0,3,1,2,0.3,0.303,0.93,0.1642,0,0,1,10,1,10
1694,2011-03-16,1,0,3,5,0,3,1,2,0.3,0.3182,0.93,0.1045,0,0,3,30,3,30
1695,2011-03-16,1,0,3,6,0,3,1,2,0.3,0.3182,0.93,0.1045,1,15,30,300,31,315
1696,2011-03-16,1,0,3,7,0,3,1,2,0.3,0.2879,0.93,0.194,10,150,101,1010,111,1160
1697,2011-03-16,1,0,3,8,0,3,1,2,0.32,0.3182,0.93,0.0,26,390,227,2270,253,2660
1698,2011-03-16,1,0,3,9,0,3,1,2,0.32,0.3333,0.93,0.1343,10,150,144,1440,154,1590
1699,2011-03-16,1,0,3,10,0,3,1,2,0.36,0.3485,0.81,0.1642,19,285,49,490,68,775
1700,2011-03-16,1,0,3,11,0,3,1,2,0.36,0.3485,0.81,0.1343,13,195,62,620,75,815
1701,2011-03-16,1,0,3,12,0,3,1,2,0.4,0.4091,0.71,0.1045,23,345,65,650,88,995
1702,2011-03-16,1,0,3,13,0,3,1,2,0.4,0.4091,0.76,0.1343,18,270,81,810,99,1080
1703,2011-03-16,1,0,3,14,0,3,1,2,0.4,0.4091,0.76,0.2239,33,495,67,670,100,1165
1704,2011-03-16,1,0,3,15,0,3,1,2,0.4,0.4091,0.76,0.2537,22,330,79,790,101,1120
1705,2011-03-16,1,0,3,16,0,3,1,2,0.4,0.4091,0.76,0.1642,30,450,121,1210,151,1660
1706,2011-03-16,1,0,3,17,0,3,1,2,0.44,0.4394,0.54,0.2985,37,555,216,2160,253,2715
1707,2011-03-16,1,0,3,18,0,3,1,2,0.44,0.4394,0.54,0.2239,26,390,211,2110,237,2500
1708,2011-03-16,1,0,3,19,0,3,1,2,0.44,0.4394,0.51,0.3284,18,270,150,1500,168,1770
1709,2011-03-16,1,0,3,20,0,3,1,2,0.42,0.4242,0.54,0.2985,10,150,111,1110,121,1260
1710,2011-03-16,1,0,3,21,0,3,1,2,0.42,0.4242,0.58,0.2836,3,45,75,750,78,795
1711,2011-03-16,1,0,3,22,0,3,1,2,0.4,0.4091,0.62,0.3881,11,165,48,480,59,645
1712,2011-03-16,1,0,3,23,0,3,1,1,0.4,0.4091,0.65,0.194,9,135,18,180,27,315
1713,2011-03-17,1,0,3,0,0,4,1,1,0.38,0.3939,0.66,0.2537,4,60,19,190,23,250
1714,2011-03-17,1,0,3,1,0,4,1,1,0.36,0.3485,0.71,0.2239,1,15,11,110,12,125
1715,2011-03-17,1,0,3,2,0,4,1,1,0.34,0.303,0.71,0.2985,3,45,5,50,8,95
1716,2011-03-17,1,0,3,3,0,4,1,1,0.34,0.3333,0.66,0.1642,1,15,1,10,2,25
1717,2011-03-17,1,0,3,4,0,4,1,1,0.34,0.3333,0.71,0.194,0,0,3,30,3,30
1718,2011-03-17,1,0,3,5,0,4,1,1,0.32,0.3333,0.76,0.1045,0,0,13,130,13,130
1719,2011-03-17,1,0,3,6,0,4,1,1,0.32,0.3182,0.76,0.194,4,60,47,470,51,530
1720,2011-03-17,1,0,3,7,0,4,1,1,0.32,0.3333,0.76,0.1343,12,180,128,1280,140,1460
1721,2011-03-17,1,0,3,8,0,4,1,1,0.36,0.3485,0.66,0.1343,17,255,282,2820,299,3075
1722,2011-03-17,1,0,3,9,0,4,1,1,0.4,0.4091,0.62,0.2537,23,345,162,1620,185,1965
1723,2011-03-17,1,0,3,10,0,4,1,1,0.44,0.4394,0.54,0.3284,9,135,69,690,78,825
1724,2011-03-17,1,0,3,11,0,4,1,1,0.44,0.4394,0.54,0.2836,20,300,66,660,86,960
1725,2011-03-17,1,0,3,12,0,4,1,1,0.5,0.4848,0.45,0.2239,24,360,81,810,105,1170
1726,2011-03-17,1,0,3,13,0,4,1,2,0.52,0.5,0.42,0.0896,26,390,85,850,111,1240
1727,2011-03-17,1,0,3,14,0,4,1,1,0.5,0.4848,0.45,0.1045,32,480,87,870,119,1350
1728,2011-03-17,1,0,3,15,0,4,1,1,0.52,0.5,0.42,0.2537,30,450,95,950,125,1400
1729,2011-03-17,1,0,3,16,0,4,1,1,0.5,0.4848,0.48,0.2836,34,510,108,1080,142,1590
1730,2011-03-17,1,0,3,17,0,4,1,1,0.5,0.4848,0.42,0.194,48,720,265,2650,313,3370
1731,2011-03-17,1,0,3,18,0,4,1,2,0.46,0.4545,0.59,0.1642,50,750,260,2600,310,3350
1732,2011-03-17,1,0,3,19,0,4,1,1,0.44,0.4394,0.58,0.194,18,270,189,1890,207,2160
1733,2011-03-17,1,0,3,20,0,4,1,1,0.42,0.4242,0.67,0.2239,25,375,112,1120,137,1495
1734,2011-03-17,1,0,3,21,0,4,1,1,0.42,0.4242,0.62,0.2239,19,285,119,1190,138,1475
1735,2011-03-17,1,0,3,22,0,4,1,1,0.4,0.4091,0.66,0.2239,17,255,70,700,87,955
1736,2011-03-17,1,0,3,23,0,4,1,1,0.42,0.4242,0.62,0.2836,7,105,43,430,50,535
1737,2011-03-18,1,0,3,0,0,5,1,1,0.42,0.4242,0.58,0.2836,5,75,24,240,29,315
1738,2011-03-18,1,0,3,1,0,5,1,1,0.4,0.4091,0.62,0.2537,4,60,12,120,16,180
1739,2011-03-18,1,0,3,2,0,5,1,1,0.4,0.4091,0.62,0.194,5,75,9,90,14,165
1740,2011-03-18,1,0,3,3,0,5,1,1,0.36,0.3485,0.71,0.194,1,15,4,40,5,55
1741,2011-03-18,1,0,3,5,0,5,1,1,0.38,0.3939,0.66,0.1642,2,30,8,80,10,110
1742,2011-03-18,1,0,3,6,0,5,1,1,0.4,0.4091,0.66,0.194,1,15,35,350,36,365
1743,2011-03-18,1,0,3,7,0,5,1,1,0.4,0.4091,0.66,0.194,11,165,112,1120,123,1285
1744,2011-03-18,1,0,3,8,0,5,1,1,0.42,0.4242,0.67,0.2537,24,360,256,2560,280,2920
1745,2011-03-18,1,0,3,9,0,5,1,1,0.46,0.4545,0.63,0.2239,18,270,192,1920,210,2190
1746,2011-03-18,1,0,3,10,0,5,1,1,0.52,0.5,0.53,0.2836,43,645,74,740,117,1385
1747,2011-03-18,1,0,3,11,0,5,1,1,0.54,0.5152,0.52,0.2836,55,825,104,1040,159,1865
1748,2011-03-18,1,0,3,12,0,5,1,2,0.56,0.5303,0.49,0.3582,72,1080,123,1230,195,2310
1749,2011-03-18,1,0,3,13,0,5,1,1,0.64,0.6212,0.41,0.2836,57,855,118,1180,175,2035
1750,2011-03-18,1,0,3,14,0,5,1,1,0.66,0.6212,0.39,0.2537,71,1065,103,1030,174,2095
1751,2011-03-18,1,0,3,15,0,5,1,2,0.68,0.6364,0.39,0.3582,62,930,111,1110,173,2040
1752,2011-03-18,1,0,3,16,0,5,1,1,0.68,0.6364,0.39,0.2836,67,1005,137,1370,204,2375
1753,2011-03-18,1,0,3,17,0,5,1,1,0.7,0.6364,0.37,0.3284,95,1425,237,2370,332,3795
1754,2011-03-18,1,0,3,18,0,5,1,1,0.68,0.6364,0.39,0.1642,84,1260,247,2470,331,3730
1755,2011-03-18,1,0,3,19,0,5,1,1,0.66,0.6212,0.44,0.1343,58,870,132,1320,190,2190
1756,2011-03-18,1,0,3,20,0,5,1,1,0.62,0.6212,0.46,0.1343,46,690,103,1030,149,1720
1757,2011-03-18,1,0,3,21,0,5,1,1,0.62,0.6212,0.46,0.1045,22,330,91,910,113,1240
1758,2011-03-18,1,0,3,22,0,5,1,1,0.62,0.6212,0.5,0.1642,55,825,63,630,118,1455
1759,2011-03-18,1,0,3,23,0,5,1,2,0.6,0.6212,0.53,0.2239,26,390,60,600,86,990
1760,2011-03-19,1,0,3,0,0,6,0,2,0.6,0.6212,0.53,0.2537,26,390,50,500,76,890
1761,2011-03-19,1,0,3,1,0,6,0,2,0.58,0.5455,0.46,0.3582,16,240,35,350,51,590
1762,2011-03-19,1,0,3,2,0,6,0,2,0.56,0.5303,0.43,0.2239,5,75,20,200,25,275
1763,2011-03-19,1,0,3,3,0,6,0,2,0.54,0.5152,0.39,0.3284,1,15,7,70,8,85
1764,2011-03-19,1,0,3,4,0,6,0,1,0.52,0.5,0.34,0.4179,1,15,2,20,3,35
1765,2011-03-19,1,0,3,5,0,6,0,1,0.52,0.5,0.34,0.4179,0,0,2,20,2,20
1766,2011-03-19,1,0,3,6,0,6,0,1,0.44,0.4394,0.44,0.4179,0,0,10,100,10,100
1767,2011-03-19,1,0,3,7,0,6,0,1,0.4,0.4091,0.5,0.3284,4,60,9,90,13,150
1768,2011-03-19,1,0,3,8,0,6,0,1,0.42,0.4242,0.47,0.4925,11,165,37,370,48,535
1769,2011-03-19,1,0,3,9,0,6,0,1,0.42,0.4242,0.44,0.4627,35,525,41,410,76,935
1770,2011-03-19,1,0,3,10,0,6,0,1,0.44,0.4394,0.38,0.4179,55,825,85,850,140,1675
1771,2011-03-19,1,0,3,11,0,6,0,1,0.46,0.4545,0.36,0.4478,90,1350,106,1060,196,2410
1772,2011-03-19,1,0,3,12,0,6,0,1,0.46,0.4545,0.33,0.4179,126,1890,141,1410,267,3300
1773,2011-03-19,1,0,3,13,0,6,0,1,0.5,0.4848,0.34,0.4627,174,2610,127,1270,301,3880
1774,2011-03-19,1,0,3,14,0,6,0,1,0.5,0.4848,0.31,0.4925,168,2520,144,1440,312,3960
1775,2011-03-19,1,0,3,15,0,6,0,1,0.5,0.4848,0.29,0.4179,170,2550,143,1430,313,3980
1776,2011-03-19,1,0,3,16,0,6,0,1,0.5,0.4848,0.31,0.3881,175,2625,129,1290,304,3915
1777,2011-03-19,1,0,3,17,0,6,0,1,0.48,0.4697,0.31,0.3284,138,2070,140,1400,278,3470
1778,2011-03-19,1,0,3,18,0,6,0,1,0.46,0.4545,0.31,0.3284,92,1380,125,1250,217,2630
1779,2011-03-19,1,0,3,19,0,6,0,1,0.44,0.4394,0.33,0.2836,38,570,116,1160,154,1730
1780,2011-03-19,1,0,3,20,0,6,0,1,0.42,0.4242,0.35,0.2239,39,585,69,690,108,1275
1781,2011-03-19,1,0,3,21,0,6,0,1,0.4,0.4091,0.37,0.2985,20,300,73,730,93,1030
1782,2011-03-19,1,0,3,22,0,6,0,1,0.4,0.4091,0.37,0.3284,27,405,45,450,72,855
1783,2011-03-19,1,0,3,23,0,6,0,1,0.38,0.3939,0.4,0.2985,13,195,37,370,50,565
1784,2011-03-20,1,0,3,0,0,0,0,1,0.34,0.303,0.49,0.4179,7,105,33,330,40,435
1785,2011-03-20,1,0,3,1,0,0,0,1,0.32,0.2879,0.53,0.3582,2,30,22,220,24,250
1786,2011-03-20,1,0,3,2,0,0,0,1,0.3,0.2879,0.52,0.2836,6,90,24,240,30,330
1787,2011-03-20,1,0,3,3,0,0,0,1,0.28,0.2727,0.56,0.2537,1,15,11,110,12,125
1788,2011-03-20,1,0,3,4,0,0,0,1,0.26,0.2576,0.56,0.2239,2,30,1,10,3,40
1789,2011-03-20,1,0,3,5,0,0,0,1,0.26,0.2576,0.6,0.194,3,45,6,60,9,105
1790,2011-03-20,1,0,3,6,0,0,0,1,0.26,0.2576,0.6,0.2239,1,15,3,30,4,45
1791,2011-03-20,1,0,3,7,0,0,0,1,0.24,0.2273,0.6,0.2239,5,75,9,90,14,165
1792,2011-03-20,1,0,3,8,0,0,0,1,0.28,0.2727,0.56,0.1642,7,105,30,300,37,405
1793,2011-03-20,1,0,3,9,0,0,0,1,0.3,0.303,0.52,0.1343,35,525,43,430,78,955
1794,2011-03-20,1,0,3,10,0,0,0,2,0.32,0.3485,0.45,0.0,55,825,81,810,136,1635
1795,2011-03-20,1,0,3,11,0,0,0,1,0.34,0.3485,0.39,0.1045,92,1380,111,1110,203,2490
1796,2011-03-20,1,0,3,12,0,0,0,1,0.36,0.3636,0.4,0.1045,120,1800,108,1080,228,2880
1797,2011-03-20,1,0,3,13,0,0,0,1,0.38,0.3939,0.34,0.0,88,1320,115,1150,203,2470
1798,2011-03-20,1,0,3,14,0,0,0,1,0.4,0.4091,0.3,0.0,145,2175,134,1340,279,3515
1799,2011-03-20,1,0,3,15,0,0,0,1,0.4,0.4091,0.32,0.0896,172,2580,136,1360,308,3940
1800,2011-03-20,1,0,3,16,0,0,0,1,0.42,0.4242,0.32,0.0,92,1380,132,1320,224,2700
1801,2011-03-20,1,0,3,17,0,0,0,1,0.4,0.4091,0.35,0.2836,83,1245,143,1430,226,2675
1802,2011-03-20,1,0,3,18,0,0,0,1,0.38,0.3939,0.4,0.3582,58,870,98,980,156,1850
1803,2011-03-20,1,0,3,19,0,0,0,1,0.36,0.3333,0.43,0.2836,21,315,58,580,79,895
1804,2011-03-20,1,0,3,20,0,0,0,1,0.36,0.3333,0.46,0.2836,21,315,46,460,67,775
1805,2011-03-20,1,0,3,21,0,0,0,2,0.34,0.3182,0.53,0.2836,10,150,39,390,49,540
1806,2011-03-20,1,0,3,22,0,0,0,2,0.34,0.303,0.53,0.3284,8,120,30,300,38,420
1807,2011-03-20,1,0,3,23,0,0,0,3,0.34,0.303,0.61,0.3881,13,195,11,110,24,305
1808,2011-03-21,2,0,3,0,0,1,1,3,0.34,0.303,0.66,0.3881,2,30,11,110,13,140
1809,2011-03-21,2,0,3,1,0,1,1,2,0.34,0.303,0.71,0.3881,1,15,6,60,7,75
1810,2011-03-21,2,0,3,2,0,1,1,2,0.34,0.303,0.71,0.3284,1,15,5,50,6,65
1811,2011-03-21,2,0,3,3,0,1,1,2,0.34,0.303,0.71,0.3284,0,0,1,10,1,10
1812,2011-03-21,2,0,3,5,0,1,1,1,0.32,0.303,0.81,0.2985,1,15,1,10,2,25
1813,2011-03-21,2,0,3,6,0,1,1,3,0.32,0.303,0.76,0.2537,2,30,30,300,32,330
1814,2011-03-21,2,0,3,7,0,1,1,3,0.3,0.2727,0.87,0.4179,3,45,15,150,18,195
1815,2011-03-21,2,0,3,8,0,1,1,2,0.3,0.2727,0.87,0.4179,3,45,95,950,98,995
1816,2011-03-21,2,0,3,9,0,1,1,2,0.34,0.303,0.81,0.3284,12,180,115,1150,127,1330
1817,2011-03-21,2,0,3,10,0,1,1,2,0.38,0.3939,0.76,0.3881,17,255,45,450,62,705
1818,2011-03-21,2,0,3,11,0,1,1,2,0.42,0.4242,0.71,0.2985,32,480,47,470,79,950
1819,2011-03-21,2,0,3,12,0,1,1,2,0.44,0.4394,0.77,0.2537,25,375,56,560,81,935
1820,2011-03-21,2,0,3,13,0,1,1,2,0.5,0.4848,0.63,0.2239,35,525,77,770,112,1295
1821,2011-03-21,2,0,3,14,0,1,1,2,0.54,0.5152,0.64,0.2239,36,540,65,650,101,1190
1822,2011-03-21,2,0,3,15,0,1,1,2,0.56,0.5303,0.6,0.2239,41,615,66,660,107,1275
1823,2011-03-21,2,0,3,16,0,1,1,2,0.54,0.5152,0.64,0.2836,29,435,112,1120,141,1555
1824,2011-03-21,2,0,3,17,0,1,1,2,0.54,0.5152,0.64,0.2537,41,615,231,2310,272,2925
1825,2011-03-21,2,0,3,18,0,1,1,2,0.52,0.5,0.72,0.2239,44,660,232,2320,276,2980
1826,2011-03-21,2,0,3,19,0,1,1,1,0.58,0.5455,0.6,0.4179,22,330,199,1990,221,2320
1827,2011-03-21,2,0,3,20,0,1,1,1,0.56,0.5303,0.64,0.194,16,240,106,1060,122,1300
1828,2011-03-21,2,0,3,21,0,1,1,1,0.46,0.4545,0.94,0.194,12,180,79,790,91,970
1829,2011-03-21,2,0,3,22,0,1,1,1,0.46,0.4545,0.88,0.2239,18,270,60,600,78,870
1830,2011-03-21,2,0,3,23,0,1,1,1,0.46,0.4545,0.88,0.0896,8,120,22,220,30,340
1831,2011-03-22,2,0,3,0,0,2,1,1,0.46,0.4545,0.88,0.194,4,60,7,70,11,130
1832,2011-03-22,2,0,3,1,0,2,1,1,0.42,0.4242,1.0,0.1343,6,90,13,130,19,220
1833,2011-03-22,2,0,3,2,0,2,1,1,0.44,0.4394,0.94,0.0896,0,0,1,10,1,10
1834,2011-03-22,2,0,3,3,0,2,1,1,0.44,0.4394,0.82,0.2239,3,45,2,20,5,65
1835,2011-03-22,2,0,3,4,0,2,1,2,0.42,0.4242,0.82,0.1642,0,0,1,10,1,10
1836,2011-03-22,2,0,3,5,0,2,1,2,0.4,0.4091,0.87,0.1343,1,15,11,110,12,125
1837,2011-03-22,2,0,3,6,0,2,1,1,0.4,0.4091,0.87,0.2537,2,30,58,580,60,610
1838,2011-03-22,2,0,3,7,0,2,1,2,0.4,0.4091,0.76,0.1045,4,60,132,1320,136,1380
1839,2011-03-22,2,0,3,8,0,2,1,2,0.4,0.4091,0.58,0.2985,24,360,312,3120,336,3480
1840,2011-03-22,2,0,3,9,0,2,1,2,0.4,0.4091,0.58,0.4627,19,285,159,1590,178,1875
1841,2011-03-22,2,0,3,10,0,2,1,2,0.44,0.4394,0.54,0.2985,29,435,95,950,124,1385
1842,2011-03-22,2,0,3,11,0,2,1,1,0.44,0.4394,0.51,0.3284,22,330,64,640,86,970
1843,2011-03-22,2,0,3,12,0,2,1,1,0.46,0.4545,0.47,0.2537,35,525,86,860,121,1385
1844,2011-03-22,2,0,3,13,0,2,1,1,0.5,0.4848,0.45,0.2239,21,315,85,850,106,1165
1845,2011-03-22,2,0,3,14,0,2,1,1,0.5,0.4848,0.42,0.3284,30,450,71,710,101,1160
1846,2011-03-22,2,0,3,15,0,2,1,1,0.5,0.4848,0.42,0.2239,55,825,79,790,134,1615
1847,2011-03-22,2,0,3,16,0,2,1,1,0.5,0.4848,0.42,0.1045,40,600,125,1250,165,1850
1848,2011-03-22,2,0,3,17,0,2,1,1,0.5,0.4848,0.42,0.1045,42,630,265,2650,307,3280
1849,2011-03-22,2,0,3,18,0,2,1,1,0.48,0.4697,0.44,0.0896,41,615,271,2710,312,3325
1850,2011-03-22,2,0,3,19,0,2,1,2,0.44,0.4394,0.54,0.2537,22,330,142,1420,164,1750
1851,2011-03-22,2,0,3,20,0,2,1,2,0.44,0.4394,0.54,0.3582,19,285,116,1160,135,1445
1852,2011-03-22,2,0,3,21,0,2,1,2,0.42,0.4242,0.54,0.2836,24,360,63,630,87,990
1853,2011-03-22,2,0,3,22,0,2,1,2,0.4,0.4091,0.58,0.2537,13,195,57,570,70,765
1854,2011-03-22,2,0,3,23,0,2,1,2,0.4,0.4091,0.58,0.2537,4,60,28,280,32,340
1855,2011-03-23,2,0,3,0,0,3,1,3,0.36,0.3485,0.71,0.2239,3,45,8,80,11,125
1856,2011-03-23,2,0,3,1,0,3,1,3,0.34,0.3182,0.76,0.2239,0,0,7,70,7,70
1857,2011-03-23,2,0,3,2,0,3,1,3,0.34,0.3182,0.76,0.2239,1,15,1,10,2,25
1858,2011-03-23,2,0,3,3,0,3,1,2,0.34,0.3182,0.76,0.2537,0,0,3,30,3,30
1859,2011-03-23,2,0,3,5,0,3,1,3,0.32,0.3182,0.87,0.194,0,0,10,100,10,100
1860,2011-03-23,2,0,3,6,0,3,1,2,0.34,0.3182,0.87,0.2537,1,15,43,430,44,445
1861,2011-03-23,2,0,3,7,0,3,1,2,0.32,0.303,0.93,0.2239,7,105,111,1110,118,1215
1862,2011-03-23,2,0,3,8,0,3,1,2,0.32,0.3182,0.87,0.194,14,210,247,2470,261,2680
1863,2011-03-23,2,0,3,9,0,3,1,2,0.32,0.303,0.81,0.2537,8,120,174,1740,182,1860
1864,2011-03-23,2,0,3,10,0,3,1,2,0.34,0.3182,0.81,0.2836,15,225,60,600,75,825
1865,2011-03-23,2,0,3,11,0,3,1,2,0.34,0.3333,0.87,0.194,18,270,53,530,71,800
1866,2011-03-23,2,0,3,12,0,3,1,2,0.34,0.3182,0.87,0.2239,14,210,73,730,87,940
1867,2011-03-23,2,0,3,13,0,3,1,3,0.34,0.3333,0.87,0.1343,14,210,94,940,108,1150
1868,2011-03-23,2,0,3,14,0,3,1,2,0.36,0.3636,0.87,0.1045,13,195,71,710,84,905
1869,2011-03-23,2,0,3,15,0,3,1,2,0.38,0.3939,0.82,0.2239,11,165,74,740,85,905
1870,2011-03-23,2,0,3,16,0,3,1,2,0.4,0.4091,0.76,0.2239,13,195,123,1230,136,1425
1871,2011-03-23,2,0,3,17,0,3,1,2,0.4,0.4091,0.76,0.2239,28,420,245,2450,273,2870
1872,2011-03-23,2,0,3,18,0,3,1,3,0.38,0.3939,0.82,0.2537,20,300,218,2180,238,2480
1873,2011-03-23,2,0,3,19,0,3,1,3,0.38,0.3939,0.82,0.2537,12,180,147,1470,159,1650
1874,2011-03-23,2,0,3,20,0,3,1,3,0.36,0.303,0.87,0.6418,3,45,72,720,75,765
1875,2011-03-23,2,0,3,21,0,3,1,3,0.32,0.2879,1.0,0.4179,0,0,22,220,22,220
1876,2011-03-23,2,0,3,22,0,3,1,2,0.32,0.3182,0.93,0.1642,6,90,38,380,44,470
1877,2011-03-23,2,0,3,23,0,3,1,3,0.32,0.3333,0.9,0.0,2,30,24,240,26,270
1878,2011-03-24,2,0,3,0,0,4,1,2,0.32,0.303,0.93,0.2239,0,0,11,110,11,110
1879,2011-03-24,2,0,3,1,0,4,1,2,0.3,0.2879,1.0,0.2239,0,0,3,30,3,30
1880,2011-03-24,2,0,3,2,0,4,1,2,0.3,0.2879,1.0,0.2537,0,0,6,60,6,60
1881,2011-03-24,2,0,3,3,0,4,1,2,0.28,0.2727,1.0,0.194,1,15,0,0,1,15
1882,2011-03-24,2,0,3,4,0,4,1,2,0.28,0.2727,1.0,0.194,0,0,1,10,1,10
1883,2011-03-24,2,0,3,5,0,4,1,2,0.28,0.2727,0.93,0.2239,1,15,8,80,9,95
1884,2011-03-24,2,0,3,6,0,4,1,2,0.28,0.2727,0.93,0.2239,0,0,41,410,41,410
1885,2011-03-24,2,0,3,7,0,4,1,3,0.26,0.2576,1.0,0.2239,2,30,106,1060,108,1090
1886,2011-03-24,2,0,3,8,0,4,1,3,0.26,0.2273,1.0,0.2985,4,60,120,1200,124,1260
1887,2011-03-24,2,0,3,9,0,4,1,2,0.26,0.2576,0.93,0.2239,3,45,94,940,97,985
1888,2011-03-24,2,0,3,10,0,4,1,2,0.26,0.2273,0.93,0.3284,10,150,55,550,65,700
1889,2011-03-24,2,0,3,11,0,4,1,2,0.3,0.2727,0.81,0.2985,10,150,61,610,71,760
1890,2011-03-24,2,0,3,12,0,4,1,2,0.3,0.2727,0.7,0.3284,12,180,82,820,94,1000
1891,2011-03-24,2,0,3,13,0,4,1,2,0.32,0.303,0.7,0.2239,11,165,90,900,101,1065
1892,2011-03-24,2,0,3,14,0,4,1,2,0.3,0.303,0.7,0.1343,17,255,66,660,83,915
1893,2011-03-24,2,0,3,15,0,4,1,2,0.3,0.2879,0.7,0.2537,13,195,77,770,90,965
1894,2011-03-24,2,0,3,16,0,4,1,2,0.3,0.2879,0.65,0.2239,6,90,78,780,84,870
1895,2011-03-24,2,0,3,17,0,4,1,2,0.3,0.2879,0.7,0.2239,12,180,221,2210,233,2390
1896,2011-03-24,2,0,3,18,0,4,1,2,0.3,0.2727,0.61,0.2985,17,255,197,1970,214,2225
1897,2011-03-24,2,0,3,19,0,4,1,1,0.3,0.2727,0.56,0.3881,16,240,122,1220,138,1460
1898,2011-03-24,2,0,3,20,0,4,1,1,0.28,0.2576,0.61,0.2836,8,120,110,1100,118,1220
1899,2011-03-24,2,0,3,21,0,4,1,1,0.26,0.2576,0.65,0.2239,11,165,67,670,78,835
1900,2011-03-24,2,0,3,22,0,4,1,1,0.26,0.2576,0.65,0.1642,3,45,59,590,62,635
1901,2011-03-24,2,0,3,23,0,4,1,1,0.24,0.2273,0.65,0.194,9,135,24,240,33,375
1902,2011-03-25,2,0,3,0,0,5,1,1,0.24,0.2273,0.6,0.194,1,15,17,170,18,185
1903,2011-03-25,2,0,3,1,0,5,1,1,0.2,0.2121,0.69,0.1642,0,0,5,50,5,50
1904,2011-03-25,2,0,3,2,0,5,1,1,0.2,0.197,0.69,0.2239,0,0,5,50,5,50
1905,2011-03-25,2,0,3,3,0,5,1,1,0.2,0.2273,0.69,0.1045,0,0,2,20,2,20
1906,2011-03-25,2,0,3,4,0,5,1,1,0.18,0.2121,0.74,0.1045,3,45,2,20,5,65
1907,2011-03-25,2,0,3,5,0,5,1,1,0.18,0.197,0.74,0.1642,0,0,9,90,9,90
1908,2011-03-25,2,0,3,6,0,5,1,1,0.18,0.1818,0.74,0.2239,0,0,32,320,32,320
1909,2011-03-25,2,0,3,7,0,5,1,1,0.2,0.1818,0.59,0.3582,4,60,100,1000,104,1060
1910,2011-03-25,2,0,3,8,0,5,1,1,0.22,0.2121,0.51,0.2836,9,135,228,2280,237,2415
1911,2011-03-25,2,0,3,9,0,5,1,1,0.24,0.2121,0.48,0.2985,16,240,150,1500,166,1740
1912,2011-03-25,2,0,3,10,0,5,1,1,0.26,0.2576,0.48,0.0,15,225,53,530,68,755
1913,2011-03-25,2,0,3,11,0,5,1,1,0.3,0.2879,0.45,0.2836,17,255,58,580,75,835
1914,2011-03-25,2,0,3,12,0,5,1,1,0.32,0.303,0.42,0.2537,37,555,108,1080,145,1635
1915,2011-03-25,2,0,3,13,0,5,1,1,0.32,0.3182,0.39,0.194,34,510,104,1040,138,1550
1916,2011-03-25,2,0,3,14,0,5,1,1,0.36,0.3333,0.32,0.3284,30,450,103,1030,133,1480
1917,2011-03-25,2,0,3,15,0,5,1,2,0.34,0.3182,0.36,0.2537,43,645,79,790,122,1435
1918,2011-03-25,2,0,3,16,0,5,1,2,0.34,0.303,0.34,0.2985,23,345,127,1270,150,1615
1919,2011-03-25,2,0,3,17,0,5,1,2,0.32,0.2879,0.36,0.3582,23,345,202,2020,225,2365
1920,2011-03-25,2,0,3,18,0,5,1,1,0.3,0.2879,0.39,0.2537,8,120,190,1900,198,2020
1921,2011-03-25,2,0,3,19,0,5,1,2,0.3,0.2879,0.36,0.2836,9,135,126,1260,135,1395
1922,2011-03-25,2,0,3,20,0,5,1,2,0.3,0.303,0.39,0.1343,6,90,75,750,81,840
1923,2011-03-25,2,0,3,21,0,5,1,2,0.3,0.303,0.39,0.1642,11,165,64,640,75,805
1924,2011-03-25,2,0,3,22,0,5,1,2,0.28,0.2576,0.38,0.3284,3,45,40,400,43,445
1925,2011-03-25,2,0,3,23,0,5,1,2,0.26,0.2424,0.38,0.2836,8,120,31,310,39,430
1926,2011-03-26,2,0,3,0,0,6,0,2,0.26,0.2424,0.38,0.2836,3,45,25,250,28,295
1927,2011-03-26,2,0,3,1,0,6,0,1,0.26,0.2273,0.38,0.2985,3,45,24,240,27,285
1928,2011-03-26,2,0,3,2,0,6,0,1,0.22,0.2121,0.44,0.2239,4,60,21,210,25,270
1929,2011-03-26,2,0,3,3,0,6,0,1,0.2,0.197,0.47,0.194,2,30,7,70,9,100
1930,2011-03-26,2,0,3,4,0,6,0,1,0.22,0.2121,0.44,0.2239,2,30,4,40,6,70
1931,2011-03-26,2,0,3,5,0,6,0,1,0.2,0.197,0.51,0.194,0,0,8,80,8,80
1932,2011-03-26,2,0,3,6,0,6,0,1,0.18,0.1818,0.55,0.194,2,30,8,80,10,110
1933,2011-03-26,2,0,3,7,0,6,0,1,0.2,0.197,0.51,0.194,18,270,23,230,41,500
1934,2011-03-26,2,0,3,8,0,6,0,1,0.22,0.2273,0.44,0.1343,24,360,42,420,66,780
1935,2011-03-26,2,0,3,9,0,6,0,1,0.24,0.2424,0.41,0.1343,32,480,68,680,100,1160
1936,2011-03-26,2,0,3,10,0,6,0,1,0.26,0.2576,0.41,0.1642,32,480,93,930,125,1410
1937,2011-03-26,2,0,3,11,0,6,0,1,0.28,0.2727,0.38,0.1642,75,1125,93,930,168,2055
1938,2011-03-26,2,0,3,12,0,6,0,1,0.3,0.2879,0.36,0.194,98,1470,129,1290,227,2760
1939,2011-03-26,2,0,3,13,0,6,0,1,0.32,0.303,0.33,0.2239,94,1410,145,1450,239,2860
1940,2011-03-26,2,0,3,14,0,6,0,1,0.34,0.3182,0.29,0.2239,93,1395,123,1230,216,2625
1941,2011-03-26,2,0,3,15,0,6,0,1,0.34,0.3333,0.29,0.194,110,1650,109,1090,219,2740
1942,2011-03-26,2,0,3,16,0,6,0,1,0.34,0.3333,0.23,0.194,118,1770,130,1300,248,3070
1943,2011-03-26,2,0,3,17,0,6,0,1,0.32,0.303,0.24,0.2239,102,1530,101,1010,203,2540
1944,2011-03-26,2,0,3,18,0,6,0,2,0.32,0.3182,0.21,0.1642,64,960,89,890,153,1850
1945,2011-03-26,2,0,3,19,0,6,0,2,0.28,0.2727,0.45,0.2537,45,675,93,930,138,1605
1946,2011-03-26,2,0,3,20,0,6,0,2,0.28,0.2727,0.45,0.2537,18,270,67,670,85,940
1947,2011-03-26,2,0,3,21,0,6,0,2,0.26,0.2576,0.44,0.194,15,225,36,360,51,585
1948,2011-03-26,2,0,3,22,0,6,0,2,0.28,0.2727,0.41,0.2239,17,255,46,460,63,715
1949,2011-03-26,2,0,3,23,0,6,0,2,0.26,0.2424,0.44,0.2836,10,150,31,310,41,460
1950,2011-03-27,2,0,3,0,0,0,0,2,0.26,0.2576,0.41,0.1642,5,75,26,260,31,335
1951,2011-03-27,2,0,3,1,0,0,0,2,0.24,0.2273,0.52,0.194,3,45,17,170,20,215
1952,2011-03-27,2,0,3,2,0,0,0,3,0.22,0.2273,0.55,0.194,6,90,15,150,21,240
1953,2011-03-27,2,0,3,3,0,0,0,3,0.2,0.197,0.69,0.2239,0,0,14,140,14,140
1954,2011-03-27,2,0,3,4,0,0,0,3,0.18,0.197,0.74,0.1642,1,15,5,50,6,65
1955,2011-03-27,2,0,3,6,0,0,0,3,0.16,0.1818,0.86,0.1343,0,0,2,20,2,20
1956,2011-03-27,2,0,3,7,0,0,0,3,0.16,0.1667,0.86,0.1642,0,0,7,70,7,70
1957,2011-03-27,2,0,3,8,0,0,0,1,0.2,0.197,0.69,0.2239,6,90,8,80,14,170
1958,2011-03-27,2,0,3,9,0,0,0,1,0.22,0.2273,0.55,0.1343,17,255,37,370,54,625
1959,2011-03-27,2,0,3,10,0,0,0,2,0.22,0.2121,0.55,0.2239,27,405,59,590,86,995
1960,2011-03-27,2,0,3,11,0,0,0,2,0.24,0.2424,0.48,0.1642,23,345,85,850,108,1195
1961,2011-03-27,2,0,3,12,0,0,0,2,0.26,0.2576,0.44,0.2239,43,645,120,1200,163,1845
1962,2011-03-27,2,0,3,13,0,0,0,1,0.3,0.2879,0.39,0.2239,47,705,100,1000,147,1705
1963,2011-03-27,2,0,3,14,0,0,0,1,0.32,0.3182,0.36,0.1642,61,915,103,1030,164,1945
1964,2011-03-27,2,0,3,15,0,0,0,1,0.32,0.303,0.36,0.2836,61,915,111,1110,172,2025
1965,2011-03-27,2,0,3,16,0,0,0,1,0.34,0.3333,0.34,0.0,45,675,98,980,143,1655
1966,2011-03-27,2,0,3,17,0,0,0,1,0.32,0.303,0.31,0.2537,50,750,109,1090,159,1840
1967,2011-03-27,2,0,3,18,0,0,0,1,0.3,0.2879,0.33,0.194,32,480,105,1050,137,1530
1968,2011-03-27,2,0,3,19,0,0,0,1,0.3,0.2879,0.31,0.2239,23,345,80,800,103,1145
1969,2011-03-27,2,0,3,20,0,0,0,1,0.28,0.2727,0.36,0.1642,7,105,50,500,57,605
1970,2011-03-27,2,0,3,21,0,0,0,1,0.26,0.2576,0.41,0.1642,7,105,29,290,36,395
1971,2011-03-27,2,0,3,22,0,0,0,1,0.26,0.2576,0.41,0.1642,5,75,25,250,30,325
1972,2011-03-27,2,0,3,23,0,0,0,1,0.26,0.2576,0.44,0.194,3,45,16,160,19,205
1973,2011-03-28,2,0,3,0,0,1,1,1,0.22,0.2273,0.55,0.194,1,15,11,110,12,125
1974,2011-03-28,2,0,3,1,0,1,1,1,0.22,0.2273,0.44,0.194,2,30,4,40,6,70
1975,2011-03-28,2,0,3,2,0,1,1,1,0.22,0.2273,0.44,0.1642,0,0,5,50,5,50
1976,2011-03-28,2,0,3,3,0,1,1,1,0.22,0.2273,0.44,0.1642,0,0,2,20,2,20
1977,2011-03-28,2,0,3,5,0,1,1,1,0.18,0.1818,0.43,0.194,0,0,8,80,8,80
1978,2011-03-28,2,0,3,6,0,1,1,1,0.18,0.1667,0.34,0.2836,0,0,40,400,40,400
1979,2011-03-28,2,0,3,7,0,1,1,1,0.2,0.1818,0.32,0.3284,6,90,104,1040,110,1130
1980,2011-03-28,2,0,3,8,0,1,1,1,0.2,0.197,0.34,0.2239,15,225,239,2390,254,2615
1981,2011-03-28,2,0,3,9,0,1,1,2,0.22,0.2121,0.32,0.2239,12,180,109,1090,121,1270
1982,2011-03-28,2,0,3,10,0,1,1,1,0.24,0.2273,0.3,0.194,22,330,47,470,69,800
1983,2011-03-28,2,0,3,11,0,1,1,2,0.26,0.2424,0.3,0.2836,18,270,39,390,57,660
1984,2011-03-28,2,0,3,12,0,1,1,2,0.26,0.2727,0.25,0.0,8,120,71,710,79,830
1985,2011-03-28,2,0,3,13,0,1,1,2,0.3,0.2879,0.24,0.2239,14,210,69,690,83,900
1986,2011-03-28,2,0,3,14,0,1,1,1,0.32,0.303,0.22,0.2239,15,225,65,650,80,875
1987,2011-03-28,2,0,3,15,0,1,1,1,0.32,0.303,0.24,0.2836,19,285,53,530,72,815
1988,2011-03-28,2,0,3,16,0,1,1,1,0.34,0.3182,0.23,0.2239,15,225,117,1170,132,1395
1989,2011-03-28,2,0,3,17,0,1,1,1,0.34,0.303,0.23,0.2985,25,375,227,2270,252,2645
1990,2011-03-28,2,0,3,18,0,1,1,1,0.32,0.303,0.21,0.2836,21,315,220,2200,241,2515
1991,2011-03-28,2,0,3,19,0,1,1,1,0.3,0.303,0.22,0.1343,17,255,156,1560,173,1815
1992,2011-03-28,2,0,3,20,0,1,1,1,0.32,0.3333,0.22,0.1045,5,75,107,1070,112,1145
1993,2011-03-28,2,0,3,21,0,1,1,1,0.32,0.3333,0.21,0.1343,6,90,55,550,61,640
1994,2011-03-28,2,0,3,22,0,1,1,1,0.3,0.2879,0.22,0.2239,0,0,40,400,40,400
1995,2011-03-28,2,0,3,23,0,1,1,1,0.28,0.2576,0.24,0.2985,1,15,18,180,19,195
1996,2011-03-29,2,0,3,0,0,2,1,1,0.26,0.2273,0.28,0.3284,1,15,15,150,16,165
1997,2011-03-29,2,0,3,1,0,2,1,1,0.24,0.2121,0.32,0.2985,0,0,4,40,4,40
1998,2011-03-29,2,0,3,2,0,2,1,1,0.24,0.2121,0.32,0.2985,0,0,3,30,3,30
1999,2011-03-29,2,0,3,3,0,2,1,1,0.24,0.2121,0.32,0.2985,2,30,1,10,3,40
2000,2011-03-29,2,0,3,4,0,2,1,1,0.2,0.2121,0.44,0.1642,1,15,1,10,2,25
2001,2011-03-29,2,0,3,5,0,2,1,1,0.22,0.2121,0.37,0.2537,0,0,8,80,8,80
2002,2011-03-29,2,0,3,6,0,2,1,1,0.22,0.2121,0.41,0.2985,4,60,46,460,50,520
2003,2011-03-29,2,0,3,7,0,2,1,1,0.22,0.197,0.41,0.3582,5,75,128,1280,133,1355
2004,2011-03-29,2,0,3,8,0,2,1,1,0.24,0.2121,0.35,0.3582,19,285,268,2680,287,2965
2005,2011-03-29,2,0,3,9,0,2,1,1,0.28,0.2576,0.28,0.3881,16,240,156,1560,172,1800
2006,2011-03-29,2,0,3,10,0,2,1,1,0.3,0.2727,0.24,0.2985,13,195,46,460,59,655
2007,2011-03-29,2,0,3,11,0,2,1,2,0.34,0.303,0.25,0.3881,18,270,63,630,81,900
2008,2011-03-29,2,0,3,12,0,2,1,1,0.34,0.3333,0.25,0.1642,29,435,77,770,106,1205
2009,2011-03-29,2,0,3,13,0,2,1,1,0.34,0.303,0.25,0.2985,24,360,80,800,104,1160
2010,2011-03-29,2,0,3,14,0,2,1,1,0.36,0.3333,0.25,0.2537,20,300,66,660,86,960
2011,2011-03-29,2,0,3,15,0,2,1,1,0.38,0.3939,0.25,0.2239,22,330,65,650,87,980
2012,2011-03-29,2,0,3,16,0,2,1,1,0.38,0.3939,0.22,0.1642,12,180,124,1240,136,1420
2013,2011-03-29,2,0,3,17,0,2,1,1,0.4,0.4091,0.2,0.1343,34,510,265,2650,299,3160
2014,2011-03-29,2,0,3,18,0,2,1,1,0.36,0.3636,0.21,0.0896,42,630,252,2520,294,3150
2015,2011-03-29,2,0,3,19,0,2,1,1,0.34,0.3333,0.23,0.194,20,300,170,1700,190,2000
2016,2011-03-29,2,0,3,20,0,2,1,1,0.36,0.3636,0.21,0.0896,13,195,119,1190,132,1385
2017,2011-03-29,2,0,3,21,0,2,1,1,0.34,0.3636,0.42,0.0,8,120,75,750,83,870
2018,2011-03-29,2,0,3,22,0,2,1,1,0.34,0.3636,0.49,0.0,6,90,49,490,55,580
2019,2011-03-29,2,0,3,23,0,2,1,2,0.32,0.3333,0.57,0.1045,8,120,27,270,35,390
2020,2011-03-30,2,0,3,0,0,3,1,2,0.32,0.3485,0.57,0.0,3,45,8,80,11,125
2021,2011-03-30,2,0,3,1,0,3,1,1,0.32,0.3485,0.39,0.0,1,15,9,90,10,105
2022,2011-03-30,2,0,3,2,0,3,1,2,0.32,0.3485,0.57,0.0,0,0,4,40,4,40
2023,2011-03-30,2,0,3,3,0,3,1,2,0.32,0.3485,0.49,0.0,0,0,4,40,4,40
2024,2011-03-30,2,0,3,4,0,3,1,2,0.32,0.3485,0.57,0.0,1,15,0,0,1,15
2025,2011-03-30,2,0,3,5,0,3,1,2,0.3,0.2879,0.56,0.194,0,0,7,70,7,70
2026,2011-03-30,2,0,3,6,0,3,1,2,0.3,0.303,0.49,0.1343,4,60,44,440,48,500
2027,2011-03-30,2,0,3,7,0,3,1,2,0.32,0.3333,0.45,0.1045,8,120,128,1280,136,1400
2028,2011-03-30,2,0,3,8,0,3,1,2,0.32,0.3182,0.49,0.1642,16,240,247,2470,263,2710
2029,2011-03-30,2,0,3,9,0,3,1,2,0.32,0.303,0.45,0.2239,7,105,147,1470,154,1575
2030,2011-03-30,2,0,3,10,0,3,1,2,0.34,0.3182,0.46,0.2239,13,195,51,510,64,705
2031,2011-03-30,2,0,3,11,0,3,1,2,0.34,0.3182,0.46,0.2537,26,390,64,640,90,1030
2032,2011-03-30,2,0,3,12,0,3,1,2,0.34,0.3333,0.46,0.1642,15,225,65,650,80,875
2033,2011-03-30,2,0,3,13,0,3,1,2,0.36,0.3485,0.46,0.2239,14,210,84,840,98,1050
2034,2011-03-30,2,0,3,14,0,3,1,2,0.36,0.3333,0.46,0.2985,16,240,64,640,80,880
2035,2011-03-30,2,0,3,15,0,3,1,3,0.28,0.2576,0.81,0.2985,14,210,56,560,70,770
2036,2011-03-30,2,0,3,16,0,3,1,3,0.28,0.2727,0.87,0.2537,0,0,36,360,36,360
2037,2011-03-30,2,0,3,17,0,3,1,3,0.26,0.2727,0.93,0.1045,11,165,105,1050,116,1215
2038,2011-03-30,2,0,3,18,0,3,1,2,0.26,0.2576,0.93,0.2239,6,90,79,790,85,880
2039,2011-03-30,2,0,3,19,0,3,1,2,0.26,0.2576,0.93,0.2239,5,75,67,670,72,745
2040,2011-03-30,2,0,3,20,0,3,1,3,0.24,0.2121,0.93,0.2985,4,60,40,400,44,460
2041,2011-03-30,2,0,3,21,0,3,1,2,0.24,0.2273,0.93,0.2537,0,0,27,270,27,270
2042,2011-03-30,2,0,3,22,0,3,1,3,0.24,0.2273,0.93,0.2239,3,45,21,210,24,255
2043,2011-03-30,2,0,3,23,0,3,1,3,0.24,0.2121,0.93,0.2836,1,15,11,110,12,125
2044,2011-03-31,2,0,3,0,0,4,1,3,0.24,0.2273,0.93,0.2239,0,0,3,30,3,30
2045,2011-03-31,2,0,3,1,0,4,1,3,0.24,0.2273,0.93,0.194,1,15,4,40,5,55
2046,2011-03-31,2,0,3,2,0,4,1,3,0.24,0.2273,0.93,0.194,0,0,5,50,5,50
2047,2011-03-31,2,0,3,3,0,4,1,3,0.24,0.2273,0.93,0.2239,0,0,1,10,1,10
2048,2011-03-31,2,0,3,4,0,4,1,3,0.24,0.2273,0.93,0.2537,0,0,2,20,2,20
2049,2011-03-31,2,0,3,5,0,4,1,3,0.24,0.2273,0.93,0.2239,0,0,8,80,8,80
2050,2011-03-31,2,0,3,6,0,4,1,3,0.24,0.2121,0.93,0.2985,2,30,34,340,36,370
2051,2011-03-31,2,0,3,7,0,4,1,3,0.24,0.2273,0.93,0.2537,5,75,87,870,92,945
2052,2011-03-31,2,0,3,8,0,4,1,2,0.24,0.2273,1.0,0.2537,7,105,185,1850,192,1955
2053,2011-03-31,2,0,3,9,0,4,1,3,0.26,0.2424,0.93,0.2537,6,90,126,1260,132,1350
2054,2011-03-31,2,0,3,10,0,4,1,3,0.26,0.2424,0.93,0.2537,15,225,54,540,69,765
2055,2011-03-31,2,0,3,11,0,4,1,3,0.28,0.2727,0.93,0.194,6,90,52,520,58,610
2056,2011-03-31,2,0,3,12,0,4,1,3,0.28,0.2727,0.93,0.194,17,255,73,730,90,985
2057,2011-03-31,2,0,3,13,0,4,1,3,0.3,0.303,0.87,0.1343,13,195,55,550,68,745
2058,2011-03-31,2,0,3,14,0,4,1,3,0.3,0.303,0.87,0.1343,27,405,49,490,76,895
2059,2011-03-31,2,0,3,15,0,4,1,3,0.3,0.2727,0.87,0.2985,4,60,61,610,65,670
2060,2011-03-31,2,0,3,16,0,4,1,2,0.3,0.2879,0.87,0.2537,13,195,72,720,85,915
2061,2011-03-31,2,0,3,17,0,4,1,2,0.3,0.2879,0.87,0.2537,15,225,153,1530,168,1755
2062,2011-03-31,2,0,3,18,0,4,1,2,0.3,0.303,0.87,0.1343,12,180,165,1650,177,1830
2063,2011-03-31,2,0,3,19,0,4,1,2,0.3,0.303,0.87,0.1343,12,180,118,1180,130,1360
2064,2011-03-31,2,0,3,20,0,4,1,3,0.28,0.2576,0.93,0.2836,6,90,79,790,85,880
2065,2011-03-31,2,0,3,21,0,4,1,2,0.28,0.2727,0.93,0.1642,7,105,53,530,60,635
2066,2011-03-31,2,0,3,22,0,4,1,3,0.28,0.2727,0.93,0.2537,7,105,44,440,51,545
2067,2011-03-31,2,0,3,23,0,4,1,3,0.26,0.2576,1.0,0.1642,4,60,23,230,27,290
2068,2011-04-01,2,0,4,0,0,5,1,3,0.26,0.2576,1.0,0.1642,0,0,6,60,6,60
2069,2011-04-01,2,0,4,1,0,5,1,3,0.26,0.2576,1.0,0.1642,0,0,4,40,4,40
2070,2011-04-01,2,0,4,2,0,5,1,3,0.26,0.2576,0.93,0.194,0,0,7,70,7,70
2071,2011-04-01,2,0,4,3,0,5,1,2,0.24,0.2273,0.93,0.2537,0,0,4,40,4,40
2072,2011-04-01,2,0,4,4,0,5,1,2,0.24,0.2273,0.93,0.2537,0,0,3,30,3,30
2073,2011-04-01,2,0,4,5,0,5,1,3,0.24,0.2273,0.93,0.2239,1,15,11,110,12,125
2074,2011-04-01,2,0,4,6,0,5,1,3,0.24,0.2273,0.93,0.2239,2,30,26,260,28,290
2075,2011-04-01,2,0,4,7,0,5,1,3,0.24,0.2424,0.93,0.0,4,60,91,910,95,970
2076,2011-04-01,2,0,4,8,0,5,1,2,0.26,0.2424,0.87,0.2537,8,120,198,1980,206,2100
2077,2011-04-01,2,0,4,9,0,5,1,1,0.32,0.2879,0.7,0.3582,11,165,162,1620,173,1785
2078,2011-04-01,2,0,4,10,0,5,1,1,0.32,0.303,0.66,0.2836,12,180,63,630,75,810
2079,2011-04-01,2,0,4,11,0,5,1,1,0.32,0.2879,0.61,0.3582,17,255,72,720,89,975
2080,2011-04-01,2,0,4,12,0,5,1,1,0.34,0.303,0.53,0.3582,15,225,80,800,95,1025
2081,2011-04-01,2,0,4,13,0,5,1,1,0.36,0.3333,0.5,0.3582,18,270,92,920,110,1190
2082,2011-04-01,2,0,4,14,0,5,1,2,0.36,0.3333,0.46,0.3582,26,390,61,610,87,1000
2083,2011-04-01,2,0,4,15,0,5,1,1,0.34,0.303,0.46,0.4179,30,450,81,810,111,1260
2084,2011-04-01,2,0,4,16,0,5,1,1,0.34,0.303,0.46,0.4179,42,630,125,1250,167,1880
2085,2011-04-01,2,0,4,17,0,5,1,1,0.34,0.303,0.46,0.3284,36,540,245,2450,281,2990
2086,2011-04-01,2,0,4,18,0,5,1,1,0.34,0.303,0.46,0.3284,36,540,205,2050,241,2590
2087,2011-04-01,2,0,4,19,0,5,1,1,0.34,0.303,0.49,0.3284,16,240,120,1200,136,1440
2088,2011-04-01,2,0,4,20,0,5,1,1,0.32,0.3182,0.53,0.194,2,30,75,750,77,780
2089,2011-04-01,2,0,4,21,0,5,1,1,0.32,0.3333,0.53,0.1343,9,135,84,840,93,975
2090,2011-04-01,2,0,4,22,0,5,1,1,0.3,0.303,0.56,0.1642,10,150,64,640,74,790
2091,2011-04-01,2,0,4,23,0,5,1,1,0.3,0.3182,0.61,0.0896,12,180,41,410,53,590
2092,2011-04-02,2,0,4,0,0,6,0,2,0.3,0.3333,0.61,0.0,3,45,29,290,32,335
2093,2011-04-02,2,0,4,1,0,6,0,1,0.26,0.2727,0.65,0.1343,4,60,28,280,32,340
2094,2011-04-02,2,0,4,2,0,6,0,1,0.24,0.2424,0.75,0.1343,1,15,20,200,21,215
2095,2011-04-02,2,0,4,3,0,6,0,1,0.24,0.2424,0.7,0.1642,1,15,8,80,9,95
2096,2011-04-02,2,0,4,4,0,6,0,1,0.24,0.2424,0.7,0.1642,0,0,5,50,5,50
2097,2011-04-02,2,0,4,5,0,6,0,2,0.24,0.2424,0.75,0.1642,1,15,4,40,5,55
2098,2011-04-02,2,0,4,6,0,6,0,1,0.26,0.2727,0.7,0.1045,5,75,7,70,12,145
2099,2011-04-02,2,0,4,7,0,6,0,2,0.26,0.2727,0.7,0.1045,2,30,16,160,18,190
2100,2011-04-02,2,0,4,8,0,6,0,1,0.3,0.3182,0.7,0.1045,10,150,45,450,55,600
2101,2011-04-02,2,0,4,9,0,6,0,2,0.34,0.3485,0.66,0.1045,22,330,65,650,87,980
2102,2011-04-02,2,0,4,10,0,6,0,2,0.36,0.3485,0.57,0.1642,41,615,113,1130,154,1745
2103,2011-04-02,2,0,4,11,0,6,0,2,0.4,0.4091,0.47,0.1642,72,1080,126,1260,198,2340
2104,2011-04-02,2,0,4,12,0,6,0,3,0.32,0.3333,0.81,0.1343,84,1260,100,1000,184,2260
2105,2011-04-02,2,0,4,13,0,6,0,1,0.34,0.3333,0.81,0.1343,56,840,81,810,137,1650
2106,2011-04-02,2,0,4,14,0,6,0,3,0.32,0.303,0.76,0.3284,97,1455,93,930,190,2385
2107,2011-04-02,2,0,4,15,0,6,0,3,0.34,0.303,0.76,0.3881,72,1080,64,640,136,1720
2108,2011-04-02,2,0,4,16,0,6,0,1,0.38,0.3939,0.62,0.3284,111,1665,85,850,196,2515
2109,2011-04-02,2,0,4,17,0,6,0,1,0.38,0.3939,0.54,0.3582,89,1335,95,950,184,2285
2110,2011-04-02,2,0,4,18,0,6,0,1,0.38,0.3939,0.54,0.194,69,1035,110,1100,179,2135
2111,2011-04-02,2,0,4,19,0,6,0,1,0.36,0.3333,0.53,0.3582,71,1065,77,770,148,1835
2112,2011-04-02,2,0,4,20,0,6,0,1,0.34,0.3182,0.53,0.2836,29,435,56,560,85,995
2113,2011-04-02,2,0,4,21,0,6,0,1,0.32,0.303,0.61,0.2537,24,360,53,530,77,890
2114,2011-04-02,2,0,4,22,0,6,0,1,0.32,0.303,0.61,0.2985,14,210,41,410,55,620
2115,2011-04-02,2,0,4,23,0,6,0,1,0.32,0.3182,0.61,0.1642,20,300,33,330,53,630
2116,2011-04-03,2,0,4,0,0,0,0,1,0.3,0.2879,0.65,0.194,8,120,31,310,39,430
2117,2011-04-03,2,0,4,1,0,0,0,1,0.3,0.3182,0.61,0.1045,8,120,26,260,34,380
2118,2011-04-03,2,0,4,2,0,0,0,1,0.26,0.2727,0.7,0.1343,5,75,19,190,24,265
2119,2011-04-03,2,0,4,3,0,0,0,1,0.3,0.3333,0.61,0.0,3,45,8,80,11,125
2120,2011-04-03,2,0,4,4,0,0,0,1,0.28,0.303,0.7,0.0896,3,45,0,0,3,45
2121,2011-04-03,2,0,4,5,0,0,0,1,0.28,0.2727,0.65,0.2239,1,15,4,40,5,55
2122,2011-04-03,2,0,4,6,0,0,0,1,0.28,0.2727,0.65,0.194,10,150,23,230,33,380
2123,2011-04-03,2,0,4,7,0,0,0,1,0.32,0.303,0.57,0.2239,13,195,20,200,33,395
2124,2011-04-03,2,0,4,8,0,0,0,1,0.34,0.3333,0.57,0.1642,18,270,44,440,62,710
2125,2011-04-03,2,0,4,9,0,0,0,1,0.36,0.3182,0.5,0.4925,68,1020,74,740,142,1760
2126,2011-04-03,2,0,4,10,0,0,0,1,0.4,0.4091,0.43,0.4179,111,1665,104,1040,215,2705
2127,2011-04-03,2,0,4,11,0,0,0,1,0.42,0.4242,0.41,0.2537,139,2085,104,1040,243,3125
2128,2011-04-03,2,0,4,12,0,0,0,1,0.44,0.4394,0.38,0.2836,166,2490,147,1470,313,3960
2129,2011-04-03,2,0,4,13,0,0,0,1,0.44,0.4394,0.33,0.2985,219,3285,148,1480,367,4765
2130,2011-04-03,2,0,4,14,0,0,0,1,0.46,0.4545,0.31,0.1343,240,3600,109,1090,349,4690
2131,2011-04-03,2,0,4,15,0,0,0,2,0.46,0.4545,0.33,0.0,174,2610,118,1180,292,3790
2132,2011-04-03,2,0,4,16,0,0,0,2,0.46,0.4545,0.31,0.194,147,2205,156,1560,303,3765
2133,2011-04-03,2,0,4,17,0,0,0,2,0.46,0.4545,0.28,0.1343,148,2220,126,1260,274,3480
2134,2011-04-03,2,0,4,18,0,0,0,2,0.46,0.4545,0.31,0.0,71,1065,101,1010,172,2075
2135,2011-04-03,2,0,4,19,0,0,0,2,0.42,0.4242,0.44,0.194,51,765,93,930,144,1695
2136,2011-04-03,2,0,4,20,0,0,0,3,0.42,0.4242,0.41,0.2239,24,360,55,550,79,910
2137,2011-04-03,2,0,4,21,0,0,0,2,0.42,0.4242,0.44,0.2239,8,120,37,370,45,490
2138,2011-04-03,2,0,4,22,0,0,0,1,0.4,0.4091,0.43,0.1045,7,105,29,290,36,395
2139,2011-04-03,2,0,4,23,0,0,0,1,0.4,0.4091,0.5,0.0896,9,135,22,220,31,355
2140,2011-04-04,2,0,4,0,0,1,1,1,0.4,0.4091,0.5,0.2239,1,15,5,50,6,65
2141,2011-04-04,2,0,4,1,0,1,1,1,0.4,0.4091,0.56,0.3582,7,105,4,40,11,145
2142,2011-04-04,2,0,4,2,0,1,1,1,0.38,0.3939,0.66,0.2537,1,15,1,10,2,25
2143,2011-04-04,2,0,4,3,0,1,1,1,0.38,0.3939,0.66,0.2836,1,15,0,0,1,15
2144,2011-04-04,2,0,4,4,0,1,1,1,0.38,0.3939,0.71,0.2985,1,15,1,10,2,25
2145,2011-04-04,2,0,4,5,0,1,1,1,0.4,0.4091,0.62,0.2537,0,0,7,70,7,70
2146,2011-04-04,2,0,4,6,0,1,1,1,0.42,0.4242,0.58,0.2836,3,45,43,430,46,475
2147,2011-04-04,2,0,4,7,0,1,1,2,0.44,0.4394,0.54,0.2537,7,105,150,1500,157,1605
2148,2011-04-04,2,0,4,8,0,1,1,2,0.46,0.4545,0.55,0.2985,31,465,308,3080,339,3545
2149,2011-04-04,2,0,4,9,0,1,1,2,0.5,0.4848,0.51,0.3881,24,360,134,1340,158,1700
2150,2011-04-04,2,0,4,10,0,1,1,2,0.54,0.5152,0.45,0.3582,35,525,55,550,90,1075
2151,2011-04-04,2,0,4,11,0,1,1,1,0.6,0.6212,0.4,0.3881,58,870,66,660,124,1530
2152,2011-04-04,2,0,4,12,0,1,1,1,0.64,0.6212,0.36,0.4627,59,885,98,980,157,1865
2153,2011-04-04,2,0,4,13,0,1,1,1,0.68,0.6364,0.34,0.3284,47,705,92,920,139,1625
2154,2011-04-04,2,0,4,14,0,1,1,2,0.74,0.6515,0.27,0.4925,47,705,76,760,123,1465
2155,2011-04-04,2,0,4,15,0,1,1,1,0.76,0.6667,0.23,0.5522,47,705,96,960,143,1665
2156,2011-04-04,2,0,4,16,0,1,1,1,0.76,0.6515,0.22,0.5224,59,885,130,1300,189,2185
2157,2011-04-04,2,0,4,17,0,1,1,1,0.74,0.6515,0.23,0.6119,83,1245,283,2830,366,4075
2158,2011-04-04,2,0,4,18,0,1,1,2,0.72,0.6364,0.23,0.4925,78,1170,308,3080,386,4250
2159,2011-04-04,2,0,4,19,0,1,1,1,0.7,0.6364,0.24,0.4627,51,765,227,2270,278,3035
2160,2011-04-04,2,0,4,20,0,1,1,2,0.7,0.6364,0.24,0.5522,40,600,133,1330,173,1930
2161,2011-04-04,2,0,4,21,0,1,1,2,0.7,0.6364,0.3,0.4478,19,285,76,760,95,1045
2162,2011-04-04,2,0,4,22,0,1,1,2,0.68,0.6364,0.36,0.4627,17,255,58,580,75,835
2163,2011-04-04,2,0,4,23,0,1,1,2,0.64,0.6212,0.47,0.2239,18,270,30,300,48,570
2164,2011-04-05,2,0,4,0,0,2,1,1,0.62,0.6212,0.5,0.1045,10,150,12,120,22,270
2165,2011-04-05,2,0,4,1,0,2,1,3,0.62,0.6212,0.57,0.4179,10,150,5,50,15,200
2166,2011-04-05,2,0,4,2,0,2,1,2,0.54,0.5152,0.73,0.3284,0,0,5,50,5,50
2167,2011-04-05,2,0,4,3,0,2,1,2,0.54,0.5152,0.73,0.3284,1,15,3,30,4,45
2168,2011-04-05,2,0,4,4,0,2,1,3,0.5,0.4848,0.88,0.4925,0,0,2,20,2,20
2169,2011-04-05,2,0,4,5,0,2,1,3,0.46,0.4545,0.94,0.2985,0,0,5,50,5,50
2170,2011-04-05,2,0,4,6,0,2,1,2,0.48,0.4697,0.88,0.3284,2,30,36,360,38,390
2171,2011-04-05,2,0,4,7,0,2,1,2,0.48,0.4697,0.88,0.3284,10,150,124,1240,134,1390
2172,2011-04-05,2,0,4,8,0,2,1,3,0.38,0.3939,0.87,0.5821,9,135,148,1480,157,1615
2173,2011-04-05,2,0,4,9,0,2,1,3,0.36,0.3182,0.87,0.4925,2,30,44,440,46,470
2174,2011-04-05,2,0,4,10,0,2,1,3,0.34,0.303,0.81,0.3881,3,45,25,250,28,295
2175,2011-04-05,2,0,4,11,0,2,1,3,0.32,0.2879,0.81,0.4478,1,15,18,180,19,195
2176,2011-04-05,2,0,4,12,0,2,1,2,0.34,0.303,0.71,0.3881,6,90,32,320,38,410
2177,2011-04-05,2,0,4,13,0,2,1,2,0.36,0.3333,0.63,0.4179,5,75,51,510,56,585
2178,2011-04-05,2,0,4,14,0,2,1,2,0.36,0.3182,0.57,0.4925,9,135,67,670,76,805
2179,2011-04-05,2,0,4,15,0,2,1,1,0.4,0.4091,0.46,0.4627,6,90,62,620,68,710
2180,2011-04-05,2,0,4,16,0,2,1,1,0.38,0.3939,0.46,0.4179,17,255,113,1130,130,1385
2181,2011-04-05,2,0,4,17,0,2,1,1,0.42,0.4242,0.38,0.4179,27,405,246,2460,273,2865
2182,2011-04-05,2,0,4,18,0,2,1,1,0.38,0.3939,0.4,0.4925,19,285,248,2480,267,2765
2183,2011-04-05,2,0,4,19,0,2,1,1,0.36,0.3333,0.43,0.2985,12,180,148,1480,160,1660
2184,2011-04-05,2,0,4,20,0,2,1,1,0.34,0.3182,0.46,0.2836,4,60,87,870,91,930
2185,2011-04-05,2,0,4,21,0,2,1,1,0.34,0.2879,0.46,0.5224,8,120,81,810,89,930
2186,2011-04-05,2,0,4,22,0,2,1,1,0.32,0.303,0.49,0.2985,3,45,43,430,46,475
2187,2011-04-05,2,0,4,23,0,2,1,1,0.3,0.2879,0.49,0.2836,3,45,23,230,26,275
2188,2011-04-06,2,0,4,0,0,3,1,1,0.3,0.3182,0.49,0.1045,0,0,15,150,15,150
2189,2011-04-06,2,0,4,1,0,3,1,1,0.26,0.2727,0.6,0.1343,0,0,2,20,2,20
2190,2011-04-06,2,0,4,2,0,3,1,1,0.24,0.2424,0.7,0.1343,0,0,5,50,5,50
2191,2011-04-06,2,0,4,3,0,3,1,1,0.26,0.2727,0.6,0.1343,0,0,4,40,4,40
2192,2011-04-06,2,0,4,4,0,3,1,1,0.24,0.2424,0.65,0.1343,0,0,1,10,1,10
2193,2011-04-06,2,0,4,5,0,3,1,1,0.24,0.2576,0.7,0.1045,1,15,12,120,13,135
2194,2011-04-06,2,0,4,6,0,3,1,1,0.24,0.2576,0.7,0.1045,4,60,52,520,56,580
2195,2011-04-06,2,0,4,7,0,3,1,1,0.26,0.2727,0.65,0.1045,3,45,130,1300,133,1345
2196,2011-04-06,2,0,4,8,0,3,1,1,0.32,0.303,0.61,0.2239,17,255,308,3080,325,3335
2197,2011-04-06,2,0,4,9,0,3,1,1,0.36,0.3333,0.46,0.2537,8,120,157,1570,165,1690
2198,2011-04-06,2,0,4,10,0,3,1,1,0.4,0.4091,0.37,0.3881,21,315,48,480,69,795
2199,2011-04-06,2,0,4,11,0,3,1,1,0.42,0.4242,0.38,0.3881,23,345,70,700,93,1045
2200,2011-04-06,2,0,4,12,0,3,1,1,0.44,0.4394,0.41,0.2537,22,330,112,1120,134,1450
2201,2011-04-06,2,0,4,13,0,3,1,1,0.46,0.4545,0.38,0.4925,29,435,83,830,112,1265
2202,2011-04-06,2,0,4,14,0,3,1,1,0.5,0.4848,0.34,0.4179,35,525,80,800,115,1325
2203,2011-04-06,2,0,4,15,0,3,1,1,0.52,0.5,0.32,0.3284,34,510,83,830,117,1340
2204,2011-04-06,2,0,4,16,0,3,1,1,0.54,0.5152,0.28,0.4179,27,405,142,1420,169,1825
2205,2011-04-06,2,0,4,17,0,3,1,1,0.52,0.5,0.32,0.4478,53,795,303,3030,356,3825
2206,2011-04-06,2,0,4,18,0,3,1,1,0.52,0.5,0.29,0.3582,43,645,282,2820,325,3465
2207,2011-04-06,2,0,4,19,0,3,1,1,0.5,0.4848,0.31,0.2985,36,540,196,1960,232,2500
2208,2011-04-06,2,0,4,20,0,3,1,1,0.46,0.4545,0.51,0.2239,15,225,126,1260,141,1485
2209,2011-04-06,2,0,4,21,0,3,1,1,0.46,0.4545,0.41,0.2836,18,270,84,840,102,1110
2210,2011-04-06,2,0,4,22,0,3,1,1,0.46,0.4545,0.41,0.2836,13,195,71,710,84,905
2211,2011-04-06,2,0,4,23,0,3,1,1,0.46,0.4545,0.41,0.2985,11,165,29,290,40,455
2212,2011-04-07,2,0,4,0,0,4,1,1,0.46,0.4545,0.41,0.2836,5,75,15,150,20,225
2213,2011-04-07,2,0,4,1,0,4,1,1,0.42,0.4242,0.47,0.1343,2,30,11,110,13,140
2214,2011-04-07,2,0,4,2,0,4,1,1,0.42,0.4242,0.54,0.0,0,0,7,70,7,70
2215,2011-04-07,2,0,4,3,0,4,1,1,0.36,0.3485,0.66,0.194,0,0,3,30,3,30
2216,2011-04-07,2,0,4,4,0,4,1,1,0.34,0.3333,0.76,0.194,0,0,1,10,1,10
2217,2011-04-07,2,0,4,5,0,4,1,1,0.34,0.3182,0.76,0.2239,0,0,6,60,6,60
2218,2011-04-07,2,0,4,6,0,4,1,1,0.32,0.303,0.81,0.2537,5,75,59,590,64,665
2219,2011-04-07,2,0,4,7,0,4,1,2,0.34,0.3333,0.76,0.1642,8,120,152,1520,160,1640
2220,2011-04-07,2,0,4,8,0,4,1,1,0.36,0.3485,0.76,0.194,23,345,291,2910,314,3255
2221,2011-04-07,2,0,4,9,0,4,1,2,0.4,0.4091,0.66,0.1343,15,225,155,1550,170,1775
2222,2011-04-07,2,0,4,10,0,4,1,2,0.42,0.4242,0.67,0.1045,29,435,66,660,95,1095
2223,2011-04-07,2,0,4,11,0,4,1,2,0.46,0.4545,0.55,0.0,36,540,86,860,122,1400
2224,2011-04-07,2,0,4,12,0,4,1,2,0.46,0.4545,0.55,0.0,39,585,114,1140,153,1725
2225,2011-04-07,2,0,4,13,0,4,1,2,0.52,0.5,0.48,0.0896,36,540,99,990,135,1530
2226,2011-04-07,2,0,4,14,0,4,1,1,0.56,0.5303,0.43,0.0896,46,690,111,1110,157,1800
2227,2011-04-07,2,0,4,15,0,4,1,1,0.6,0.6212,0.38,0.1045,27,405,133,1330,160,1735
2228,2011-04-07,2,0,4,16,0,4,1,1,0.6,0.6212,0.35,0.0,52,780,161,1610,213,2390
2229,2011-04-07,2,0,4,17,0,4,1,1,0.52,0.5,0.52,0.2836,63,945,280,2800,343,3745
2230,2011-04-07,2,0,4,18,0,4,1,1,0.48,0.4697,0.55,0.2537,68,1020,265,2650,333,3670
2231,2011-04-07,2,0,4,19,0,4,1,1,0.46,0.4545,0.59,0.2985,34,510,192,1920,226,2430
2232,2011-04-07,2,0,4,20,0,4,1,1,0.44,0.4394,0.62,0.1642,37,555,166,1660,203,2215
2233,2011-04-07,2,0,4,21,0,4,1,2,0.44,0.4394,0.67,0.2836,19,285,89,890,108,1175
2234,2011-04-07,2,0,4,22,0,4,1,2,0.4,0.4091,0.76,0.194,18,270,63,630,81,900
2235,2011-04-07,2,0,4,23,0,4,1,1,0.38,0.3939,0.76,0.2537,9,135,45,450,54,585
2236,2011-04-08,2,0,4,0,0,5,1,2,0.36,0.3485,0.76,0.2239,4,60,21,210,25,270
2237,2011-04-08,2,0,4,1,0,5,1,2,0.34,0.3333,0.76,0.1343,3,45,6,60,9,105
2238,2011-04-08,2,0,4,2,0,5,1,3,0.34,0.3333,0.76,0.1642,3,45,10,100,13,145
2239,2011-04-08,2,0,4,3,0,5,1,3,0.34,0.3333,0.76,0.1642,0,0,1,10,1,10
2240,2011-04-08,2,0,4,4,0,5,1,2,0.34,0.3333,0.86,0.1343,0,0,1,10,1,10
2241,2011-04-08,2,0,4,5,0,5,1,2,0.32,0.3182,0.87,0.194,1,15,8,80,9,95
2242,2011-04-08,2,0,4,6,0,5,1,2,0.34,0.3636,0.87,0.0,2,30,33,330,35,360
2243,2011-04-08,2,0,4,7,0,5,1,3,0.34,0.3333,0.87,0.1642,4,60,109,1090,113,1150
2244,2011-04-08,2,0,4,8,0,5,1,3,0.34,0.3333,0.87,0.1642,13,195,208,2080,221,2275
2245,2011-04-08,2,0,4,9,0,5,1,2,0.36,0.3485,0.76,0.194,17,255,168,1680,185,1935
2246,2011-04-08,2,0,4,10,0,5,1,2,0.36,0.3333,0.71,0.2836,10,150,63,630,73,780
2247,2011-04-08,2,0,4,11,0,5,1,2,0.4,0.4091,0.62,0.3881,19,285,79,790,98,1075
2248,2011-04-08,2,0,4,12,0,5,1,3,0.38,0.3939,0.66,0.2239,29,435,51,510,80,945
2249,2011-04-08,2,0,4,13,0,5,1,3,0.36,0.3333,0.76,0.2836,7,105,35,350,42,455
2250,2011-04-08,2,0,4,14,0,5,1,3,0.34,0.3182,0.87,0.2239,2,30,13,130,15,160
2251,2011-04-08,2,0,4,15,0,5,1,3,0.34,0.3182,0.87,0.2239,1,15,24,240,25,255
2252,2011-04-08,2,0,4,16,0,5,1,2,0.32,0.303,0.93,0.2537,2,30,58,580,60,610
2253,2011-04-08,2,0,4,17,0,5,1,3,0.32,0.303,0.93,0.2537,10,150,138,1380,148,1530
2254,2011-04-08,2,0,4,18,0,5,1,3,0.32,0.303,0.93,0.2537,8,120,54,540,62,660
2255,2011-04-08,2,0,4,19,0,5,1,3,0.3,0.2727,0.93,0.4179,1,15,52,520,53,535
2256,2011-04-08,2,0,4,20,0,5,1,2,0.3,0.2727,0.93,0.3284,12,180,51,510,63,690
2257,2011-04-08,2,0,4,21,0,5,1,2,0.3,0.2879,0.93,0.2537,11,165,43,430,54,595
2258,2011-04-08,2,0,4,22,0,5,1,2,0.3,0.2727,0.93,0.2985,9,135,42,420,51,555
2259,2011-04-08,2,0,4,23,0,5,1,2,0.3,0.2879,0.93,0.2239,4,60,31,310,35,370
2260,2011-04-09,2,0,4,0,0,6,0,2,0.3,0.2879,0.87,0.2239,5,75,26,260,31,335
2261,2011-04-09,2,0,4,1,0,6,0,2,0.3,0.303,0.87,0.1343,3,45,17,170,20,215
2262,2011-04-09,2,0,4,2,0,6,0,2,0.32,0.303,0.87,0.2239,2,30,15,150,17,180
2263,2011-04-09,2,0,4,3,0,6,0,3,0.3,0.2879,1.0,0.2537,3,45,11,110,14,155
2264,2011-04-09,2,0,4,4,0,6,0,3,0.3,0.2727,1.0,0.2537,0,0,3,30,3,30
2265,2011-04-09,2,0,4,5,0,6,0,2,0.3,0.2879,0.93,0.2239,0,0,5,50,5,50
2266,2011-04-09,2,0,4,6,0,6,0,2,0.3,0.2879,0.93,0.194,0,0,13,130,13,130
2267,2011-04-09,2,0,4,7,0,6,0,2,0.3,0.303,0.93,0.1642,8,120,13,130,21,250
2268,2011-04-09,2,0,4,8,0,6,0,2,0.32,0.303,0.93,0.1642,7,105,47,470,54,575
2269,2011-04-09,2,0,4,9,0,6,0,2,0.34,0.3485,0.87,0.1045,27,405,71,710,98,1115
2270,2011-04-09,2,0,4,10,0,6,0,2,0.34,0.3333,0.87,0.1343,43,645,90,900,133,1545
2271,2011-04-09,2,0,4,11,0,6,0,2,0.36,0.3636,0.81,0.0,51,765,91,910,142,1675
2272,2011-04-09,2,0,4,12,0,6,0,2,0.36,0.3485,0.81,0.1343,79,1185,123,1230,202,2415
2273,2011-04-09,2,0,4,13,0,6,0,2,0.36,0.3788,0.81,0.0,114,1710,108,1080,222,2790
2274,2011-04-09,2,0,4,14,0,6,0,2,0.36,0.3485,0.81,0.1343,94,1410,118,1180,212,2590
2275,2011-04-09,2,0,4,15,0,6,0,2,0.36,0.3788,0.87,0.0,85,1275,116,1160,201,2435
2276,2011-04-09,2,0,4,16,0,6,0,2,0.38,0.3939,0.82,0.0,73,1095,118,1180,191,2275
2277,2011-04-09,2,0,4,17,0,6,0,2,0.38,0.3939,0.82,0.0896,128,1920,129,1290,257,3210
2278,2011-04-09,2,0,4,18,0,6,0,2,0.38,0.3939,0.82,0.1045,48,720,129,1290,177,2010
2279,2011-04-09,2,0,4,19,0,6,0,2,0.38,0.3939,0.82,0.1343,47,705,83,830,130,1535
2280,2011-04-09,2,0,4,20,0,6,0,2,0.38,0.3939,0.87,0.1642,19,285,74,740,93,1025
2281,2011-04-09,2,0,4,21,0,6,0,2,0.36,0.3485,0.93,0.1343,10,150,65,650,75,800
2282,2011-04-09,2,0,4,22,0,6,0,2,0.36,0.3485,0.93,0.1343,21,315,66,660,87,975
2283,2011-04-09,2,0,4,23,0,6,0,2,0.38,0.3939,0.87,0.0896,12,180,45,450,57,630
2284,2011-04-10,2,0,4,0,0,0,0,2,0.38,0.3939,0.87,0.0896,5,75,48,480,53,555
2285,2011-04-10,2,0,4,1,0,0,0,2,0.38,0.3939,0.87,0.1343,6,90,31,310,37,400
2286,2011-04-10,2,0,4,2,0,0,0,2,0.38,0.3939,0.87,0.0896,12,180,24,240,36,420
2287,2011-04-10,2,0,4,3,0,0,0,2,0.38,0.3939,0.87,0.1343,5,75,11,110,16,185
2288,2011-04-10,2,0,4,4,0,0,0,2,0.36,0.3636,0.93,0.1045,3,45,2,20,5,65
2289,2011-04-10,2,0,4,5,0,0,0,2,0.36,0.3636,0.93,0.0896,0,0,4,40,4,40
2290,2011-04-10,2,0,4,6,0,0,0,2,0.36,0.3636,0.93,0.0896,0,0,4,40,4,40
2291,2011-04-10,2,0,4,7,0,0,0,2,0.36,0.3636,1.0,0.0896,3,45,7,70,10,115
2292,2011-04-10,2,0,4,8,0,0,0,2,0.38,0.3939,0.94,0.0896,17,255,38,380,55,635
2293,2011-04-10,2,0,4,9,0,0,0,2,0.38,0.3939,0.94,0.1343,31,465,50,500,81,965
2294,2011-04-10,2,0,4,10,0,0,0,2,0.4,0.4091,0.87,0.0,69,1035,81,810,150,1845
2295,2011-04-10,2,0,4,11,0,0,0,2,0.4,0.4091,0.87,0.1343,93,1395,109,1090,202,2485
2296,2011-04-10,2,0,4,12,0,0,0,2,0.42,0.4242,0.88,0.1343,94,1410,136,1360,230,2770
2297,2011-04-10,2,0,4,13,0,0,0,1,0.46,0.4545,0.82,0.1045,121,1815,142,1420,263,3235
2298,2011-04-10,2,0,4,14,0,0,0,1,0.5,0.4848,0.72,0.194,148,2220,133,1330,281,3550
2299,2011-04-10,2,0,4,15,0,0,0,1,0.5,0.4848,0.77,0.2239,156,2340,141,1410,297,3750
2300,2011-04-10,2,0,4,16,0,0,0,2,0.52,0.5,0.72,0.1642,135,2025,153,1530,288,3555
2301,2011-04-10,2,0,4,17,0,0,0,2,0.52,0.5,0.72,0.194,84,1260,152,1520,236,2780
2302,2011-04-10,2,0,4,18,0,0,0,1,0.5,0.4848,0.77,0.194,103,1545,137,1370,240,2915
2303,2011-04-10,2,0,4,19,0,0,0,1,0.5,0.4848,0.77,0.194,47,705,84,840,131,1545
2304,2011-04-10,2,0,4,20,0,0,0,1,0.46,0.4545,0.82,0.1343,21,315,71,710,92,1025
2305,2011-04-10,2,0,4,21,0,0,0,1,0.44,0.4394,0.88,0.194,18,270,77,770,95,1040
2306,2011-04-10,2,0,4,22,0,0,0,1,0.44,0.4394,0.94,0.2537,12,180,45,450,57,630
2307,2011-04-10,2,0,4,23,0,0,0,1,0.46,0.4545,0.88,0.3582,5,75,27,270,32,345
2308,2011-04-11,2,0,4,0,0,1,1,1,0.48,0.4697,0.88,0.3284,7,105,16,160,23,265
2309,2011-04-11,2,0,4,1,0,1,1,1,0.46,0.4545,0.94,0.2836,1,15,3,30,4,45
2310,2011-04-11,2,0,4,2,0,1,1,1,0.46,0.4545,0.94,0.2836,7,105,2,20,9,125
2311,2011-04-11,2,0,4,4,0,1,1,1,0.46,0.4545,0.94,0.194,0,0,1,10,1,10
2312,2011-04-11,2,0,4,5,0,1,1,1,0.46,0.4545,0.94,0.194,1,15,12,120,13,135
2313,2011-04-11,2,0,4,6,0,1,1,2,0.46,0.4545,1.0,0.2239,2,30,59,590,61,620
2314,2011-04-11,2,0,4,7,0,1,1,2,0.5,0.4848,0.88,0.2239,12,180,164,1640,176,1820
2315,2011-04-11,2,0,4,8,0,1,1,2,0.52,0.5,0.88,0.2836,28,420,286,2860,314,3280
2316,2011-04-11,2,0,4,9,0,1,1,2,0.56,0.5303,0.83,0.2836,33,495,132,1320,165,1815
2317,2011-04-11,2,0,4,10,0,1,1,2,0.56,0.5303,0.83,0.2985,41,615,55,550,96,1165
2318,2011-04-11,2,0,4,11,0,1,1,2,0.6,0.5909,0.73,0.2985,45,675,59,590,104,1265
2319,2011-04-11,2,0,4,12,0,1,1,2,0.6,0.5909,0.73,0.3284,37,555,97,970,134,1525
2320,2011-04-11,2,0,4,13,0,1,1,2,0.64,0.6061,0.69,0.4179,62,930,77,770,139,1700
2321,2011-04-11,2,0,4,14,0,1,1,2,0.72,0.6667,0.54,0.3582,60,900,85,850,145,1750
2322,2011-04-11,2,0,4,15,0,1,1,1,0.74,0.6667,0.48,0.5224,56,840,85,850,141,1690
2323,2011-04-11,2,0,4,16,0,1,1,1,0.74,0.6667,0.48,0.5224,73,1095,162,1620,235,2715
2324,2011-04-11,2,0,4,17,0,1,1,1,0.74,0.6667,0.48,0.5224,100,1500,352,3520,452,5020
2325,2011-04-11,2,0,4,18,0,1,1,1,0.72,0.6667,0.51,0.3881,93,1395,290,2900,383,4295
2326,2011-04-11,2,0,4,19,0,1,1,1,0.72,0.6667,0.51,0.4478,73,1095,211,2110,284,3205
2327,2011-04-11,2,0,4,20,0,1,1,1,0.68,0.6364,0.57,0.5224,44,660,122,1220,166,1880
2328,2011-04-11,2,0,4,21,0,1,1,1,0.66,0.6212,0.61,0.2537,39,585,119,1190,158,1775
2329,2011-04-11,2,0,4,22,0,1,1,2,0.64,0.6212,0.5,0.2836,25,375,66,660,91,1035
2330,2011-04-11,2,0,4,23,0,1,1,3,0.58,0.5455,0.6,0.0,16,240,38,380,54,620
2331,2011-04-12,2,0,4,0,0,2,1,2,0.62,0.6212,0.5,0.1045,11,165,13,130,24,295
2332,2011-04-12,2,0,4,1,0,2,1,2,0.62,0.6212,0.5,0.0896,6,90,7,70,13,160
2333,2011-04-12,2,0,4,2,0,2,1,2,0.6,0.6212,0.53,0.1343,7,105,7,70,14,175
2334,2011-04-12,2,0,4,3,0,2,1,2,0.58,0.5455,0.56,0.1343,0,0,1,10,1,10
2335,2011-04-12,2,0,4,4,0,2,1,2,0.56,0.5303,0.64,0.1343,4,60,2,20,6,80
2336,2011-04-12,2,0,4,5,0,2,1,2,0.54,0.5152,0.68,0.1343,1,15,15,150,16,165
2337,2011-04-12,2,0,4,6,0,2,1,2,0.54,0.5152,0.68,0.2836,3,45,55,550,58,595
2338,2011-04-12,2,0,4,7,0,2,1,2,0.54,0.5152,0.68,0.2239,12,180,177,1770,189,1950
2339,2011-04-12,2,0,4,8,0,2,1,3,0.48,0.4697,0.88,0.3881,15,225,211,2110,226,2335
2340,2011-04-12,2,0,4,9,0,2,1,3,0.46,0.4545,0.94,0.4925,4,60,50,500,54,560
2341,2011-04-12,2,0,4,10,0,2,1,3,0.5,0.4848,0.82,0.4179,6,90,34,340,40,430
2342,2011-04-12,2,0,4,11,0,2,1,1,0.52,0.5,0.77,0.3582,11,165,38,380,49,545
2343,2011-04-12,2,0,4,12,0,2,1,2,0.56,0.5303,0.64,0.4627,9,135,83,830,92,965
2344,2011-04-12,2,0,4,13,0,2,1,3,0.54,0.5152,0.68,0.2836,22,330,84,840,106,1170
2345,2011-04-12,2,0,4,14,0,2,1,2,0.5,0.4848,0.82,0.2836,16,240,28,280,44,520
2346,2011-04-12,2,0,4,15,0,2,1,2,0.48,0.4697,0.77,0.5224,24,360,54,540,78,900
2347,2011-04-12,2,0,4,16,0,2,1,2,0.48,0.4697,0.77,0.3881,19,285,80,800,99,1085
2348,2011-04-12,2,0,4,17,0,2,1,3,0.44,0.4394,0.77,0.2239,29,435,262,2620,291,3055
2349,2011-04-12,2,0,4,18,0,2,1,3,0.44,0.4394,0.77,0.2239,21,315,203,2030,224,2345
2350,2011-04-12,2,0,4,19,0,2,1,2,0.42,0.4242,0.82,0.2836,3,45,127,1270,130,1315
2351,2011-04-12,2,0,4,20,0,2,1,2,0.42,0.4242,0.82,0.2836,9,135,94,940,103,1075
2352,2011-04-12,2,0,4,21,0,2,1,2,0.42,0.4242,0.82,0.194,10,150,74,740,84,890
2353,2011-04-12,2,0,4,22,0,2,1,2,0.4,0.4091,0.94,0.2985,7,105,47,470,54,575
2354,2011-04-12,2,0,4,23,0,2,1,2,0.4,0.4091,0.94,0.2537,8,120,31,310,39,430
2355,2011-04-13,2,0,4,0,0,3,1,2,0.4,0.4091,1.0,0.2985,3,45,12,120,15,165
2356,2011-04-13,2,0,4,1,0,3,1,2,0.4,0.4091,1.0,0.2985,0,0,1,10,1,10
2357,2011-04-13,2,0,4,2,0,3,1,3,0.4,0.4091,1.0,0.2985,0,0,2,20,2,20
2358,2011-04-13,2,0,4,3,0,3,1,3,0.4,0.4091,0.94,0.3284,0,0,2,20,2,20
2359,2011-04-13,2,0,4,4,0,3,1,3,0.4,0.4091,0.94,0.3284,1,15,2,20,3,35
2360,2011-04-13,2,0,4,5,0,3,1,3,0.38,0.3939,0.94,0.2537,1,15,4,40,5,55
2361,2011-04-13,2,0,4,6,0,3,1,3,0.38,0.3939,0.94,0.2239,1,15,33,330,34,345
2362,2011-04-13,2,0,4,7,0,3,1,3,0.36,0.3485,1.0,0.2239,3,45,67,670,70,715
2363,2011-04-13,2,0,4,8,0,3,1,3,0.38,0.3939,0.94,0.194,6,90,158,1580,164,1670
2364,2011-04-13,2,0,4,9,0,3,1,2,0.38,0.3939,0.94,0.2239,2,30,63,630,65,660
2365,2011-04-13,2,0,4,10,0,3,1,2,0.4,0.4091,0.87,0.194,4,60,42,420,46,480
2366,2011-04-13,2,0,4,11,0,3,1,2,0.42,0.4242,0.82,0.194,4,60,57,570,61,630
2367,2011-04-13,2,0,4,12,0,3,1,3,0.42,0.4242,0.82,0.2537,12,180,83,830,95,1010
2368,2011-04-13,2,0,4,13,0,3,1,2,0.44,0.4394,0.77,0.194,6,90,55,550,61,640
2369,2011-04-13,2,0,4,14,0,3,1,2,0.42,0.4242,0.77,0.2537,24,360,82,820,106,1180
2370,2011-04-13,2,0,4,15,0,3,1,2,0.44,0.4394,0.72,0.2836,12,180,69,690,81,870
2371,2011-04-13,2,0,4,16,0,3,1,1,0.46,0.4545,0.67,0.2836,23,345,119,1190,142,1535
2372,2011-04-13,2,0,4,17,0,3,1,1,0.46,0.4545,0.67,0.2985,25,375,284,2840,309,3215
2373,2011-04-13,2,0,4,18,0,3,1,1,0.44,0.4394,0.62,0.3881,28,420,293,2930,321,3350
2374,2011-04-13,2,0,4,19,0,3,1,1,0.44,0.4394,0.62,0.2537,15,225,160,1600,175,1825
2375,2011-04-13,2,0,4,20,0,3,1,1,0.44,0.4394,0.62,0.2537,7,105,119,1190,126,1295
2376,2011-04-13,2,0,4,21,0,3,1,1,0.42,0.4242,0.67,0.1642,17,255,100,1000,117,1255
2377,2011-04-13,2,0,4,22,0,3,1,1,0.42,0.4242,0.67,0.194,10,150,89,890,99,1040
2378,2011-04-13,2,0,4,23,0,3,1,1,0.4,0.4091,0.71,0.1343,5,75,57,570,62,645
2379,2011-04-14,2,0,4,0,0,4,1,1,0.38,0.3939,0.76,0.1343,3,45,18,180,21,225
2380,2011-04-14,2,0,4,1,0,4,1,1,0.38,0.3939,0.76,0.2239,1,15,9,90,10,105
2381,2011-04-14,2,0,4,2,0,4,1,1,0.36,0.3485,0.76,0.1343,0,0,3,30,3,30
2382,2011-04-14,2,0,4,3,0,4,1,1,0.34,0.3333,0.81,0.1343,0,0,2,20,2,20
2383,2011-04-14,2,0,4,4,0,4,1,1,0.34,0.3636,0.76,0.0,1,15,8,80,9,95
2384,2011-04-14,2,0,4,5,0,4,1,1,0.34,0.3485,0.76,0.0896,2,30,12,120,14,150
2385,2011-04-14,2,0,4,6,0,4,1,1,0.34,0.3485,0.76,0.1045,4,60,66,660,70,720
2386,2011-04-14,2,0,4,7,0,4,1,1,0.38,0.3939,0.66,0.0,11,165,182,1820,193,1985
2387,2011-04-14,2,0,4,8,0,4,1,1,0.42,0.4242,0.58,0.1642,21,315,316,3160,337,3475
2388,2011-04-14,2,0,4,9,0,4,1,1,0.46,0.4545,0.51,0.1343,18,270,152,1520,170,1790
2389,2011-04-14,2,0,4,10,0,4,1,1,0.5,0.4848,0.51,0.194,21,315,68,680,89,995
2390,2011-04-14,2,0,4,11,0,4,1,1,0.52,0.5,0.45,0.1642,28,420,87,870,115,1290
2391,2011-04-14,2,0,4,12,0,4,1,1,0.54,0.5152,0.42,0.1343,35,525,110,1100,145,1625
2392,2011-04-14,2,0,4,13,0,4,1,1,0.56,0.5303,0.37,0.2239,38,570,121,1210,159,1780
2393,2011-04-14,2,0,4,14,0,4,1,1,0.56,0.5303,0.35,0.0896,36,540,101,1010,137,1550
2394,2011-04-14,2,0,4,15,0,4,1,1,0.6,0.6212,0.31,0.0896,57,855,85,850,142,1705
2395,2011-04-14,2,0,4,16,0,4,1,1,0.6,0.6061,0.26,0.1045,49,735,153,1530,202,2265
2396,2011-04-14,2,0,4,17,0,4,1,1,0.6,0.6061,0.28,0.0,50,750,338,3380,388,4130
2397,2011-04-14,2,0,4,18,0,4,1,1,0.56,0.5303,0.3,0.0,47,705,290,2900,337,3605
2398,2011-04-14,2,0,4,19,0,4,1,1,0.54,0.5152,0.32,0.0,37,555,222,2220,259,2775
2399,2011-04-14,2,0,4,20,0,4,1,1,0.5,0.4848,0.51,0.194,22,330,147,1470,169,1800
2400,2011-04-14,2,0,4,21,0,4,1,1,0.46,0.4545,0.63,0.1343,19,285,126,1260,145,1545
2401,2011-04-14,2,0,4,22,0,4,1,1,0.48,0.4697,0.55,0.1045,22,330,82,820,104,1150
2402,2011-04-14,2,0,4,23,0,4,1,1,0.46,0.4545,0.59,0.1045,7,105,40,400,47,505
2403,2011-04-15,2,0,4,0,1,5,0,1,0.44,0.4394,0.67,0.0,6,90,21,210,27,300
2404,2011-04-15,2,0,4,1,1,5,0,1,0.44,0.4394,0.62,0.0,6,90,9,90,15,180
2405,2011-04-15,2,0,4,2,1,5,0,1,0.4,0.4091,0.76,0.0,8,120,10,100,18,220
2406,2011-04-15,2,0,4,3,1,5,0,1,0.4,0.4091,0.76,0.0,0,0,3,30,3,30
2407,2011-04-15,2,0,4,4,1,5,0,1,0.38,0.3939,0.82,0.0896,0,0,3,30,3,30
2408,2011-04-15,2,0,4,5,1,5,0,1,0.36,0.3636,0.81,0.1045,2,30,11,110,13,140
2409,2011-04-15,2,0,4,6,1,5,0,1,0.36,0.3636,0.81,0.0896,5,75,42,420,47,495
2410,2011-04-15,2,0,4,7,1,5,0,1,0.4,0.4091,0.71,0.1642,10,150,139,1390,149,1540
2411,2011-04-15,2,0,4,8,1,5,0,1,0.44,0.4394,0.62,0.2985,21,315,279,2790,300,3105
2412,2011-04-15,2,0,4,9,1,5,0,1,0.5,0.4848,0.55,0.194,16,240,162,1620,178,1860
2413,2011-04-15,2,0,4,10,1,5,0,1,0.5,0.4848,0.55,0.194,31,465,91,910,122,1375
2414,2011-04-15,2,0,4,11,1,5,0,1,0.52,0.5,0.55,0.194,41,615,95,950,136,1565
2415,2011-04-15,2,0,4,12,1,5,0,1,0.52,0.5,0.55,0.2836,45,675,155,1550,200,2225
2416,2011-04-15,2,0,4,13,1,5,0,1,0.54,0.5152,0.52,0.2537,47,705,133,1330,180,2035
2417,2011-04-15,2,0,4,14,1,5,0,1,0.54,0.5152,0.52,0.2537,57,855,106,1060,163,1915
2418,2011-04-15,2,0,4,15,1,5,0,1,0.54,0.5152,0.52,0.4478,50,750,112,1120,162,1870
2419,2011-04-15,2,0,4,16,1,5,0,1,0.52,0.5,0.55,0.4925,70,1050,173,1730,243,2780
2420,2011-04-15,2,0,4,17,1,5,0,2,0.5,0.4848,0.63,0.3881,64,960,267,2670,331,3630
2421,2011-04-15,2,0,4,18,1,5,0,2,0.46,0.4545,0.67,0.3881,47,705,216,2160,263,2865
2422,2011-04-15,2,0,4,19,1,5,0,1,0.42,0.4242,0.77,0.3881,41,615,168,1680,209,2295
2423,2011-04-15,2,0,4,20,1,5,0,2,0.4,0.4091,0.76,0.3284,26,390,92,920,118,1310
2424,2011-04-15,2,0,4,21,1,5,0,2,0.4,0.4091,0.76,0.2985,25,375,77,770,102,1145
2425,2011-04-15,2,0,4,22,1,5,0,2,0.38,0.3939,0.82,0.3881,16,240,64,640,80,880
2426,2011-04-15,2,0,4,23,1,5,0,2,0.36,0.3485,0.81,0.194,8,120,56,560,64,680
2427,2011-04-16,2,0,4,0,0,6,0,2,0.36,0.3485,0.81,0.2239,7,105,36,360,43,465
2428,2011-04-16,2,0,4,1,0,6,0,2,0.36,0.3333,0.87,0.2836,5,75,28,280,33,355
2429,2011-04-16,2,0,4,2,0,6,0,2,0.36,0.3485,0.87,0.1343,5,75,19,190,24,265
2430,2011-04-16,2,0,4,3,0,6,0,2,0.36,0.3485,0.87,0.1642,5,75,9,90,14,165
2431,2011-04-16,2,0,4,4,0,6,0,2,0.36,0.3485,0.87,0.2239,1,15,4,40,5,55
2432,2011-04-16,2,0,4,5,0,6,0,2,0.38,0.3939,0.87,0.2836,1,15,3,30,4,45
2433,2011-04-16,2,0,4,6,0,6,0,3,0.4,0.4091,0.82,0.3284,1,15,9,90,10,105
2434,2011-04-16,2,0,4,7,0,6,0,2,0.4,0.4091,0.82,0.4179,3,45,18,180,21,225
2435,2011-04-16,2,0,4,8,0,6,0,3,0.4,0.4091,0.87,0.3582,7,105,38,380,45,485
2436,2011-04-16,2,0,4,9,0,6,0,3,0.4,0.4091,1.0,0.2985,2,30,27,270,29,300
2437,2011-04-16,2,0,4,10,0,6,0,3,0.42,0.4242,0.94,0.3881,1,15,21,210,22,225
2438,2011-04-16,2,0,4,11,0,6,0,3,0.42,0.4242,0.94,0.4478,4,60,27,270,31,330
2439,2011-04-16,2,0,4,12,0,6,0,2,0.46,0.4545,0.88,0.5821,6,90,26,260,32,350
2440,2011-04-16,2,0,4,13,0,6,0,3,0.46,0.4545,0.94,0.5224,9,135,49,490,58,625
2441,2011-04-16,2,0,4,14,0,6,0,3,0.52,0.5,0.83,0.5821,14,210,49,490,63,700
2442,2011-04-16,2,0,4,15,0,6,0,3,0.52,0.5,0.83,0.5821,16,240,62,620,78,860
2443,2011-04-16,2,0,4,16,0,6,0,3,0.5,0.4848,0.88,0.4627,6,90,27,270,33,360
2444,2011-04-16,2,0,4,17,0,6,0,3,0.5,0.4848,0.88,0.5821,1,15,14,140,15,155
2445,2011-04-16,2,0,4,18,0,6,0,2,0.5,0.4848,0.94,0.3881,6,90,32,320,38,410
2446,2011-04-16,2,0,4,19,0,6,0,2,0.52,0.5,0.94,0.4179,9,135,62,620,71,755
2447,2011-04-16,2,0,4,20,0,6,0,3,0.44,0.4394,0.94,0.2239,4,60,49,490,53,550
2448,2011-04-16,2,0,4,21,0,6,0,2,0.44,0.4394,0.94,0.0,1,15,13,130,14,145
2449,2011-04-16,2,0,4,22,0,6,0,3,0.42,0.4242,1.0,0.0,2,30,22,220,24,250
2450,2011-04-16,2,0,4,23,0,6,0,2,0.44,0.4394,0.77,0.2836,5,75,30,300,35,375
2451,2011-04-17,2,0,4,0,0,0,0,2,0.44,0.4394,0.77,0.2836,4,60,29,290,33,350
2452,2011-04-17,2,0,4,1,0,0,0,1,0.42,0.4242,0.67,0.2239,6,90,25,250,31,340
2453,2011-04-17,2,0,4,2,0,0,0,1,0.4,0.4091,0.62,0.194,4,60,25,250,29,310
2454,2011-04-17,2,0,4,3,0,0,0,1,0.4,0.4091,0.66,0.1343,12,180,13,130,25,310
2455,2011-04-17,2,0,4,4,0,0,0,1,0.36,0.3636,0.76,0.1045,2,30,5,50,7,80
2456,2011-04-17,2,0,4,5,0,0,0,1,0.36,0.3485,0.71,0.1642,2,30,1,10,3,40
2457,2011-04-17,2,0,4,6,0,0,0,1,0.36,0.3182,0.66,0.4478,3,45,5,50,8,95
2458,2011-04-17,2,0,4,7,0,0,0,1,0.36,0.3333,0.5,0.3582,2,30,14,140,16,170
2459,2011-04-17,2,0,4,8,0,0,0,1,0.38,0.3939,0.46,0.3881,7,105,36,360,43,465
2460,2011-04-17,2,0,4,9,0,0,0,1,0.4,0.4091,0.43,0.2836,31,465,71,710,102,1175
2461,2011-04-17,2,0,4,10,0,0,0,1,0.42,0.4242,0.44,0.4478,91,1365,120,1200,211,2565
2462,2011-04-17,2,0,4,11,0,0,0,1,0.46,0.4545,0.41,0.4179,119,1785,185,1850,304,3635
2463,2011-04-17,2,0,4,12,0,0,0,1,0.46,0.4545,0.38,0.3881,167,2505,187,1870,354,4375
2464,2011-04-17,2,0,4,13,0,0,0,1,0.5,0.4848,0.34,0.3881,181,2715,162,1620,343,4335
2465,2011-04-17,2,0,4,14,0,0,0,1,0.52,0.5,0.34,0.3881,170,2550,191,1910,361,4460
2466,2011-04-17,2,0,4,15,0,0,0,1,0.54,0.5152,0.32,0.5224,179,2685,209,2090,388,4775
2467,2011-04-17,2,0,4,16,0,0,0,1,0.54,0.5152,0.3,0.3582,161,2415,182,1820,343,4235
2468,2011-04-17,2,0,4,17,0,0,0,1,0.56,0.5303,0.3,0.4478,143,2145,163,1630,306,3775
2469,2011-04-17,2,0,4,18,0,0,0,1,0.56,0.5303,0.3,0.3881,102,1530,175,1750,277,3280
2470,2011-04-17,2,0,4,19,0,0,0,1,0.56,0.5303,0.3,0.2985,75,1125,135,1350,210,2475
2471,2011-04-17,2,0,4,20,0,0,0,1,0.52,0.5,0.36,0.194,44,660,97,970,141,1630
2472,2011-04-17,2,0,4,21,0,0,0,1,0.5,0.4848,0.42,0.194,13,195,70,700,83,895
2473,2011-04-17,2,0,4,22,0,0,0,1,0.5,0.4848,0.39,0.1045,21,315,49,490,70,805
2474,2011-04-17,2,0,4,23,0,0,0,1,0.44,0.4394,0.67,0.1642,19,285,37,370,56,655
2475,2011-04-18,2,0,4,0,0,1,1,1,0.46,0.4545,0.47,0.0896,15,225,24,240,39,465
2476,2011-04-18,2,0,4,1,0,1,1,1,0.46,0.4545,0.47,0.1343,11,165,8,80,19,245
2477,2011-04-18,2,0,4,2,0,1,1,1,0.42,0.4242,0.67,0.1045,14,210,2,20,16,230
2478,2011-04-18,2,0,4,3,0,1,1,1,0.42,0.4242,0.62,0.1045,6,90,1,10,7,100
2479,2011-04-18,2,0,4,4,0,1,1,1,0.4,0.4091,0.87,0.1642,2,30,4,40,6,70
2480,2011-04-18,2,0,4,5,0,1,1,1,0.4,0.4091,0.76,0.0896,0,0,16,160,16,160
2481,2011-04-18,2,0,4,6,0,1,1,1,0.4,0.4091,0.82,0.0,3,45,51,510,54,555
2482,2011-04-18,2,0,4,7,0,1,1,1,0.46,0.4545,0.63,0.0,12,180,156,1560,168,1740
2483,2011-04-18,2,0,4,8,0,1,1,1,0.46,0.4545,0.63,0.0,20,300,277,2770,297,3070
2484,2011-04-18,2,0,4,9,0,1,1,2,0.5,0.4848,0.55,0.1045,37,555,132,1320,169,1875
2485,2011-04-18,2,0,4,10,0,1,1,2,0.52,0.5,0.55,0.1045,41,615,68,680,109,1295
2486,2011-04-18,2,0,4,11,0,1,1,2,0.54,0.5152,0.52,0.0896,36,540,87,870,123,1410
2487,2011-04-18,2,0,4,12,0,1,1,2,0.56,0.5303,0.49,0.0896,60,900,124,1240,184,2140
2488,2011-04-18,2,0,4,13,0,1,1,2,0.56,0.5303,0.49,0.1642,41,615,128,1280,169,1895
2489,2011-04-18,2,0,4,14,0,1,1,2,0.58,0.5455,0.49,0.194,49,735,95,950,144,1685
2490,2011-04-18,2,0,4,15,0,1,1,2,0.6,0.6212,0.43,0.194,64,960,112,1120,176,2080
2491,2011-04-18,2,0,4,16,0,1,1,1,0.6,0.6212,0.46,0.2836,40,600,165,1650,205,2250
2492,2011-04-18,2,0,4,17,0,1,1,1,0.58,0.5455,0.49,0.2836,66,990,362,3620,428,4610
2493,2011-04-18,2,0,4,18,0,1,1,1,0.64,0.6212,0.31,0.3582,41,615,321,3210,362,3825
2494,2011-04-18,2,0,4,19,0,1,1,1,0.56,0.5303,0.46,0.2537,42,630,244,2440,286,3070
2495,2011-04-18,2,0,4,20,0,1,1,1,0.6,0.6212,0.33,0.2985,29,435,136,1360,165,1795
2496,2011-04-18,2,0,4,21,0,1,1,1,0.56,0.5303,0.37,0.2836,20,300,131,1310,151,1610
2497,2011-04-18,2,0,4,22,0,1,1,1,0.52,0.5,0.55,0.2836,9,135,81,810,90,945
2498,2011-04-18,2,0,4,23,0,1,1,1,0.5,0.4848,0.59,0.2537,11,165,35,350,46,515
2499,2011-04-19,2,0,4,0,0,2,1,1,0.5,0.4848,0.55,0.2239,2,30,23,230,25,260
2500,2011-04-19,2,0,4,1,0,2,1,1,0.46,0.4545,0.63,0.2239,5,75,2,20,7,95
2501,2011-04-19,2,0,4,2,0,2,1,1,0.46,0.4545,0.67,0.2836,8,120,5,50,13,170
2502,2011-04-19,2,0,4,3,0,2,1,1,0.48,0.4697,0.63,0.2239,0,0,3,30,3,30
2503,2011-04-19,2,0,4,4,0,2,1,1,0.46,0.4545,0.67,0.0896,1,15,4,40,5,55
2504,2011-04-19,2,0,4,5,0,2,1,2,0.46,0.4545,0.72,0.194,1,15,17,170,18,185
2505,2011-04-19,2,0,4,6,0,2,1,2,0.48,0.4697,0.67,0.0,2,30,63,630,65,660
2506,2011-04-19,2,0,4,7,0,2,1,2,0.52,0.5,0.55,0.0,22,330,166,1660,188,1990
2507,2011-04-19,2,0,4,8,0,2,1,2,0.5,0.4848,0.68,0.1343,20,300,331,3310,351,3610
2508,2011-04-19,2,0,4,9,0,2,1,3,0.52,0.5,0.63,0.0896,23,345,139,1390,162,1735
2509,2011-04-19,2,0,4,10,0,2,1,2,0.5,0.4848,0.72,0.2239,15,225,60,600,75,825
2510,2011-04-19,2,0,4,11,0,2,1,2,0.54,0.5152,0.68,0.1642,19,285,53,530,72,815
2511,2011-04-19,2,0,4,12,0,2,1,2,0.54,0.5152,0.64,0.0896,19,285,84,840,103,1125
2512,2011-04-19,2,0,4,13,0,2,1,2,0.54,0.5152,0.68,0.2239,26,390,103,1030,129,1420
2513,2011-04-19,2,0,4,14,0,2,1,2,0.54,0.5152,0.64,0.194,19,285,88,880,107,1165
2514,2011-04-19,2,0,4,15,0,2,1,2,0.54,0.5152,0.65,0.1642,44,660,83,830,127,1490
2515,2011-04-19,2,0,4,16,0,2,1,1,0.56,0.5303,0.52,0.2985,30,450,162,1620,192,2070
2516,2011-04-19,2,0,4,17,0,2,1,1,0.56,0.5303,0.6,0.1045,39,585,372,3720,411,4305
2517,2011-04-19,2,0,4,18,0,2,1,2,0.54,0.5152,0.64,0.1343,44,660,377,3770,421,4430
2518,2011-04-19,2,0,4,19,0,2,1,2,0.5,0.4848,0.72,0.194,28,420,248,2480,276,2900
2519,2011-04-19,2,0,4,20,0,2,1,2,0.5,0.4848,0.72,0.2239,20,300,148,1480,168,1780
2520,2011-04-19,2,0,4,21,0,2,1,2,0.5,0.4848,0.72,0.1343,8,120,114,1140,122,1260
2521,2011-04-19,2,0,4,22,0,2,1,1,0.48,0.4697,0.77,0.0896,3,45,109,1090,112,1135
2522,2011-04-19,2,0,4,23,0,2,1,1,0.46,0.4545,0.88,0.0896,11,165,41,410,52,575
2523,2011-04-20,2,0,4,0,0,3,1,1,0.44,0.4394,0.88,0.1343,4,60,29,290,33,350
2524,2011-04-20,2,0,4,1,0,3,1,1,0.42,0.4242,0.94,0.1642,2,30,5,50,7,80
2525,2011-04-20,2,0,4,2,0,3,1,1,0.42,0.4242,0.94,0.1642,0,0,2,20,2,20
2526,2011-04-20,2,0,4,3,0,3,1,1,0.42,0.4242,0.94,0.0,0,0,2,20,2,20
2527,2011-04-20,2,0,4,4,0,3,1,1,0.4,0.4091,1.0,0.1045,5,75,4,40,9,115
2528,2011-04-20,2,0,4,5,0,3,1,1,0.4,0.4091,0.94,0.194,1,15,14,140,15,155
2529,2011-04-20,2,0,4,6,0,3,1,1,0.42,0.4242,0.94,0.1642,2,30,62,620,64,650
2530,2011-04-20,2,0,4,7,0,3,1,1,0.44,0.4394,0.94,0.0,26,390,211,2110,237,2500
2531,2011-04-20,2,0,4,8,0,3,1,1,0.62,0.6061,0.69,0.4627,22,330,374,3740,396,4070
2532,2011-04-20,2,0,4,9,0,3,1,1,0.66,0.6212,0.61,0.2836,27,405,170,1700,197,2105
2533,2011-04-20,2,0,4,10,0,3,1,1,0.62,0.6061,0.69,0.0896,45,675,86,860,131,1535
2534,2011-04-20,2,0,4,11,0,3,1,1,0.62,0.6061,0.69,0.0896,31,465,87,870,118,1335
2535,2011-04-20,2,0,4,12,0,3,1,1,0.7,0.6515,0.48,0.3881,28,420,117,1170,145,1590
2536,2011-04-20,2,0,4,13,0,3,1,1,0.7,0.6515,0.48,0.3881,42,630,135,1350,177,1980
2537,2011-04-20,2,0,4,14,0,3,1,1,0.74,0.6515,0.4,0.4627,33,495,115,1150,148,1645
2538,2011-04-20,2,0,4,15,0,3,1,2,0.76,0.6667,0.35,0.3582,32,480,113,1130,145,1610
2539,2011-04-20,2,0,4,16,0,3,1,2,0.76,0.6667,0.35,0.3582,54,810,201,2010,255,2820
2540,2011-04-20,2,0,4,17,0,3,1,2,0.74,0.6515,0.37,0.4179,34,510,398,3980,432,4490
2541,2011-04-20,2,0,4,18,0,3,1,1,0.74,0.6515,0.3,0.3582,56,840,385,3850,441,4690
2542,2011-04-20,2,0,4,19,0,3,1,1,0.7,0.6364,0.32,0.2537,74,1110,309,3090,383,4200
2543,2011-04-20,2,0,4,20,0,3,1,1,0.68,0.6212,0.32,0.1045,31,465,194,1940,225,2405
2544,2011-04-20,2,0,4,21,0,3,1,1,0.66,0.6212,0.36,0.2836,38,570,134,1340,172,1910
2545,2011-04-20,2,0,4,22,0,3,1,1,0.62,0.6212,0.41,0.2537,12,180,105,1050,117,1230
2546,2011-04-20,2,0,4,23,0,3,1,1,0.6,0.6212,0.4,0.3284,14,210,79,790,93,1000
2547,2011-04-21,2,0,4,0,0,4,1,1,0.56,0.5303,0.43,0.3582,11,165,33,330,44,495
2548,2011-04-21,2,0,4,1,0,4,1,1,0.52,0.5,0.45,0.2239,6,90,20,200,26,290
2549,2011-04-21,2,0,4,2,0,4,1,1,0.5,0.4848,0.42,0.3881,3,45,10,100,13,145
2550,2011-04-21,2,0,4,3,0,4,1,2,0.46,0.4545,0.51,0.4627,4,60,3,30,7,90
2551,2011-04-21,2,0,4,4,0,4,1,2,0.44,0.4394,0.54,0.4478,2,30,4,40,6,70
2552,2011-04-21,2,0,4,5,0,4,1,2,0.42,0.4242,0.54,0.5522,0,0,14,140,14,140
2553,2011-04-21,2,0,4,6,0,4,1,2,0.4,0.4091,0.58,0.5821,2,30,73,730,75,760
2554,2011-04-21,2,0,4,7,0,4,1,2,0.42,0.4242,0.47,0.4627,15,225,183,1830,198,2055
2555,2011-04-21,2,0,4,8,0,4,1,2,0.4,0.4091,0.5,0.4925,19,285,346,3460,365,3745
2556,2011-04-21,2,0,4,9,0,4,1,2,0.42,0.4242,0.47,0.2836,18,270,178,1780,196,2050
2557,2011-04-21,2,0,4,10,0,4,1,1,0.42,0.4242,0.44,0.3582,25,375,73,730,98,1105
2558,2011-04-21,2,0,4,11,0,4,1,1,0.44,0.4394,0.41,0.2836,34,510,99,990,133,1500
2559,2011-04-21,2,0,4,12,0,4,1,1,0.46,0.4545,0.38,0.1642,49,735,150,1500,199,2235
2560,2011-04-21,2,0,4,13,0,4,1,1,0.48,0.4697,0.33,0.3284,55,825,122,1220,177,2045
2561,2011-04-21,2,0,4,14,0,4,1,1,0.5,0.4848,0.34,0.3881,68,1020,160,1600,228,2620
2562,2011-04-21,2,0,4,15,0,4,1,1,0.52,0.5,0.29,0.4179,69,1035,166,1660,235,2695
2563,2011-04-21,2,0,4,16,0,4,1,1,0.52,0.5,0.27,0.3582,66,990,228,2280,294,3270
2564,2011-04-21,2,0,4,17,0,4,1,1,0.5,0.4848,0.29,0.1642,79,1185,402,4020,481,5205
2565,2011-04-21,2,0,4,18,0,4,1,1,0.5,0.4848,0.25,0.2836,71,1065,381,3810,452,4875
2566,2011-04-21,2,0,4,19,0,4,1,1,0.46,0.4545,0.28,0.2836,52,780,272,2720,324,3500
2567,2011-04-21,2,0,4,20,0,4,1,1,0.44,0.4394,0.3,0.1343,28,420,176,1760,204,2180
2568,2011-04-21,2,0,4,21,0,4,1,1,0.42,0.4242,0.47,0.194,25,375,159,1590,184,1965
2569,2011-04-21,2,0,4,22,0,4,1,1,0.42,0.4242,0.38,0.0896,31,465,106,1060,137,1525
2570,2011-04-21,2,0,4,23,0,4,1,1,0.4,0.4091,0.43,0.1045,13,195,86,860,99,1055
2571,2011-04-22,2,0,4,0,0,5,1,1,0.36,0.3485,0.62,0.194,3,45,30,300,33,345
2572,2011-04-22,2,0,4,1,0,5,1,1,0.36,0.3333,0.53,0.2537,2,30,22,220,24,250
2573,2011-04-22,2,0,4,2,0,5,1,1,0.36,0.3333,0.53,0.2985,2,30,7,70,9,100
2574,2011-04-22,2,0,4,3,0,5,1,1,0.36,0.3333,0.53,0.2985,0,0,2,20,2,20
2575,2011-04-22,2,0,4,4,0,5,1,1,0.34,0.3182,0.53,0.2836,1,15,2,20,3,35
2576,2011-04-22,2,0,4,5,0,5,1,1,0.34,0.3182,0.53,0.2239,0,0,16,160,16,160
2577,2011-04-22,2,0,4,6,0,5,1,1,0.34,0.3182,0.53,0.2836,2,30,47,470,49,500
2578,2011-04-22,2,0,4,7,0,5,1,2,0.34,0.3182,0.53,0.2836,5,75,175,1750,180,1825
2579,2011-04-22,2,0,4,8,0,5,1,2,0.34,0.3182,0.53,0.2537,15,225,331,3310,346,3535
2580,2011-04-22,2,0,4,9,0,5,1,3,0.34,0.303,0.61,0.2985,17,255,178,1780,195,2035
2581,2011-04-22,2,0,4,10,0,5,1,2,0.36,0.3485,0.62,0.194,32,480,104,1040,136,1520
2582,2011-04-22,2,0,4,11,0,5,1,3,0.34,0.3333,0.66,0.194,23,345,83,830,106,1175
2583,2011-04-22,2,0,4,12,0,5,1,3,0.34,0.3333,0.76,0.1343,19,285,61,610,80,895
2584,2011-04-22,2,0,4,13,0,5,1,3,0.34,0.3333,0.87,0.194,3,45,37,370,40,415
2585,2011-04-22,2,0,4,14,0,5,1,3,0.34,0.3182,0.87,0.2537,3,45,33,330,36,375
2586,2011-04-22,2,0,4,15,0,5,1,3,0.34,0.3333,0.87,0.194,13,195,62,620,75,815
2587,2011-04-22,2,0,4,16,0,5,1,3,0.34,0.3333,0.87,0.1343,4,60,58,580,62,640
2588,2011-04-22,2,0,4,17,0,5,1,3,0.32,0.303,0.93,0.2239,6,90,63,630,69,720
2589,2011-04-22,2,0,4,18,0,5,1,3,0.32,0.303,0.93,0.2239,4,60,47,470,51,530
2590,2011-04-22,2,0,4,19,0,5,1,3,0.32,0.303,0.93,0.2239,7,105,48,480,55,585
2591,2011-04-22,2,0,4,20,0,5,1,3,0.32,0.303,0.87,0.2239,8,120,39,390,47,510
2592,2011-04-22,2,0,4,21,0,5,1,3,0.3,0.303,0.93,0.1642,5,75,23,230,28,305
2593,2011-04-22,2,0,4,22,0,5,1,3,0.3,0.303,1.0,0.1343,3,45,21,210,24,255
2594,2011-04-22,2,0,4,23,0,5,1,3,0.32,0.3333,0.93,0.1045,0,0,17,170,17,170
2595,2011-04-23,2,0,4,0,0,6,0,2,0.32,0.3182,1.0,0.194,0,0,18,180,18,180
2596,2011-04-23,2,0,4,1,0,6,0,2,0.32,0.3182,1.0,0.194,5,75,11,110,16,185
2597,2011-04-23,2,0,4,2,0,6,0,3,0.32,0.3333,1.0,0.1343,3,45,14,140,17,185
2598,2011-04-23,2,0,4,3,0,6,0,3,0.32,0.3333,1.0,0.0896,0,0,4,40,4,40
2599,2011-04-23,2,0,4,4,0,6,0,3,0.34,0.3636,1.0,0.0,2,30,3,30,5,60
2600,2011-04-23,2,0,4,5,0,6,0,3,0.34,0.3636,1.0,0.0,1,15,6,60,7,75
2601,2011-04-23,2,0,4,6,0,6,0,2,0.34,0.3333,1.0,0.1642,0,0,11,110,11,110
2602,2011-04-23,2,0,4,7,0,6,0,3,0.34,0.3333,1.0,0.1642,2,30,17,170,19,200
2603,2011-04-23,2,0,4,8,0,6,0,2,0.36,0.3333,1.0,0.2537,15,225,32,320,47,545
2604,2011-04-23,2,0,4,9,0,6,0,2,0.38,0.3939,0.94,0.2985,13,195,55,550,68,745
2605,2011-04-23,2,0,4,10,0,6,0,2,0.42,0.4242,0.88,0.2239,36,540,93,930,129,1470
2606,2011-04-23,2,0,4,11,0,6,0,2,0.46,0.4545,0.88,0.2239,68,1020,164,1640,232,2660
2607,2011-04-23,2,0,4,12,0,6,0,1,0.52,0.5,0.83,0.4179,94,1410,197,1970,291,3380
2608,2011-04-23,2,0,4,13,0,6,0,1,0.52,0.5,0.83,0.3881,126,1890,186,1860,312,3750
2609,2011-04-23,2,0,4,14,0,6,0,1,0.58,0.5455,0.78,0.3582,182,2730,209,2090,391,4820
2610,2011-04-23,2,0,4,15,0,6,0,1,0.6,0.5909,0.73,0.3881,171,2565,226,2260,397,4825
2611,2011-04-23,2,0,4,16,0,6,0,1,0.6,0.5909,0.73,0.2836,180,2700,246,2460,426,5160
2612,2011-04-23,2,0,4,17,0,6,0,1,0.6,0.5909,0.73,0.3284,168,2520,215,2150,383,4670
2613,2011-04-23,2,0,4,18,0,6,0,1,0.58,0.5455,0.78,0.194,149,2235,227,2270,376,4505
2614,2011-04-23,2,0,4,19,0,6,0,1,0.56,0.5303,0.83,0.2836,84,1260,199,1990,283,3250
2615,2011-04-23,2,0,4,20,0,6,0,2,0.54,0.5152,0.88,0.2537,45,675,138,1380,183,2055
2616,2011-04-23,2,0,4,21,0,6,0,2,0.56,0.5303,0.83,0.2836,32,480,103,1030,135,1510
2617,2011-04-23,2,0,4,22,0,6,0,2,0.58,0.5455,0.78,0.2537,55,825,114,1140,169,1965
2618,2011-04-23,2,0,4,23,0,6,0,2,0.54,0.5152,0.88,0.1642,31,465,86,860,117,1325
2619,2011-04-24,2,0,4,0,0,0,0,1,0.52,0.5,0.83,0.2239,30,450,66,660,96,1110
2620,2011-04-24,2,0,4,1,0,0,0,1,0.5,0.4848,0.88,0.194,14,210,40,400,54,610
2621,2011-04-24,2,0,4,2,0,0,0,1,0.5,0.4848,0.88,0.194,27,405,45,450,72,855
2622,2011-04-24,2,0,4,3,0,0,0,1,0.5,0.4848,0.94,0.0896,4,60,20,200,24,260
2623,2011-04-24,2,0,4,4,0,0,0,1,0.5,0.4848,0.94,0.0896,0,0,5,50,5,50
2624,2011-04-24,2,0,4,5,0,0,0,1,0.5,0.4848,0.94,0.0896,5,75,7,70,12,145
2625,2011-04-24,2,0,4,6,0,0,0,2,0.5,0.4848,1.0,0.0,10,150,3,30,13,180
2626,2011-04-24,2,0,4,7,0,0,0,2,0.5,0.4848,1.0,0.0,16,240,11,110,27,350
2627,2011-04-24,2,0,4,8,0,0,0,1,0.52,0.5,0.94,0.2239,38,570,42,420,80,990
2628,2011-04-24,2,0,4,9,0,0,0,1,0.56,0.5303,0.88,0.2537,73,1095,104,1040,177,2135
2629,2011-04-24,2,0,4,10,0,0,0,1,0.6,0.5758,0.78,0.1642,118,1770,171,1710,289,3480
2630,2011-04-24,2,0,4,11,0,0,0,1,0.66,0.6212,0.65,0.1343,124,1860,193,1930,317,3790
2631,2011-04-24,2,0,4,12,0,0,0,1,0.68,0.6364,0.65,0.2537,168,2520,220,2200,388,4720
2632,2011-04-24,2,0,4,13,0,0,0,1,0.7,0.6515,0.58,0.2836,205,3075,236,2360,441,5435
2633,2011-04-24,2,0,4,14,0,0,0,1,0.7,0.6515,0.54,0.3284,197,2955,223,2230,420,5185
2634,2011-04-24,2,0,4,15,0,0,0,1,0.66,0.6212,0.61,0.2537,167,2505,202,2020,369,4525
2635,2011-04-24,2,0,4,16,0,0,0,1,0.74,0.6667,0.48,0.3881,162,2430,197,1970,359,4400
2636,2011-04-24,2,0,4,17,0,0,0,1,0.66,0.6212,0.65,0.2985,142,2130,189,1890,331,4020
2637,2011-04-24,2,0,4,18,0,0,0,1,0.64,0.6061,0.69,0.1642,96,1440,174,1740,270,3180
2638,2011-04-24,2,0,4,19,0,0,0,3,0.6,0.5606,0.83,0.2836,62,930,132,1320,194,2250
2639,2011-04-24,2,0,4,20,0,0,0,3,0.6,0.5606,0.83,0.2836,34,510,71,710,105,1220
2640,2011-04-24,2,0,4,21,0,0,0,3,0.54,0.5152,0.94,0.1642,8,120,53,530,61,650
2641,2011-04-24,2,0,4,22,0,0,0,3,0.54,0.5152,1.0,0.1642,5,75,40,400,45,475
2642,2011-04-24,2,0,4,23,0,0,0,3,0.54,0.5152,1.0,0.0896,5,75,37,370,42,445
2643,2011-04-25,2,0,4,0,0,1,1,3,0.52,0.5,1.0,0.0,2,30,10,100,12,130
2644,2011-04-25,2,0,4,1,0,1,1,1,0.54,0.5152,1.0,0.0896,2,30,8,80,10,110
2645,2011-04-25,2,0,4,2,0,1,1,1,0.54,0.5152,1.0,0.0896,1,15,9,90,10,105
2646,2011-04-25,2,0,4,3,0,1,1,2,0.5,0.4848,1.0,0.1045,2,30,8,80,10,110
2647,2011-04-25,2,0,4,4,0,1,1,2,0.52,0.5,1.0,0.0,1,15,4,40,5,55
2648,2011-04-25,2,0,4,5,0,1,1,2,0.46,0.4545,1.0,0.0,3,45,14,140,17,185
2649,2011-04-25,2,0,4,6,0,1,1,2,0.5,0.4848,1.0,0.0,7,105,59,590,66,695
2650,2011-04-25,2,0,4,7,0,1,1,2,0.52,0.5,1.0,0.0896,13,195,183,1830,196,2025
2651,2011-04-25,2,0,4,8,0,1,1,1,0.56,0.5303,0.88,0.1045,27,405,326,3260,353,3665
2652,2011-04-25,2,0,4,9,0,1,1,1,0.6,0.5606,0.83,0.1343,27,405,147,1470,174,1875
2653,2011-04-25,2,0,4,10,0,1,1,1,0.64,0.6061,0.73,0.2239,61,915,64,640,125,1555
2654,2011-04-25,2,0,4,11,0,1,1,1,0.64,0.6061,0.73,0.2239,53,795,94,940,147,1735
2655,2011-04-25,2,0,4,12,0,1,1,1,0.66,0.6212,0.74,0.2537,48,720,140,1400,188,2120
2656,2011-04-25,2,0,4,13,0,1,1,1,0.7,0.6515,0.65,0.2239,57,855,146,1460,203,2315
2657,2011-04-25,2,0,4,14,0,1,1,1,0.72,0.6667,0.54,0.2239,47,705,99,990,146,1695
2658,2011-04-25,2,0,4,15,0,1,1,1,0.74,0.6667,0.51,0.2239,50,750,125,1250,175,2000
2659,2011-04-25,2,0,4,16,0,1,1,1,0.7,0.6515,0.54,0.3582,41,615,198,1980,239,2595
2660,2011-04-25,2,0,4,17,0,1,1,1,0.7,0.6515,0.54,0.2985,80,1200,441,4410,521,5610
2661,2011-04-25,2,0,4,18,0,1,1,1,0.68,0.6364,0.57,0.3582,74,1110,425,4250,499,5360
2662,2011-04-25,2,0,4,19,0,1,1,1,0.66,0.6212,0.57,0.3284,62,930,320,3200,382,4130
2663,2011-04-25,2,0,4,20,0,1,1,1,0.66,0.6212,0.61,0.2836,42,630,195,1950,237,2580
2664,2011-04-25,2,0,4,21,0,1,1,1,0.62,0.6061,0.69,0.2537,41,615,149,1490,190,2105
2665,2011-04-25,2,0,4,22,0,1,1,1,0.6,0.5909,0.73,0.2985,23,345,83,830,106,1175
2666,2011-04-25,2,0,4,23,0,1,1,1,0.58,0.5455,0.78,0.2836,9,135,53,530,62,665
2667,2011-04-26,2,0,4,0,0,2,1,1,0.62,0.6061,0.69,0.2836,10,150,17,170,27,320
2668,2011-04-26,2,0,4,1,0,2,1,1,0.62,0.5909,0.73,0.2836,16,240,5,50,21,290
2669,2011-04-26,2,0,4,2,0,2,1,1,0.56,0.5303,0.83,0.3284,17,255,9,90,26,345
2670,2011-04-26,2,0,4,3,0,2,1,1,0.54,0.5152,0.88,0.2836,17,255,4,40,21,295
2671,2011-04-26,2,0,4,4,0,2,1,1,0.56,0.5303,0.83,0.2537,2,30,4,40,6,70
2672,2011-04-26,2,0,4,5,0,2,1,1,0.54,0.5152,0.88,0.2537,0,0,16,160,16,160
2673,2011-04-26,2,0,4,6,0,2,1,1,0.56,0.5303,0.88,0.2239,0,0,80,800,80,800
2674,2011-04-26,2,0,4,7,0,2,1,1,0.58,0.5455,0.83,0.2985,16,240,254,2540,270,2780
2675,2011-04-26,2,0,4,8,0,2,1,1,0.58,0.5455,0.83,0.2985,32,480,417,4170,449,4650
2676,2011-04-26,2,0,4,9,0,2,1,1,0.64,0.6061,0.73,0.3582,35,525,164,1640,199,2165
2677,2011-04-26,2,0,4,10,0,2,1,1,0.66,0.6212,0.69,0.3582,22,330,98,980,120,1310
2678,2011-04-26,2,0,4,11,0,2,1,1,0.68,0.6364,0.65,0.3881,40,600,132,1320,172,1920
2679,2011-04-26,2,0,4,12,0,2,1,1,0.7,0.6515,0.61,0.4179,40,600,146,1460,186,2060
2680,2011-04-26,2,0,4,13,0,2,1,1,0.74,0.6667,0.51,0.4478,37,555,139,1390,176,1945
2681,2011-04-26,2,0,4,14,0,2,1,1,0.72,0.6667,0.58,0.3284,40,600,115,1150,155,1750
2682,2011-04-26,2,0,4,15,0,2,1,1,0.7,0.6515,0.61,0.3582,34,510,119,1190,153,1700
2683,2011-04-26,2,0,4,16,0,2,1,1,0.7,0.6515,0.58,0.3881,40,600,251,2510,291,3110
2684,2011-04-26,2,0,4,17,0,2,1,1,0.68,0.6364,0.61,0.3582,66,990,455,4550,521,5540
2685,2011-04-26,2,0,4,18,0,2,1,1,0.68,0.6364,0.65,0.4478,65,975,463,4630,528,5605
2686,2011-04-26,2,0,4,19,0,2,1,1,0.64,0.6061,0.73,0.4179,42,630,286,2860,328,3490
2687,2011-04-26,2,0,4,20,0,2,1,1,0.64,0.6061,0.73,0.3582,35,525,199,1990,234,2515
2688,2011-04-26,2,0,4,21,0,2,1,1,0.62,0.5909,0.78,0.2836,33,495,162,1620,195,2115
2689,2011-04-26,2,0,4,22,0,2,1,2,0.6,0.5606,0.83,0.194,32,480,116,1160,148,1640
2690,2011-04-26,2,0,4,23,0,2,1,2,0.6,0.5606,0.83,0.2239,7,105,71,710,78,815
2691,2011-04-27,2,0,4,0,0,3,1,1,0.6,0.5606,0.83,0.2239,3,45,24,240,27,285
2692,2011-04-27,2,0,4,1,0,3,1,1,0.6,0.5606,0.83,0.2537,2,30,15,150,17,180
2693,2011-04-27,2,0,4,2,0,3,1,1,0.58,0.5455,0.88,0.2537,0,0,5,50,5,50
2694,2011-04-27,2,0,4,3,0,3,1,2,0.58,0.5455,0.88,0.2836,3,45,4,40,7,85
2695,2011-04-27,2,0,4,4,0,3,1,1,0.56,0.5303,0.94,0.2239,0,0,6,60,6,60
2696,2011-04-27,2,0,4,5,0,3,1,2,0.56,0.5303,0.94,0.2537,1,15,16,160,17,175
2697,2011-04-27,2,0,4,6,0,3,1,1,0.56,0.5303,0.94,0.2537,5,75,79,790,84,865
2698,2011-04-27,2,0,4,7,0,3,1,2,0.58,0.5455,0.88,0.2836,17,255,229,2290,246,2545
2699,2011-04-27,2,0,4,8,0,3,1,2,0.58,0.5455,0.88,0.3284,31,465,413,4130,444,4595
2700,2011-04-27,2,0,4,9,0,3,1,2,0.6,0.5455,0.88,0.4179,20,300,161,1610,181,1910
2701,2011-04-27,2,0,4,10,0,3,1,2,0.62,0.5758,0.83,0.2836,26,390,66,660,92,1050
2702,2011-04-27,2,0,4,11,0,3,1,2,0.64,0.5909,0.78,0.2836,53,795,103,1030,156,1825
2703,2011-04-27,2,0,4,12,0,3,1,1,0.66,0.6061,0.78,0.3284,38,570,135,1350,173,1920
2704,2011-04-27,2,0,4,13,0,3,1,1,0.64,0.5909,0.78,0.2985,31,465,119,1190,150,1655
2705,2011-04-27,2,0,4,14,0,3,1,1,0.68,0.6364,0.74,0.2836,29,435,119,1190,148,1625
2706,2011-04-27,2,0,4,15,0,3,1,1,0.7,0.6515,0.65,0.4925,18,270,120,1200,138,1470
2707,2011-04-27,2,0,4,16,0,3,1,1,0.7,0.6515,0.7,0.3881,29,435,189,1890,218,2325
2708,2011-04-27,2,0,4,17,0,3,1,3,0.66,0.6061,0.83,0.3881,63,945,458,4580,521,5525
2709,2011-04-27,2,0,4,18,0,3,1,3,0.66,0.6061,0.83,0.3881,46,690,366,3660,412,4350
2710,2011-04-27,2,0,4,19,0,3,1,1,0.62,0.5909,0.78,0.2836,40,600,220,2200,260,2800
2711,2011-04-27,2,0,4,20,0,3,1,1,0.64,0.5758,0.83,0.3284,30,450,188,1880,218,2330
2712,2011-04-27,2,0,4,21,0,3,1,1,0.62,0.5606,0.88,0.2836,19,285,126,1260,145,1545
2713,2011-04-27,2,0,4,22,0,3,1,2,0.62,0.5606,0.88,0.3284,18,270,111,1110,129,1380
2714,2011-04-27,2,0,4,23,0,3,1,2,0.62,0.5606,0.88,0.3582,25,375,53,530,78,905
2715,2011-04-28,2,0,4,0,0,4,1,1,0.64,0.5909,0.78,0.3582,13,195,41,410,54,605
2716,2011-04-28,2,0,4,1,0,4,1,2,0.62,0.5758,0.83,0.3881,8,120,12,120,20,240
2717,2011-04-28,2,0,4,2,0,4,1,2,0.62,0.5758,0.83,0.4478,14,210,7,70,21,280
2718,2011-04-28,2,0,4,3,0,4,1,2,0.64,0.5909,0.78,0.3881,2,30,1,10,3,40
2719,2011-04-28,2,0,4,4,0,4,1,2,0.62,0.5758,0.83,0.4179,4,60,5,50,9,110
2720,2011-04-28,2,0,4,5,0,4,1,2,0.62,0.5758,0.83,0.3881,0,0,13,130,13,130
2721,2011-04-28,2,0,4,6,0,4,1,2,0.64,0.5909,0.78,0.4627,7,105,79,790,86,895
2722,2011-04-28,2,0,4,7,0,4,1,2,0.64,0.5909,0.78,0.4478,14,210,201,2010,215,2220
2723,2011-04-28,2,0,4,8,0,4,1,2,0.66,0.6061,0.78,0.4478,31,465,367,3670,398,4135
2724,2011-04-28,2,0,4,9,0,4,1,3,0.62,0.5606,0.88,0.3284,18,270,165,1650,183,1920
2725,2011-04-28,2,0,4,10,0,4,1,2,0.62,0.5606,0.88,0.2836,9,135,45,450,54,585
2726,2011-04-28,2,0,4,11,0,4,1,2,0.62,0.5758,0.83,0.2836,10,150,74,740,84,890
2727,2011-04-28,2,0,4,12,0,4,1,2,0.62,0.5909,0.78,0.2537,23,345,84,840,107,1185
2728,2011-04-28,2,0,4,13,0,4,1,2,0.62,0.5758,0.83,0.2985,18,270,103,1030,121,1300
2729,2011-04-28,2,0,4,14,0,4,1,1,0.62,0.5758,0.83,0.2985,21,315,121,1210,142,1525
2730,2011-04-28,2,0,4,15,0,4,1,1,0.66,0.6212,0.69,0.3284,46,690,117,1170,163,1860
2731,2011-04-28,2,0,4,16,0,4,1,1,0.62,0.5909,0.78,0.2537,42,630,228,2280,270,2910
2732,2011-04-28,2,0,4,17,0,4,1,1,0.64,0.6212,0.47,0.3582,49,735,406,4060,455,4795
2733,2011-04-28,2,0,4,18,0,4,1,1,0.64,0.6212,0.47,0.3582,44,660,486,4860,530,5520
2734,2011-04-28,2,0,4,19,0,4,1,1,0.62,0.6212,0.43,0.2985,57,855,347,3470,404,4325
2735,2011-04-28,2,0,4,20,0,4,1,1,0.58,0.5455,0.43,0.2239,49,735,220,2200,269,2935
2736,2011-04-28,2,0,4,21,0,4,1,1,0.56,0.5303,0.46,0.1343,27,405,167,1670,194,2075
2737,2011-04-28,2,0,4,22,0,4,1,1,0.54,0.5152,0.45,0.1642,34,510,119,1190,153,1700
2738,2011-04-28,2,0,4,23,0,4,1,1,0.54,0.5152,0.39,0.0896,29,435,81,810,110,1245
2739,2011-04-29,2,0,4,0,0,5,1,1,0.52,0.5,0.39,0.2836,11,165,37,370,48,535
2740,2011-04-29,2,0,4,1,0,5,1,1,0.5,0.4848,0.45,0.0896,10,150,21,210,31,360
2741,2011-04-29,2,0,4,2,0,5,1,1,0.46,0.4545,0.63,0.1045,2,30,8,80,10,110
2742,2011-04-29,2,0,4,3,0,5,1,1,0.46,0.4545,0.59,0.0896,1,15,4,40,5,55
2743,2011-04-29,2,0,4,4,0,5,1,1,0.46,0.4545,0.51,0.1343,0,0,6,60,6,60
2744,2011-04-29,2,0,4,5,0,5,1,1,0.46,0.4545,0.47,0.1343,0,0,25,250,25,250
2745,2011-04-29,2,0,4,6,0,5,1,1,0.5,0.4848,0.45,0.2836,4,60,67,670,71,730
2746,2011-04-29,2,0,4,7,0,5,1,1,0.52,0.5,0.42,0.194,18,270,222,2220,240,2490
2747,2011-04-29,2,0,4,8,0,5,1,1,0.54,0.5152,0.39,0.2985,35,525,386,3860,421,4385
2748,2011-04-29,2,0,4,9,0,5,1,1,0.54,0.5152,0.39,0.3284,45,675,185,1850,230,2525
2749,2011-04-29,2,0,4,10,0,5,1,1,0.56,0.5303,0.4,0.2836,57,855,99,990,156,1845
2750,2011-04-29,2,0,4,11,0,5,1,1,0.6,0.6212,0.38,0.2239,49,735,108,1080,157,1815
2751,2011-04-29,2,0,4,12,0,5,1,1,0.56,0.5303,0.37,0.2836,63,945,160,1600,223,2545
2752,2011-04-29,2,0,4,13,0,5,1,1,0.56,0.5303,0.37,0.2985,74,1110,234,2340,308,3450
2753,2011-04-29,2,0,4,14,0,5,1,1,0.6,0.6212,0.35,0.3284,58,870,190,1900,248,2770
2754,2011-04-29,2,0,4,15,0,5,1,2,0.56,0.5303,0.4,0.2985,77,1155,175,1750,252,2905
2755,2011-04-29,2,0,4,16,0,5,1,2,0.54,0.5152,0.42,0.3582,59,885,240,2400,299,3285
2756,2011-04-29,2,0,4,17,0,5,1,2,0.52,0.5,0.45,0.3881,75,1125,433,4330,508,5455
2757,2011-04-29,2,0,4,18,0,5,1,1,0.52,0.5,0.48,0.3582,55,825,384,3840,439,4665
2758,2011-04-29,2,0,4,19,0,5,1,1,0.46,0.4545,0.55,0.3284,40,600,230,2300,270,2900
2759,2011-04-29,2,0,4,20,0,5,1,1,0.48,0.4697,0.48,0.2239,34,510,160,1600,194,2110
2760,2011-04-29,2,0,4,21,0,5,1,1,0.46,0.4545,0.51,0.194,50,750,145,1450,195,2200
2761,2011-04-29,2,0,4,22,0,5,1,1,0.42,0.4242,0.58,0.1642,36,540,110,1100,146,1640
2762,2011-04-29,2,0,4,23,0,5,1,2,0.44,0.4394,0.54,0.0896,25,375,88,880,113,1255
2763,2011-04-30,2,0,4,0,0,6,0,2,0.44,0.4394,0.54,0.2537,33,495,73,730,106,1225
2764,2011-04-30,2,0,4,1,0,6,0,2,0.44,0.4394,0.54,0.1642,15,225,59,590,74,815
2765,2011-04-30,2,0,4,2,0,6,0,2,0.44,0.4394,0.54,0.2239,12,180,53,530,65,710
2766,2011-04-30,2,0,4,3,0,6,0,2,0.42,0.4242,0.54,0.194,4,60,13,130,17,190
2767,2011-04-30,2,0,4,4,0,6,0,2,0.42,0.4242,0.54,0.2239,2,30,5,50,7,80
2768,2011-04-30,2,0,4,5,0,6,0,1,0.42,0.4242,0.54,0.3881,3,45,4,40,7,85
2769,2011-04-30,2,0,4,6,0,6,0,1,0.4,0.4091,0.58,0.2836,10,150,11,110,21,260
2770,2011-04-30,2,0,4,7,0,6,0,1,0.4,0.4091,0.54,0.3881,21,315,27,270,48,585
2771,2011-04-30,2,0,4,8,0,6,0,1,0.4,0.4091,0.54,0.2985,21,315,70,700,91,1015
2772,2011-04-30,2,0,4,9,0,6,0,1,0.44,0.4394,0.51,0.3582,35,525,121,1210,156,1735
2773,2011-04-30,2,0,4,10,0,6,0,1,0.48,0.4697,0.44,0.3881,94,1410,185,1850,279,3260
2774,2011-04-30,2,0,4,11,0,6,0,1,0.5,0.4848,0.42,0.3582,120,1800,201,2010,321,3810
2775,2011-04-30,2,0,4,12,0,6,0,1,0.52,0.5,0.42,0.3881,178,2670,238,2380,416,5050
2776,2011-04-30,2,0,4,13,0,6,0,1,0.54,0.5152,0.39,0.2985,185,2775,270,2700,455,5475
2777,2011-04-30,2,0,4,14,0,6,0,1,0.54,0.5152,0.39,0.2239,184,2760,268,2680,452,5440
2778,2011-04-30,2,0,4,15,0,6,0,1,0.56,0.5303,0.37,0.1343,217,3255,282,2820,499,6075
2779,2011-04-30,2,0,4,16,0,6,0,1,0.58,0.5455,0.37,0.194,191,2865,273,2730,464,5595
2780,2011-04-30,2,0,4,17,0,6,0,1,0.56,0.5303,0.43,0.1343,162,2430,245,2450,407,4880
2781,2011-04-30,2,0,4,18,0,6,0,1,0.54,0.5152,0.43,0.1343,134,2010,237,2370,371,4380
2782,2011-04-30,2,0,4,19,0,6,0,1,0.54,0.5152,0.43,0.1343,150,2250,237,2370,387,4620
2783,2011-04-30,2,0,4,20,0,6,0,1,0.44,0.4394,0.62,0.1343,65,975,159,1590,224,2565
2784,2011-04-30,2,0,4,21,0,6,0,1,0.44,0.4394,0.62,0.1343,58,870,119,1190,177,2060
2785,2011-04-30,2,0,4,22,0,6,0,1,0.44,0.4394,0.67,0.1045,37,555,106,1060,143,1615
2786,2011-04-30,2,0,4,23,0,6,0,1,0.44,0.4394,0.67,0.1045,34,510,91,910,125,1420
2787,2011-05-01,2,0,5,0,0,0,0,1,0.42,0.4242,0.67,0.0896,19,285,77,770,96,1055
2788,2011-05-01,2,0,5,1,0,0,0,1,0.42,0.4242,0.69,0.1045,9,135,50,500,59,635
2789,2011-05-01,2,0,5,2,0,0,0,1,0.42,0.4242,0.77,0.1045,7,105,43,430,50,535
2790,2011-05-01,2,0,5,3,0,0,0,1,0.4,0.4091,0.82,0.1045,8,120,15,150,23,270
2791,2011-05-01,2,0,5,4,0,0,0,1,0.4,0.4091,0.76,0.1045,6,90,11,110,17,200
2792,2011-05-01,2,0,5,5,0,0,0,1,0.4,0.4091,0.82,0.0896,0,0,10,100,10,100
2793,2011-05-01,2,0,5,6,0,0,0,2,0.4,0.4091,0.82,0.0896,4,60,9,90,13,150
2794,2011-05-01,2,0,5,7,0,0,0,2,0.42,0.4242,0.77,0.0896,7,105,26,260,33,365
2795,2011-05-01,2,0,5,8,0,0,0,2,0.44,0.4394,0.77,0.1343,16,240,43,430,59,670
2796,2011-05-01,2,0,5,9,0,0,0,2,0.46,0.4545,0.72,0.1343,45,675,96,960,141,1635
2797,2011-05-01,2,0,5,10,0,0,0,2,0.48,0.4697,0.63,0.194,109,1635,155,1550,264,3185
2798,2011-05-01,2,0,5,11,0,0,0,1,0.46,0.4545,0.82,0.1045,109,1635,141,1410,250,3045
2799,2011-05-01,2,0,5,12,0,0,0,2,0.48,0.4697,0.77,0.1045,109,1635,172,1720,281,3355
2800,2011-05-01,2,0,5,13,0,0,0,2,0.5,0.4848,0.63,0.1642,123,1845,209,2090,332,3935
2801,2011-05-01,2,0,5,14,0,0,0,2,0.5,0.4848,0.68,0.1045,85,1275,153,1530,238,2805
2802,2011-05-01,2,0,5,15,0,0,0,2,0.5,0.4848,0.72,0.0,113,1695,153,1530,266,3225
2803,2011-05-01,2,0,5,16,0,0,0,2,0.5,0.4848,0.72,0.194,75,1125,139,1390,214,2515
2804,2011-05-01,2,0,5,17,0,0,0,2,0.48,0.4697,0.82,0.2537,60,900,136,1360,196,2260
2805,2011-05-01,2,0,5,18,0,0,0,2,0.46,0.4545,0.82,0.0896,33,495,126,1260,159,1755
2806,2011-05-01,2,0,5,19,0,0,0,2,0.46,0.4545,0.84,0.1045,47,705,131,1310,178,2015
2807,2011-05-01,2,0,5,20,0,0,0,2,0.46,0.4545,0.82,0.0,35,525,86,860,121,1385
2808,2011-05-01,2,0,5,21,0,0,0,2,0.46,0.4545,0.82,0.0,23,345,82,820,105,1165
2809,2011-05-01,2,0,5,22,0,0,0,2,0.46,0.4545,0.82,0.0,32,480,68,680,100,1160
2810,2011-05-01,2,0,5,23,0,0,0,1,0.46,0.4545,0.77,0.194,64,960,82,820,146,1780
2811,2011-05-02,2,0,5,0,0,1,1,1,0.46,0.4545,0.72,0.1343,68,1020,109,1090,177,2110
2812,2011-05-02,2,0,5,1,0,1,1,1,0.46,0.4545,0.72,0.1343,41,615,73,730,114,1345
2813,2011-05-02,2,0,5,2,0,1,1,2,0.44,0.4394,0.77,0.2239,16,240,19,190,35,430
2814,2011-05-02,2,0,5,3,0,1,1,1,0.44,0.4394,0.77,0.1343,9,135,7,70,16,205
2815,2011-05-02,2,0,5,4,0,1,1,1,0.44,0.4394,0.77,0.1642,9,135,8,80,17,215
2816,2011-05-02,2,0,5,5,0,1,1,2,0.44,0.4394,0.77,0.1343,4,60,16,160,20,220
2817,2011-05-02,2,0,5,6,0,1,1,1,0.44,0.4394,0.88,0.1045,3,45,59,590,62,635
2818,2011-05-02,2,0,5,7,0,1,1,2,0.46,0.4545,0.82,0.3284,16,240,193,1930,209,2170
2819,2011-05-02,2,0,5,8,0,1,1,2,0.48,0.4697,0.77,0.2239,21,315,350,3500,371,3815
2820,2011-05-02,2,0,5,9,0,1,1,2,0.5,0.4848,0.77,0.2836,41,615,131,1310,172,1925
2821,2011-05-02,2,0,5,10,0,1,1,2,0.54,0.5152,0.77,0.2239,31,465,77,770,108,1235
2822,2011-05-02,2,0,5,11,0,1,1,1,0.58,0.5455,0.73,0.2985,34,510,96,960,130,1470
2823,2011-05-02,2,0,5,12,0,1,1,1,0.62,0.6061,0.69,0.2239,40,600,147,1470,187,2070
2824,2011-05-02,2,0,5,13,0,1,1,2,0.62,0.6061,0.69,0.194,51,765,119,1190,170,1955
2825,2011-05-02,2,0,5,14,0,1,1,1,0.64,0.6061,0.69,0.2239,48,720,133,1330,181,2050
2826,2011-05-02,2,0,5,15,0,1,1,1,0.66,0.6212,0.61,0.194,45,675,110,1100,155,1775
2827,2011-05-02,2,0,5,16,0,1,1,1,0.66,0.6212,0.61,0.2239,49,735,220,2200,269,2935
2828,2011-05-02,2,0,5,17,0,1,1,1,0.66,0.6212,0.65,0.194,65,975,472,4720,537,5695
2829,2011-05-02,2,0,5,18,0,1,1,2,0.64,0.6061,0.65,0.194,68,1020,450,4500,518,5520
2830,2011-05-02,2,0,5,19,0,1,1,2,0.62,0.6061,0.69,0.1343,46,690,268,2680,314,3370
2831,2011-05-02,2,0,5,20,0,1,1,2,0.62,0.6061,0.69,0.1343,44,660,174,1740,218,2400
2832,2011-05-02,2,0,5,21,0,1,1,2,0.6,0.5909,0.73,0.1045,54,810,178,1780,232,2590
2833,2011-05-02,2,0,5,22,0,1,1,2,0.6,0.5909,0.73,0.0,28,420,97,970,125,1390
2834,2011-05-02,2,0,5,23,0,1,1,2,0.56,0.5303,0.83,0.194,16,240,48,480,64,720
2835,2011-05-03,2,0,5,0,0,2,1,2,0.56,0.5303,0.83,0.2239,0,0,16,160,16,160
2836,2011-05-03,2,0,5,1,0,2,1,2,0.56,0.5303,0.78,0.2537,0,0,14,140,14,140
2837,2011-05-03,2,0,5,2,0,2,1,2,0.56,0.5303,0.78,0.2537,0,0,5,50,5,50
2838,2011-05-03,2,0,5,3,0,2,1,1,0.54,0.5152,0.83,0.2836,0,0,2,20,2,20
2839,2011-05-03,2,0,5,4,0,2,1,1,0.52,0.5,0.88,0.2239,3,45,1,10,4,55
2840,2011-05-03,2,0,5,5,0,2,1,1,0.52,0.5,0.88,0.1343,0,0,14,140,14,140
2841,2011-05-03,2,0,5,6,0,2,1,2,0.52,0.5,0.94,0.1642,7,105,102,1020,109,1125
2842,2011-05-03,2,0,5,7,0,2,1,2,0.54,0.5152,0.88,0.2239,17,255,248,2480,265,2735
2843,2011-05-03,2,0,5,8,0,2,1,2,0.56,0.5303,0.83,0.2836,24,360,435,4350,459,4710
2844,2011-05-03,2,0,5,9,0,2,1,2,0.6,0.5758,0.78,0.3582,29,435,157,1570,186,2005
2845,2011-05-03,2,0,5,10,0,2,1,2,0.64,0.6061,0.69,0.3582,36,540,91,910,127,1450
2846,2011-05-03,2,0,5,11,0,2,1,2,0.66,0.6212,0.65,0.3284,20,300,120,1200,140,1500
2847,2011-05-03,2,0,5,12,0,2,1,2,0.68,0.6364,0.61,0.4925,48,720,169,1690,217,2410
2848,2011-05-03,2,0,5,13,0,2,1,2,0.7,0.6515,0.58,0.6119,50,750,144,1440,194,2190
2849,2011-05-03,2,0,5,14,0,2,1,2,0.7,0.6515,0.58,0.5224,36,540,122,1220,158,1760
2850,2011-05-03,2,0,5,15,0,2,1,2,0.7,0.6515,0.58,0.4478,37,555,117,1170,154,1725
2851,2011-05-03,2,0,5,16,0,2,1,1,0.72,0.6667,0.54,0.4627,46,690,225,2250,271,2940
2852,2011-05-03,2,0,5,17,0,2,1,1,0.7,0.6515,0.54,0.4627,53,795,464,4640,517,5435
2853,2011-05-03,2,0,5,18,0,2,1,1,0.7,0.6515,0.48,0.4179,59,885,485,4850,544,5735
2854,2011-05-03,2,0,5,19,0,2,1,1,0.68,0.6364,0.57,0.3582,42,630,323,3230,365,3860
2855,2011-05-03,2,0,5,20,0,2,1,1,0.66,0.6212,0.61,0.194,28,420,262,2620,290,3040
2856,2011-05-03,2,0,5,21,0,2,1,2,0.64,0.6212,0.61,0.4478,42,630,183,1830,225,2460
2857,2011-05-03,2,0,5,22,0,2,1,2,0.58,0.5455,0.6,0.3881,14,210,99,990,113,1200
2858,2011-05-03,2,0,5,23,0,2,1,2,0.56,0.5303,0.68,0.3284,12,180,50,500,62,680
2859,2011-05-04,2,0,5,0,0,3,1,3,0.52,0.5,0.77,0.1642,5,75,22,220,27,295
2860,2011-05-04,2,0,5,1,0,3,1,3,0.5,0.4848,0.82,0.2836,1,15,6,60,7,75
2861,2011-05-04,2,0,5,2,0,3,1,3,0.5,0.4848,0.82,0.2836,0,0,4,40,4,40
2862,2011-05-04,2,0,5,3,0,3,1,3,0.42,0.4242,0.88,0.5224,0,0,1,10,1,10
2863,2011-05-04,2,0,5,4,0,3,1,3,0.38,0.3939,0.94,0.3284,1,15,2,20,3,35
2864,2011-05-04,2,0,5,5,0,3,1,3,0.36,0.3333,0.87,0.3284,1,15,8,80,9,95
2865,2011-05-04,2,0,5,6,0,3,1,3,0.34,0.303,0.93,0.3881,0,0,21,210,21,210
2866,2011-05-04,2,0,5,7,0,3,1,3,0.34,0.303,0.93,0.3582,6,90,46,460,52,550
2867,2011-05-04,2,0,5,8,0,3,1,3,0.34,0.303,0.93,0.3881,5,75,74,740,79,815
2868,2011-05-04,2,0,5,9,0,3,1,3,0.34,0.303,0.93,0.3582,5,75,35,350,40,425
2869,2011-05-04,2,0,5,10,0,3,1,2,0.34,0.3182,0.93,0.2836,5,75,26,260,31,335
2870,2011-05-04,2,0,5,11,0,3,1,1,0.4,0.4091,0.82,0.3284,3,45,69,690,72,735
2871,2011-05-04,2,0,5,12,0,3,1,2,0.44,0.4394,0.62,0.3582,19,285,105,1050,124,1335
2872,2011-05-04,2,0,5,13,0,3,1,2,0.46,0.4545,0.59,0.4478,15,225,128,1280,143,1505
2873,2011-05-04,2,0,5,14,0,3,1,1,0.5,0.4848,0.51,0.3881,13,195,94,940,107,1135
2874,2011-05-04,2,0,5,15,0,3,1,1,0.48,0.4697,0.51,0.4179,22,330,107,1070,129,1400
2875,2011-05-04,2,0,5,16,0,3,1,1,0.5,0.4848,0.45,0.4627,22,330,173,1730,195,2060
2876,2011-05-04,2,0,5,17,0,3,1,1,0.4,0.4091,0.71,0.2537,22,330,388,3880,410,4210
2877,2011-05-04,2,0,5,18,0,3,1,1,0.42,0.4242,0.67,0.2537,29,435,367,3670,396,4105
2878,2011-05-04,2,0,5,19,0,3,1,1,0.42,0.4242,0.58,0.3582,30,450,266,2660,296,3110
2879,2011-05-04,2,0,5,20,0,3,1,1,0.4,0.4091,0.62,0.3284,17,255,174,1740,191,1995
2880,2011-05-04,2,0,5,21,0,3,1,1,0.4,0.4091,0.62,0.1642,17,255,133,1330,150,1585
2881,2011-05-04,2,0,5,22,0,3,1,1,0.38,0.3939,0.62,0.2239,9,135,80,800,89,935
2882,2011-05-04,2,0,5,23,0,3,1,1,0.36,0.3485,0.62,0.2239,8,120,49,490,57,610
2883,2011-05-05,2,0,5,0,0,4,1,1,0.36,0.3485,0.66,0.194,4,60,23,230,27,290
2884,2011-05-05,2,0,5,1,0,4,1,1,0.34,0.3333,0.71,0.194,4,60,6,60,10,120
2885,2011-05-05,2,0,5,2,0,4,1,1,0.34,0.3182,0.66,0.2239,1,15,4,40,5,55
2886,2011-05-05,2,0,5,3,0,4,1,1,0.34,0.3182,0.66,0.2537,0,0,4,40,4,40
2887,2011-05-05,2,0,5,4,0,4,1,1,0.34,0.3182,0.66,0.2537,4,60,3,30,7,90
2888,2011-05-05,2,0,5,5,0,4,1,1,0.34,0.3182,0.66,0.2537,1,15,29,290,30,305
2889,2011-05-05,2,0,5,6,0,4,1,1,0.34,0.3182,0.66,0.2537,3,45,86,860,89,905
2890,2011-05-05,2,0,5,7,0,4,1,1,0.38,0.3939,0.58,0.2537,16,240,255,2550,271,2790
2891,2011-05-05,2,0,5,8,0,4,1,1,0.42,0.4242,0.5,0.2537,25,375,415,4150,440,4525
2892,2011-05-05,2,0,5,9,0,4,1,1,0.46,0.4545,0.44,0.2836,20,300,164,1640,184,1940
2893,2011-05-05,2,0,5,10,0,4,1,1,0.5,0.4848,0.39,0.2836,30,450,98,980,128,1430
2894,2011-05-05,2,0,5,11,0,4,1,1,0.52,0.5,0.36,0.4478,43,645,105,1050,148,1695
2895,2011-05-05,2,0,5,12,0,4,1,1,0.52,0.5,0.34,0.3582,27,405,169,1690,196,2095
2896,2011-05-05,2,0,5,13,0,4,1,1,0.54,0.5152,0.3,0.5821,50,750,142,1420,192,2170
2897,2011-05-05,2,0,5,14,0,4,1,1,0.54,0.5152,0.28,0.4478,19,285,135,1350,154,1635
2898,2011-05-05,2,0,5,15,0,4,1,1,0.56,0.5303,0.26,0.4925,27,405,120,1200,147,1605
2899,2011-05-05,2,0,5,16,0,4,1,1,0.58,0.5455,0.24,0.4179,36,540,233,2330,269,2870
2900,2011-05-05,2,0,5,17,0,4,1,1,0.56,0.5303,0.26,0.3881,66,990,467,4670,533,5660
2901,2011-05-05,2,0,5,18,0,4,1,1,0.56,0.5303,0.26,0.2836,64,960,456,4560,520,5520
2902,2011-05-05,2,0,5,19,0,4,1,1,0.54,0.5152,0.28,0.2239,56,840,305,3050,361,3890
2903,2011-05-05,2,0,5,20,0,4,1,1,0.5,0.4848,0.34,0.1642,33,495,225,2250,258,2745
2904,2011-05-05,2,0,5,21,0,4,1,1,0.5,0.4848,0.36,0.194,39,585,141,1410,180,1995
2905,2011-05-05,2,0,5,22,0,4,1,1,0.48,0.4697,0.39,0.194,30,450,135,1350,165,1800
2906,2011-05-05,2,0,5,23,0,4,1,1,0.46,0.4545,0.41,0.194,16,240,99,990,115,1230
2907,2011-05-06,2,0,5,0,0,5,1,1,0.44,0.4394,0.44,0.1642,13,195,43,430,56,625
2908,2011-05-06,2,0,5,1,0,5,1,1,0.4,0.4091,0.62,0.1642,8,120,24,240,32,360
2909,2011-05-06,2,0,5,2,0,5,1,1,0.38,0.3939,0.62,0.1045,1,15,15,150,16,165
2910,2011-05-06,2,0,5,3,0,5,1,1,0.36,0.3636,0.71,0.1045,3,45,6,60,9,105
2911,2011-05-06,2,0,5,4,0,5,1,1,0.36,0.3636,0.71,0.1045,0,0,1,10,1,10
2912,2011-05-06,2,0,5,5,0,5,1,1,0.34,0.3485,0.81,0.1045,0,0,16,160,16,160
2913,2011-05-06,2,0,5,6,0,5,1,1,0.36,0.3636,0.81,0.0896,8,120,74,740,82,860
2914,2011-05-06,2,0,5,7,0,5,1,1,0.4,0.4091,0.82,0.0,20,300,202,2020,222,2320
2915,2011-05-06,2,0,5,8,0,5,1,1,0.42,0.4242,0.77,0.2537,35,525,415,4150,450,4675
2916,2011-05-06,2,0,5,9,0,5,1,1,0.46,0.4545,0.67,0.2836,27,405,161,1610,188,2015
2917,2011-05-06,2,0,5,10,0,5,1,2,0.54,0.5152,0.49,0.3284,30,450,97,970,127,1420
2918,2011-05-06,2,0,5,11,0,5,1,2,0.54,0.5152,0.49,0.3284,42,630,123,1230,165,1860
2919,2011-05-06,2,0,5,12,0,5,1,1,0.56,0.5303,0.49,0.3582,48,720,198,1980,246,2700
2920,2011-05-06,2,0,5,13,0,5,1,1,0.58,0.5455,0.4,0.3284,71,1065,182,1820,253,2885
2921,2011-05-06,2,0,5,14,0,5,1,1,0.6,0.6212,0.4,0.4478,86,1290,127,1270,213,2560
2922,2011-05-06,2,0,5,15,0,5,1,1,0.6,0.6212,0.38,0.3881,89,1335,171,1710,260,3045
2923,2011-05-06,2,0,5,16,0,5,1,1,0.6,0.6212,0.4,0.2537,82,1230,262,2620,344,3850
2924,2011-05-06,2,0,5,17,0,5,1,1,0.58,0.5455,0.4,0.3582,83,1245,470,4700,553,5945
2925,2011-05-06,2,0,5,18,0,5,1,3,0.54,0.5152,0.52,0.3582,85,1275,385,3850,470,5125
2926,2011-05-06,2,0,5,19,0,5,1,3,0.54,0.5152,0.52,0.3582,39,585,253,2530,292,3115
2927,2011-05-06,2,0,5,20,0,5,1,1,0.52,0.5,0.48,0.1045,29,435,161,1610,190,2045
2928,2011-05-06,2,0,5,21,0,5,1,1,0.48,0.4697,0.67,0.1343,22,330,130,1300,152,1630
2929,2011-05-06,2,0,5,22,0,5,1,1,0.46,0.4545,0.72,0.2239,46,690,105,1050,151,1740
2930,2011-05-06,2,0,5,23,0,5,1,1,0.44,0.4394,0.82,0.1343,27,405,93,930,120,1335
2931,2011-05-07,2,0,5,0,0,6,0,1,0.42,0.4242,0.82,0.1343,10,150,76,760,86,910
2932,2011-05-07,2,0,5,1,0,6,0,1,0.42,0.4242,0.82,0.1045,8,120,50,500,58,620
2933,2011-05-07,2,0,5,2,0,6,0,1,0.42,0.4242,0.82,0.0896,5,75,47,470,52,545
2934,2011-05-07,2,0,5,3,0,6,0,1,0.42,0.4242,0.77,0.0896,9,135,9,90,18,225
2935,2011-05-07,2,0,5,4,0,6,0,1,0.4,0.4091,0.82,0.1045,1,15,4,40,5,55
2936,2011-05-07,2,0,5,5,0,6,0,1,0.46,0.4545,0.59,0.1343,4,60,3,30,7,90
2937,2011-05-07,2,0,5,6,0,6,0,1,0.42,0.4242,0.77,0.0896,1,15,12,120,13,135
2938,2011-05-07,2,0,5,7,0,6,0,1,0.48,0.4697,0.59,0.0,8,120,32,320,40,440
2939,2011-05-07,2,0,5,8,0,6,0,1,0.52,0.5,0.52,0.194,19,285,96,960,115,1245
2940,2011-05-07,2,0,5,9,0,6,0,1,0.54,0.5152,0.49,0.2836,54,810,164,1640,218,2450
2941,2011-05-07,2,0,5,10,0,6,0,1,0.56,0.5303,0.49,0.2985,90,1350,208,2080,298,3430
2942,2011-05-07,2,0,5,11,0,6,0,1,0.56,0.5303,0.43,0.0,132,1980,215,2150,347,4130
2943,2011-05-07,2,0,5,12,0,6,0,1,0.6,0.6212,0.4,0.194,129,1935,244,2440,373,4375
2944,2011-05-07,2,0,5,13,0,6,0,1,0.6,0.6212,0.35,0.2836,196,2940,240,2400,436,5340
2945,2011-05-07,2,0,5,14,0,6,0,3,0.6,0.6212,0.35,0.1642,143,2145,235,2350,378,4495
2946,2011-05-07,2,0,5,15,0,6,0,1,0.6,0.6212,0.38,0.2537,148,2220,230,2300,378,4520
2947,2011-05-07,2,0,5,16,0,6,0,1,0.6,0.6212,0.38,0.194,119,1785,223,2230,342,4015
2948,2011-05-07,2,0,5,17,0,6,0,1,0.58,0.5455,0.4,0.2239,138,2070,216,2160,354,4230
2949,2011-05-07,2,0,5,18,0,6,0,1,0.58,0.5455,0.37,0.1642,114,1710,175,1750,289,3460
2950,2011-05-07,2,0,5,19,0,6,0,1,0.56,0.5303,0.43,0.194,88,1320,179,1790,267,3110
2951,2011-05-07,2,0,5,20,0,6,0,1,0.56,0.5303,0.43,0.1343,82,1230,137,1370,219,2600
2952,2011-05-07,2,0,5,21,0,6,0,1,0.54,0.5152,0.49,0.2239,58,870,124,1240,182,2110
2953,2011-05-07,2,0,5,22,0,6,0,1,0.54,0.5152,0.49,0.194,26,390,94,940,120,1330
2954,2011-05-07,2,0,5,23,0,6,0,1,0.5,0.4848,0.59,0.1045,30,450,89,890,119,1340
2955,2011-05-08,2,0,5,0,0,0,0,2,0.5,0.4848,0.59,0.1045,22,330,78,780,100,1110
2956,2011-05-08,2,0,5,1,0,0,0,2,0.52,0.5,0.55,0.0,8,120,56,560,64,680
2957,2011-05-08,2,0,5,2,0,0,0,1,0.48,0.4697,0.63,0.0,17,255,42,420,59,675
2958,2011-05-08,2,0,5,3,0,0,0,1,0.46,0.4545,0.72,0.0896,10,150,21,210,31,360
2959,2011-05-08,2,0,5,4,0,0,0,1,0.42,0.4242,0.82,0.0,2,30,8,80,10,110
2960,2011-05-08,2,0,5,5,0,0,0,2,0.44,0.4394,0.77,0.0,0,0,5,50,5,50
2961,2011-05-08,2,0,5,6,0,0,0,2,0.44,0.4394,0.82,0.0,2,30,4,40,6,70
2962,2011-05-08,2,0,5,7,0,0,0,2,0.46,0.4545,0.82,0.0,8,120,15,150,23,270
2963,2011-05-08,2,0,5,8,0,0,0,1,0.52,0.5,0.63,0.1343,28,420,58,580,86,1000
2964,2011-05-08,2,0,5,9,0,0,0,1,0.56,0.5303,0.52,0.2239,48,720,112,1120,160,1840
2965,2011-05-08,2,0,5,10,0,0,0,1,0.58,0.5455,0.49,0.1343,91,1365,153,1530,244,2895
2966,2011-05-08,2,0,5,11,0,0,0,1,0.58,0.5455,0.49,0.0896,142,2130,198,1980,340,4110
2967,2011-05-08,2,0,5,12,0,0,0,1,0.6,0.6212,0.46,0.0896,139,2085,243,2430,382,4515
2968,2011-05-08,2,0,5,13,0,0,0,1,0.6,0.6212,0.49,0.1343,166,2490,224,2240,390,4730
2969,2011-05-08,2,0,5,14,0,0,0,1,0.6,0.6212,0.49,0.0,126,1890,240,2400,366,4290
2970,2011-05-08,2,0,5,15,0,0,0,1,0.6,0.6212,0.49,0.0,128,1920,230,2300,358,4220
2971,2011-05-08,2,0,5,16,0,0,0,1,0.6,0.6212,0.46,0.1045,122,1830,263,2630,385,4460
2972,2011-05-08,2,0,5,17,0,0,0,3,0.58,0.5455,0.49,0.2836,106,1590,245,2450,351,4040
2973,2011-05-08,2,0,5,18,0,0,0,1,0.58,0.5455,0.49,0.0,63,945,205,2050,268,2995
2974,2011-05-08,2,0,5,19,0,0,0,1,0.56,0.5303,0.64,0.0,61,915,178,1780,239,2695
2975,2011-05-08,2,0,5,20,0,0,0,1,0.52,0.5,0.77,0.1343,42,630,132,1320,174,1950
2976,2011-05-08,2,0,5,21,0,0,0,1,0.52,0.5,0.77,0.0896,32,480,95,950,127,1430
2977,2011-05-08,2,0,5,22,0,0,0,1,0.5,0.4848,0.88,0.0896,29,435,86,860,115,1295
2978,2011-05-08,2,0,5,23,0,0,0,1,0.46,0.4545,0.88,0.0896,9,135,41,410,50,545
2979,2011-05-09,2,0,5,0,0,1,1,1,0.46,0.4545,0.82,0.0896,31,465,22,220,53,685
2980,2011-05-09,2,0,5,1,0,1,1,1,0.44,0.4394,0.88,0.0,25,375,8,80,33,455
2981,2011-05-09,2,0,5,2,0,1,1,1,0.44,0.4394,0.94,0.0,6,90,2,20,8,110
2982,2011-05-09,2,0,5,3,0,1,1,1,0.46,0.4545,0.82,0.0896,0,0,7,70,7,70
2983,2011-05-09,2,0,5,4,0,1,1,1,0.42,0.4242,0.82,0.1642,0,0,4,40,4,40
2984,2011-05-09,2,0,5,5,0,1,1,1,0.42,0.4242,0.77,0.1642,0,0,23,230,23,230
2985,2011-05-09,2,0,5,6,0,1,1,1,0.44,0.4394,0.72,0.2537,2,30,87,870,89,900
2986,2011-05-09,2,0,5,7,0,1,1,1,0.48,0.4697,0.63,0.2537,16,240,221,2210,237,2450
2987,2011-05-09,2,0,5,8,0,1,1,1,0.52,0.5,0.55,0.2239,23,345,351,3510,374,3855
2988,2011-05-09,2,0,5,9,0,1,1,1,0.54,0.5152,0.56,0.1642,36,540,142,1420,178,1960
2989,2011-05-09,2,0,5,10,0,1,1,1,0.56,0.5303,0.52,0.194,24,360,95,950,119,1310
2990,2011-05-09,2,0,5,11,0,1,1,1,0.6,0.6212,0.46,0.2239,26,390,99,990,125,1380
2991,2011-05-09,2,0,5,12,0,1,1,1,0.6,0.6212,0.43,0.194,35,525,160,1600,195,2125
2992,2011-05-09,2,0,5,13,0,1,1,1,0.62,0.6212,0.38,0.2836,36,540,138,1380,174,1920
2993,2011-05-09,2,0,5,14,0,1,1,1,0.62,0.6212,0.41,0.2239,44,660,118,1180,162,1840
2994,2011-05-09,2,0,5,15,0,1,1,1,0.62,0.6212,0.41,0.2239,51,765,148,1480,199,2245
2995,2011-05-09,2,0,5,16,0,1,1,1,0.64,0.6212,0.38,0.2239,49,735,255,2550,304,3285
2996,2011-05-09,2,0,5,17,0,1,1,1,0.62,0.6212,0.38,0.2537,59,885,539,5390,598,6275
2997,2011-05-09,2,0,5,18,0,1,1,1,0.62,0.6212,0.38,0.2985,66,990,458,4580,524,5570
2998,2011-05-09,2,0,5,19,0,1,1,1,0.58,0.5455,0.43,0.194,45,675,339,3390,384,4065
2999,2011-05-09,2,0,5,20,0,1,1,1,0.54,0.5152,0.49,0.194,25,375,214,2140,239,2515
3000,2011-05-09,2,0,5,21,0,1,1,1,0.52,0.5,0.59,0.1343,28,420,128,1280,156,1700
3001,2011-05-09,2,0,5,22,0,1,1,1,0.52,0.5,0.68,0.0896,21,315,95,950,116,1265
3002,2011-05-09,2,0,5,23,0,1,1,1,0.5,0.4848,0.68,0.0896,16,240,45,450,61,690
3003,2011-05-10,2,0,5,0,0,2,1,1,0.48,0.4697,0.63,0.0,6,90,12,120,18,210
3004,2011-05-10,2,0,5,1,0,2,1,1,0.46,0.4545,0.59,0.0896,3,45,12,120,15,165
3005,2011-05-10,2,0,5,2,0,2,1,1,0.44,0.4394,0.58,0.1343,1,15,4,40,5,55
3006,2011-05-10,2,0,5,3,0,2,1,1,0.44,0.4394,0.54,0.194,1,15,3,30,4,45
3007,2011-05-10,2,0,5,4,0,2,1,1,0.42,0.4242,0.62,0.2537,0,0,2,20,2,20
3008,2011-05-10,2,0,5,5,0,2,1,1,0.4,0.4091,0.66,0.2239,1,15,28,280,29,295
3009,2011-05-10,2,0,5,6,0,2,1,1,0.42,0.4242,0.67,0.1343,9,135,103,1030,112,1165
3010,2011-05-10,2,0,5,7,0,2,1,2,0.44,0.4394,0.62,0.1343,13,195,301,3010,314,3205
3011,2011-05-10,2,0,5,8,0,2,1,2,0.5,0.4848,0.51,0.1045,28,420,397,3970,425,4390
3012,2011-05-10,2,0,5,9,0,2,1,2,0.52,0.5,0.48,0.1045,29,435,176,1760,205,2195
3013,2011-05-10,2,0,5,10,0,2,1,2,0.56,0.5303,0.37,0.0896,27,405,100,1000,127,1405
3014,2011-05-10,2,0,5,11,0,2,1,2,0.56,0.5303,0.43,0.1343,17,255,108,1080,125,1335
3015,2011-05-10,2,0,5,12,0,2,1,2,0.6,0.6212,0.38,0.0,47,705,170,1700,217,2405
3016,2011-05-10,2,0,5,13,0,2,1,2,0.62,0.6212,0.38,0.2537,50,750,152,1520,202,2270
3017,2011-05-10,2,0,5,14,0,2,1,2,0.62,0.6212,0.33,0.0,42,630,134,1340,176,1970
3018,2011-05-10,2,0,5,15,0,2,1,2,0.64,0.6212,0.33,0.0896,28,420,152,1520,180,1940
3019,2011-05-10,2,0,5,16,0,2,1,1,0.66,0.6212,0.31,0.1045,56,840,271,2710,327,3550
3020,2011-05-10,2,0,5,17,0,2,1,1,0.64,0.6212,0.33,0.0,79,1185,532,5320,611,6505
3021,2011-05-10,2,0,5,18,0,2,1,1,0.64,0.6212,0.29,0.1343,70,1050,480,4800,550,5850
3022,2011-05-10,2,0,5,19,0,2,1,1,0.6,0.6212,0.43,0.2239,69,1035,365,3650,434,4685
3023,2011-05-10,2,0,5,20,0,2,1,1,0.54,0.5152,0.6,0.1343,50,750,241,2410,291,3160
3024,2011-05-10,2,0,5,21,0,2,1,1,0.54,0.5152,0.52,0.0,30,450,173,1730,203,2180
3025,2011-05-10,2,0,5,22,0,2,1,1,0.52,0.5,0.55,0.1045,29,435,121,1210,150,1645
3026,2011-05-10,2,0,5,23,0,2,1,2,0.52,0.5,0.59,0.1343,9,135,72,720,81,855
3027,2011-05-11,2,0,5,0,0,3,1,2,0.52,0.5,0.55,0.1343,8,120,30,300,38,420
3028,2011-05-11,2,0,5,1,0,3,1,2,0.5,0.4848,0.59,0.1045,4,60,16,160,20,220
3029,2011-05-11,2,0,5,2,0,3,1,1,0.52,0.5,0.59,0.0,6,90,4,40,10,130
3030,2011-05-11,2,0,5,3,0,3,1,1,0.5,0.4848,0.63,0.2239,0,0,3,30,3,30
3031,2011-05-11,2,0,5,4,0,3,1,2,0.48,0.4697,0.88,0.1343,0,0,2,20,2,20
3032,2011-05-11,2,0,5,5,0,3,1,1,0.46,0.4545,0.88,0.1343,0,0,20,200,20,200
3033,2011-05-11,2,0,5,6,0,3,1,1,0.46,0.4545,0.82,0.1343,6,90,93,930,99,1020
3034,2011-05-11,2,0,5,7,0,3,1,1,0.48,0.4697,0.72,0.194,25,375,293,2930,318,3305
3035,2011-05-11,2,0,5,8,0,3,1,1,0.48,0.4697,0.77,0.2537,21,315,421,4210,442,4525
3036,2011-05-11,2,0,5,9,0,3,1,1,0.52,0.5,0.72,0.1343,21,315,182,1820,203,2135
3037,2011-05-11,2,0,5,10,0,3,1,1,0.54,0.5152,0.68,0.0896,30,450,124,1240,154,1690
3038,2011-05-11,2,0,5,11,0,3,1,1,0.56,0.5303,0.64,0.0896,18,270,123,1230,141,1500
3039,2011-05-11,2,0,5,12,0,3,1,1,0.6,0.6212,0.56,0.0,41,615,185,1850,226,2465
3040,2011-05-11,2,0,5,13,0,3,1,1,0.62,0.6212,0.5,0.0,36,540,157,1570,193,2110
3041,2011-05-11,2,0,5,14,0,3,1,1,0.62,0.6212,0.53,0.0896,36,540,141,1410,177,1950
3042,2011-05-11,2,0,5,15,0,3,1,1,0.64,0.6212,0.41,0.0,48,720,131,1310,179,2030
3043,2011-05-11,2,0,5,16,0,3,1,1,0.66,0.6212,0.39,0.0,49,735,240,2400,289,3135
3044,2011-05-11,2,0,5,17,0,3,1,1,0.64,0.6212,0.47,0.1045,17,255,242,2420,259,2675
3045,2011-05-11,2,0,5,18,0,3,1,1,0.62,0.6212,0.5,0.2985,40,600,234,2340,274,2940
3046,2011-05-11,2,0,5,19,0,3,1,1,0.56,0.5303,0.52,0.1343,60,900,341,3410,401,4310
3047,2011-05-11,2,0,5,20,0,3,1,1,0.54,0.5152,0.64,0.1343,28,420,245,2450,273,2870
3048,2011-05-11,2,0,5,21,0,3,1,1,0.54,0.5152,0.6,0.0,32,480,202,2020,234,2500
3049,2011-05-11,2,0,5,22,0,3,1,1,0.5,0.4848,0.72,0.2537,12,180,134,1340,146,1520
3050,2011-05-11,2,0,5,23,0,3,1,1,0.46,0.4545,0.88,0.2537,12,180,69,690,81,870
3051,2011-05-12,2,0,5,0,0,4,1,2,0.46,0.4545,0.88,0.2239,5,75,39,390,44,465
3052,2011-05-12,2,0,5,1,0,4,1,1,0.46,0.4545,0.88,0.2239,1,15,16,160,17,175
3053,2011-05-12,2,0,5,2,0,4,1,1,0.44,0.4394,0.94,0.194,1,15,14,140,15,155
3054,2011-05-12,2,0,5,3,0,4,1,1,0.44,0.4394,0.88,0.1343,0,0,5,50,5,50
3055,2011-05-12,2,0,5,4,0,4,1,1,0.42,0.4242,0.94,0.0,1,15,5,50,6,65
3056,2011-05-12,2,0,5,5,0,4,1,1,0.42,0.4242,0.94,0.1343,2,30,27,270,29,300
3057,2011-05-12,2,0,5,6,0,4,1,1,0.44,0.4394,0.88,0.0,9,135,103,1030,112,1165
3058,2011-05-12,2,0,5,7,0,4,1,1,0.46,0.4545,0.88,0.1343,14,210,283,2830,297,3040
3059,2011-05-12,2,0,5,8,0,4,1,1,0.48,0.4697,0.82,0.194,27,405,394,3940,421,4345
3060,2011-05-12,2,0,5,9,0,4,1,2,0.5,0.4848,0.77,0.2836,21,315,191,1910,212,2225
3061,2011-05-12,2,0,5,10,0,4,1,2,0.54,0.5152,0.68,0.2239,28,420,119,1190,147,1610
3062,2011-05-12,2,0,5,11,0,4,1,1,0.58,0.5455,0.6,0.2239,43,645,136,1360,179,2005
3063,2011-05-12,2,0,5,12,0,4,1,1,0.58,0.5455,0.6,0.2239,43,645,164,1640,207,2285
3064,2011-05-12,2,0,5,13,0,4,1,2,0.62,0.6212,0.57,0.2985,48,720,170,1700,218,2420
3065,2011-05-12,2,0,5,14,0,4,1,2,0.62,0.6061,0.61,0.2239,43,645,148,1480,191,2125
3066,2011-05-12,2,0,5,15,0,4,1,2,0.64,0.6212,0.53,0.2537,54,810,163,1630,217,2440
3067,2011-05-12,2,0,5,16,0,4,1,2,0.64,0.6212,0.57,0.2537,50,750,238,2380,288,3130
3068,2011-05-12,2,0,5,17,0,4,1,2,0.64,0.6212,0.57,0.194,54,810,540,5400,594,6210
3069,2011-05-12,2,0,5,18,0,4,1,1,0.62,0.6061,0.69,0.2239,64,960,463,4630,527,5590
3070,2011-05-12,2,0,5,19,0,4,1,2,0.6,0.6061,0.64,0.194,59,885,305,3050,364,3935
3071,2011-05-12,2,0,5,20,0,4,1,1,0.6,0.6061,0.64,0.194,56,840,220,2200,276,3040
3072,2011-05-12,2,0,5,21,0,4,1,1,0.56,0.5303,0.83,0.1343,31,465,192,1920,223,2385
3073,2011-05-12,2,0,5,22,0,4,1,1,0.54,0.5152,0.83,0.194,25,375,147,1470,172,1845
3074,2011-05-12,2,0,5,23,0,4,1,2,0.54,0.5152,0.77,0.194,16,240,87,870,103,1110
3075,2011-05-13,2,0,5,0,0,5,1,2,0.52,0.5,0.83,0.1642,6,90,46,460,52,550
3076,2011-05-13,2,0,5,1,0,5,1,1,0.52,0.5,0.83,0.1642,5,75,15,150,20,225
3077,2011-05-13,2,0,5,2,0,5,1,2,0.5,0.4848,0.88,0.1343,3,45,8,80,11,125
3078,2011-05-13,2,0,5,3,0,5,1,2,0.5,0.4848,0.88,0.1343,2,30,2,20,4,50
3079,2011-05-13,2,0,5,4,0,5,1,3,0.5,0.4848,0.88,0.1642,2,30,3,30,5,60
3080,2011-05-13,2,0,5,5,0,5,1,2,0.5,0.4848,0.88,0.194,1,15,24,240,25,255
3081,2011-05-13,2,0,5,6,0,5,1,3,0.5,0.4848,0.88,0.1343,6,90,76,760,82,850
3082,2011-05-13,2,0,5,7,0,5,1,3,0.5,0.4848,0.88,0.1642,16,240,141,1410,157,1650
3083,2011-05-13,2,0,5,8,0,5,1,2,0.5,0.4848,0.88,0.194,26,390,361,3610,387,4000
3084,2011-05-13,2,0,5,9,0,5,1,2,0.5,0.4848,0.88,0.194,18,270,215,2150,233,2420
3085,2011-05-13,2,0,5,10,0,5,1,2,0.52,0.5,0.83,0.1343,31,465,99,990,130,1455
3086,2011-05-13,2,0,5,11,0,5,1,2,0.52,0.5,0.83,0.1642,56,840,90,900,146,1740
3087,2011-05-13,2,0,5,12,0,5,1,2,0.52,0.5,0.88,0.194,53,795,170,1700,223,2495
3088,2011-05-13,2,0,5,13,0,5,1,2,0.52,0.5,0.88,0.3881,69,1035,157,1570,226,2605
3089,2011-05-13,2,0,5,14,0,5,1,2,0.52,0.5,0.87,0.2836,70,1050,120,1200,190,2250
3090,2011-05-13,2,0,5,15,0,5,1,2,0.52,0.5,0.88,0.1642,56,840,142,1420,198,2260
3091,2011-05-13,2,0,5,16,0,5,1,2,0.52,0.5,0.88,0.1343,44,660,256,2560,300,3220
3092,2011-05-13,2,0,5,17,0,5,1,3,0.52,0.5,0.88,0.1642,62,930,429,4290,491,5220
3093,2011-05-13,2,0,5,18,0,5,1,3,0.52,0.5,0.88,0.1642,39,585,359,3590,398,4175
3094,2011-05-13,2,0,5,19,0,5,1,2,0.52,0.5,0.83,0.194,25,375,245,2450,270,2825
3095,2011-05-13,2,0,5,20,0,5,1,2,0.52,0.5,0.83,0.1343,22,330,130,1300,152,1630
3096,2011-05-13,2,0,5,21,0,5,1,2,0.52,0.5,0.84,0.1642,24,360,130,1300,154,1660
3097,2011-05-13,2,0,5,22,0,5,1,2,0.52,0.5,0.83,0.2239,25,375,107,1070,132,1445
3098,2011-05-13,2,0,5,23,0,5,1,3,0.5,0.4848,0.88,0.1642,31,465,88,880,119,1345
3099,2011-05-14,2,0,5,0,0,6,0,2,0.5,0.4848,0.88,0.1343,24,360,78,780,102,1140
3100,2011-05-14,2,0,5,1,0,6,0,2,0.5,0.4848,0.88,0.1343,18,270,64,640,82,910
3101,2011-05-14,2,0,5,2,0,6,0,2,0.5,0.4848,0.88,0.1343,15,225,37,370,52,595
3102,2011-05-14,2,0,5,3,0,6,0,2,0.5,0.4848,0.88,0.1343,5,75,30,300,35,375
3103,2011-05-14,2,0,5,4,0,6,0,2,0.5,0.4848,0.82,0.1642,1,15,4,40,5,55
3104,2011-05-14,2,0,5,5,0,6,0,2,0.5,0.4848,0.82,0.1045,7,105,7,70,14,175
3105,2011-05-14,2,0,5,6,0,6,0,2,0.5,0.4848,0.88,0.1045,2,30,9,90,11,120
3106,2011-05-14,2,0,5,7,0,6,0,3,0.48,0.4697,1.0,0.0,4,60,28,280,32,340
3107,2011-05-14,2,0,5,8,0,6,0,3,0.5,0.4848,0.94,0.0,16,240,72,720,88,960
3108,2011-05-14,2,0,5,9,0,6,0,2,0.52,0.5,0.94,0.0896,14,210,86,860,100,1070
3109,2011-05-14,2,0,5,10,0,6,0,2,0.52,0.5,0.94,0.1642,34,510,133,1330,167,1840
3110,2011-05-14,2,0,5,11,0,6,0,2,0.52,0.5,0.94,0.1343,72,1080,207,2070,279,3150
3111,2011-05-14,2,0,5,12,0,6,0,3,0.52,0.5,1.0,0.0896,75,1125,204,2040,279,3165
3112,2011-05-14,2,0,5,13,0,6,0,3,0.52,0.5,1.0,0.0896,68,1020,180,1800,248,2820
3113,2011-05-14,2,0,5,14,0,6,0,2,0.54,0.5152,0.94,0.1343,57,855,159,1590,216,2445
3114,2011-05-14,2,0,5,15,0,6,0,2,0.54,0.5152,0.94,0.1642,73,1095,221,2210,294,3305
3115,2011-05-14,2,0,5,16,0,6,0,2,0.54,0.5152,0.94,0.194,107,1605,188,1880,295,3485
3116,2011-05-14,2,0,5,17,0,6,0,2,0.56,0.5303,0.88,0.194,78,1170,194,1940,272,3110
3117,2011-05-14,2,0,5,18,0,6,0,2,0.56,0.5303,0.88,0.2239,88,1320,216,2160,304,3480
3118,2011-05-14,2,0,5,19,0,6,0,3,0.54,0.5152,0.94,0.1343,69,1035,179,1790,248,2825
3119,2011-05-14,2,0,5,20,0,6,0,3,0.54,0.5152,0.94,0.1343,42,630,115,1150,157,1780
3120,2011-05-14,2,0,5,21,0,6,0,3,0.54,0.5152,0.94,0.2239,15,225,44,440,59,665
3121,2011-05-14,2,0,5,22,0,6,0,3,0.54,0.5152,0.94,0.1642,7,105,19,190,26,295
3122,2011-05-14,2,0,5,23,0,6,0,3,0.52,0.5,1.0,0.194,11,165,33,330,44,495
3123,2011-05-15,2,0,5,0,0,0,0,2,0.52,0.5,1.0,0.0,5,75,34,340,39,415
3124,2011-05-15,2,0,5,1,0,0,0,2,0.52,0.5,1.0,0.1045,4,60,43,430,47,490
3125,2011-05-15,2,0,5,2,0,0,0,2,0.52,0.5,1.0,0.1343,13,195,37,370,50,565
3126,2011-05-15,2,0,5,3,0,0,0,2,0.52,0.5,1.0,0.0,11,165,21,210,32,375
3127,2011-05-15,2,0,5,4,0,0,0,2,0.52,0.5,1.0,0.0,5,75,8,80,13,155
3128,2011-05-15,2,0,5,5,0,0,0,3,0.52,0.5,1.0,0.1045,3,45,11,110,14,155
3129,2011-05-15,2,0,5,6,0,0,0,2,0.52,0.5,1.0,0.1343,3,45,14,140,17,185
3130,2011-05-15,2,0,5,7,0,0,0,2,0.52,0.5,1.0,0.1343,4,60,38,380,42,440
3131,2011-05-15,2,0,5,8,0,0,0,2,0.54,0.5152,0.94,0.1343,24,360,46,460,70,820
3132,2011-05-15,2,0,5,9,0,0,0,1,0.58,0.5455,0.83,0.2537,36,540,98,980,134,1520
3133,2011-05-15,2,0,5,10,0,0,0,1,0.58,0.5455,0.83,0.2239,73,1095,153,1530,226,2625
3134,2011-05-15,2,0,5,11,0,0,0,1,0.6,0.5758,0.78,0.2239,120,1800,202,2020,322,3820
3135,2011-05-15,2,0,5,12,0,0,0,1,0.62,0.5909,0.73,0.2985,120,1800,247,2470,367,4270
3136,2011-05-15,2,0,5,13,0,0,0,1,0.62,0.5909,0.73,0.2836,195,2925,261,2610,456,5535
3137,2011-05-15,2,0,5,14,0,0,0,1,0.64,0.6061,0.73,0.194,183,2745,254,2540,437,5285
3138,2011-05-15,2,0,5,15,0,0,0,1,0.66,0.6212,0.69,0.2537,206,3090,253,2530,459,5620
3139,2011-05-15,2,0,5,16,0,0,0,1,0.64,0.6061,0.69,0.2537,158,2370,282,2820,440,5190
3140,2011-05-15,2,0,5,17,0,0,0,3,0.56,0.5303,0.78,0.3582,137,2055,255,2550,392,4605
3141,2011-05-15,2,0,5,18,0,0,0,1,0.56,0.5303,0.78,0.2537,60,900,177,1770,237,2670
3142,2011-05-15,2,0,5,19,0,0,0,1,0.56,0.5303,0.83,0.1045,78,1170,153,1530,231,2700
3143,2011-05-15,2,0,5,20,0,0,0,1,0.54,0.5152,0.88,0.0,53,795,138,1380,191,2175
3144,2011-05-15,2,0,5,21,0,0,0,1,0.54,0.5152,0.88,0.0,44,660,107,1070,151,1730
3145,2011-05-15,2,0,5,22,0,0,0,1,0.56,0.5303,0.83,0.0,29,435,88,880,117,1315
3146,2011-05-15,2,0,5,23,0,0,0,1,0.54,0.5152,0.88,0.2239,18,270,51,510,69,780
3147,2011-05-16,2,0,5,0,0,1,1,1,0.52,0.5,0.94,0.1045,17,255,21,210,38,465
3148,2011-05-16,2,0,5,1,0,1,1,1,0.52,0.5,0.94,0.1343,6,90,8,80,14,170
3149,2011-05-16,2,0,5,2,0,1,1,1,0.5,0.4848,1.0,0.0896,4,60,9,90,13,150
3150,2011-05-16,2,0,5,3,0,1,1,1,0.5,0.4848,0.94,0.1642,1,15,3,30,4,45
3151,2011-05-16,2,0,5,4,0,1,1,1,0.5,0.4848,1.0,0.1343,1,15,5,50,6,65
3152,2011-05-16,2,0,5,5,0,1,1,1,0.5,0.4848,0.93,0.194,1,15,20,200,21,215
3153,2011-05-16,2,0,5,6,0,1,1,1,0.52,0.5,0.88,0.1642,11,165,93,930,104,1095
3154,2011-05-16,2,0,5,7,0,1,1,1,0.52,0.5,0.83,0.2836,27,405,245,2450,272,2855
3155,2011-05-16,2,0,5,8,0,1,1,1,0.56,0.5303,0.73,0.2985,28,420,366,3660,394,4080
3156,2011-05-16,2,0,5,9,0,1,1,1,0.6,0.5909,0.69,0.194,38,570,156,1560,194,2130
3157,2011-05-16,2,0,5,10,0,1,1,1,0.62,0.6061,0.65,0.0896,37,555,75,750,112,1305
3158,2011-05-16,2,0,5,11,0,1,1,1,0.64,0.6212,0.57,0.0,56,840,129,1290,185,2130
3159,2011-05-16,2,0,5,12,0,1,1,1,0.66,0.6212,0.54,0.0896,72,1080,137,1370,209,2450
3160,2011-05-16,2,0,5,13,0,1,1,1,0.68,0.6364,0.51,0.0,61,915,153,1530,214,2445
3161,2011-05-16,2,0,5,14,0,1,1,1,0.68,0.6364,0.51,0.0,76,1140,117,1170,193,2310
3162,2011-05-16,2,0,5,15,0,1,1,1,0.72,0.6667,0.51,0.0,55,825,110,1100,165,1925
3163,2011-05-16,2,0,5,16,0,1,1,3,0.6,0.5758,0.78,0.2537,45,675,181,1810,226,2485
3164,2011-05-16,2,0,5,17,0,1,1,1,0.58,0.5455,0.88,0.2239,47,705,227,2270,274,2975
3165,2011-05-16,2,0,5,18,0,1,1,3,0.58,0.5455,0.83,0.194,55,825,398,3980,453,4805
3166,2011-05-16,2,0,5,19,0,1,1,1,0.58,0.5455,0.83,0.2537,36,540,272,2720,308,3260
3167,2011-05-16,2,0,5,20,0,1,1,1,0.58,0.5455,0.83,0.0,31,465,167,1670,198,2135
3168,2011-05-16,2,0,5,21,0,1,1,1,0.58,0.5455,0.83,0.0,28,420,149,1490,177,1910
3169,2011-05-16,2,0,5,22,0,1,1,1,0.56,0.5303,0.88,0.0896,22,330,105,1050,127,1380
3170,2011-05-16,2,0,5,23,0,1,1,1,0.56,0.5303,0.88,0.0896,18,270,39,390,57,660
3171,2011-05-17,2,0,5,0,0,2,1,2,0.56,0.5303,0.88,0.0,13,195,18,180,31,375
3172,2011-05-17,2,0,5,1,0,2,1,3,0.56,0.5303,0.88,0.0,7,105,6,60,13,165
3173,2011-05-17,2,0,5,2,0,2,1,3,0.56,0.5303,0.88,0.0,4,60,4,40,8,100
3174,2011-05-17,2,0,5,3,0,2,1,3,0.54,0.5152,0.94,0.2537,1,15,3,30,4,45
3175,2011-05-17,2,0,5,4,0,2,1,3,0.54,0.5152,0.94,0.2537,2,30,2,20,4,50
3176,2011-05-17,2,0,5,5,0,2,1,3,0.52,0.5,0.94,0.2537,0,0,22,220,22,220
3177,2011-05-17,2,0,5,6,0,2,1,3,0.52,0.5,0.94,0.2537,0,0,49,490,49,490
3178,2011-05-17,2,0,5,7,0,2,1,2,0.52,0.5,0.94,0.2537,13,195,138,1380,151,1575
3179,2011-05-17,2,0,5,8,0,2,1,2,0.52,0.5,0.94,0.2985,22,330,325,3250,347,3580
3180,2011-05-17,2,0,5,9,0,2,1,2,0.54,0.5152,0.88,0.2537,17,255,190,1900,207,2155
3181,2011-05-17,2,0,5,10,0,2,1,3,0.54,0.5152,0.88,0.2537,31,465,73,730,104,1195
3182,2011-05-17,2,0,5,11,0,2,1,2,0.56,0.5303,0.83,0.4179,26,390,104,1040,130,1430
3183,2011-05-17,2,0,5,12,0,2,1,3,0.56,0.5303,0.83,0.4179,38,570,115,1150,153,1720
3184,2011-05-17,2,0,5,13,0,2,1,2,0.56,0.5303,0.88,0.3284,31,465,141,1410,172,1875
3185,2011-05-17,2,0,5,14,0,2,1,1,0.62,0.5909,0.73,0.4627,61,915,123,1230,184,2145
3186,2011-05-17,2,0,5,15,0,2,1,1,0.62,0.6061,0.69,0.4478,79,1185,131,1310,210,2495
3187,2011-05-17,2,0,5,16,0,2,1,1,0.62,0.6061,0.61,0.3284,73,1095,217,2170,290,3265
3188,2011-05-17,2,0,5,17,0,2,1,1,0.62,0.6061,0.65,0.4179,83,1245,521,5210,604,6455
3189,2011-05-17,2,0,5,18,0,2,1,1,0.6,0.5909,0.69,0.2985,54,810,426,4260,480,5070
3190,2011-05-17,2,0,5,19,0,2,1,1,0.6,0.5909,0.69,0.2537,51,765,298,2980,349,3745
3191,2011-05-17,2,0,5,20,0,2,1,1,0.58,0.5455,0.83,0.4179,30,450,253,2530,283,2980
3192,2011-05-17,2,0,5,21,0,2,1,1,0.54,0.5152,0.88,0.2537,23,345,151,1510,174,1855
3193,2011-05-17,2,0,5,22,0,2,1,2,0.54,0.5152,0.88,0.2836,12,180,86,860,98,1040
3194,2011-05-17,2,0,5,23,0,2,1,2,0.54,0.5152,0.88,0.2537,7,105,49,490,56,595
3195,2011-05-18,2,0,5,0,0,3,1,2,0.54,0.5152,0.88,0.2239,8,120,15,150,23,270
3196,2011-05-18,2,0,5,1,0,3,1,2,0.54,0.5152,0.88,0.2537,3,45,9,90,12,135
3197,2011-05-18,2,0,5,2,0,3,1,3,0.52,0.5,0.94,0.2239,1,15,5,50,6,65
3198,2011-05-18,2,0,5,3,0,3,1,3,0.52,0.5,0.94,0.2985,6,90,3,30,9,120
3199,2011-05-18,2,0,5,4,0,3,1,3,0.52,0.5,0.94,0.2985,1,15,2,20,3,35
3200,2011-05-18,2,0,5,5,0,3,1,1,0.52,0.5,1.0,0.2239,0,0,9,90,9,90
3201,2011-05-18,2,0,5,6,0,3,1,1,0.52,0.5,1.0,0.1343,2,30,99,990,101,1020
3202,2011-05-18,2,0,5,7,0,3,1,1,0.54,0.5152,0.88,0.194,14,210,260,2600,274,2810
3203,2011-05-18,2,0,5,8,0,3,1,1,0.56,0.5303,0.88,0.2836,25,375,428,4280,453,4655
3204,2011-05-18,2,0,5,9,0,3,1,3,0.56,0.5303,0.83,0.2537,26,390,176,1760,202,2150
3205,2011-05-18,2,0,5,10,0,3,1,3,0.54,0.5152,0.88,0.2836,33,495,73,730,106,1225
3206,2011-05-18,2,0,5,11,0,3,1,2,0.54,0.5152,0.94,0.0896,6,90,17,170,23,260
3207,2011-05-18,2,0,5,12,0,3,1,1,0.56,0.5303,0.94,0.2985,12,180,42,420,54,600
3208,2011-05-18,2,0,5,13,0,3,1,2,0.56,0.5303,0.83,0.3284,30,450,92,920,122,1370
3209,2011-05-18,2,0,5,14,0,3,1,2,0.58,0.5455,0.78,0.2836,44,660,94,940,138,1600
3210,2011-05-18,2,0,5,15,0,3,1,1,0.6,0.5758,0.78,0.2537,34,510,133,1330,167,1840
3211,2011-05-18,2,0,5,16,0,3,1,1,0.6,0.5909,0.73,0.194,53,795,241,2410,294,3205
3212,2011-05-18,2,0,5,17,0,3,1,1,0.6,0.5909,0.69,0.1343,78,1170,487,4870,565,6040
3213,2011-05-18,2,0,5,18,0,3,1,1,0.6,0.5909,0.73,0.2239,58,870,431,4310,489,5180
3214,2011-05-18,2,0,5,19,0,3,1,3,0.56,0.5303,0.88,0.1343,43,645,288,2880,331,3525
3215,2011-05-18,2,0,5,20,0,3,1,3,0.56,0.5303,0.88,0.1343,24,360,189,1890,213,2250
3216,2011-05-18,2,0,5,21,0,3,1,1,0.52,0.5,0.88,0.0,11,165,74,740,85,905
3217,2011-05-18,2,0,5,22,0,3,1,1,0.52,0.5,0.83,0.0,14,210,103,1030,117,1240
3218,2011-05-18,2,0,5,23,0,3,1,1,0.52,0.5,0.94,0.0896,10,150,49,490,59,640
3219,2011-05-19,2,0,5,0,0,4,1,1,0.52,0.5,0.94,0.1045,6,90,23,230,29,320
3220,2011-05-19,2,0,5,1,0,4,1,1,0.5,0.4848,0.94,0.0,2,30,4,40,6,70
3221,2011-05-19,2,0,5,2,0,4,1,1,0.5,0.4848,0.94,0.0,3,45,12,120,15,165
3222,2011-05-19,2,0,5,3,0,4,1,1,0.48,0.4697,1.0,0.0,1,15,3,30,4,45
3223,2011-05-19,2,0,5,4,0,4,1,1,0.48,0.4697,0.94,0.0,2,30,3,30,5,60
3224,2011-05-19,2,0,5,5,0,4,1,1,0.48,0.4697,0.94,0.0,2,30,24,240,26,270
3225,2011-05-19,2,0,5,6,0,4,1,2,0.5,0.4848,0.94,0.0,17,255,86,860,103,1115
3226,2011-05-19,2,0,5,7,0,4,1,2,0.5,0.4848,1.0,0.0,18,270,239,2390,257,2660
3227,2011-05-19,2,0,5,8,0,4,1,2,0.52,0.5,0.88,0.0,34,510,453,4530,487,5040
3228,2011-05-19,2,0,5,9,0,4,1,2,0.54,0.5152,0.88,0.0896,40,600,176,1760,216,2360
3229,2011-05-19,2,0,5,10,0,4,1,2,0.54,0.5152,0.83,0.0,35,525,95,950,130,1475
3230,2011-05-19,2,0,5,11,0,4,1,3,0.54,0.5152,0.88,0.1642,53,795,111,1110,164,1905
3231,2011-05-19,2,0,5,12,0,4,1,2,0.58,0.5455,0.78,0.1045,38,570,130,1300,168,1870
3232,2011-05-19,2,0,5,13,0,4,1,3,0.58,0.5455,0.64,0.2537,44,660,139,1390,183,2050
3233,2011-05-19,2,0,5,14,0,4,1,3,0.54,0.5152,0.73,0.194,43,645,137,1370,180,2015
3234,2011-05-19,2,0,5,15,0,4,1,1,0.56,0.5303,0.78,0.1642,63,945,125,1250,188,2195
3235,2011-05-19,2,0,5,16,0,4,1,1,0.58,0.5455,0.64,0.194,55,825,247,2470,302,3295
3236,2011-05-19,2,0,5,17,0,4,1,1,0.56,0.5303,0.78,0.1642,60,900,487,4870,547,5770
3237,2011-05-19,2,0,5,18,0,4,1,1,0.6,0.6212,0.55,0.1642,59,885,454,4540,513,5425
3238,2011-05-19,2,0,5,19,0,4,1,1,0.58,0.5455,0.6,0.1343,65,975,345,3450,410,4425
3239,2011-05-19,2,0,5,20,0,4,1,1,0.54,0.5152,0.77,0.2836,46,690,236,2360,282,3050
3240,2011-05-19,2,0,5,21,0,4,1,1,0.54,0.5152,0.77,0.2836,29,435,180,1800,209,2235
3241,2011-05-19,2,0,5,22,0,4,1,3,0.5,0.4848,0.82,0.2985,11,165,68,680,79,845
3242,2011-05-19,2,0,5,23,0,4,1,1,0.48,0.4697,0.94,0.0,9,135,63,630,72,765
3243,2011-05-20,2,0,5,0,0,5,1,1,0.46,0.4545,0.94,0.0896,15,225,33,330,48,555
3244,2011-05-20,2,0,5,1,0,5,1,1,0.46,0.4545,1.0,0.0,8,120,17,170,25,290
3245,2011-05-20,2,0,5,2,0,5,1,1,0.44,0.4394,1.0,0.0896,4,60,4,40,8,100
3246,2011-05-20,2,0,5,3,0,5,1,1,0.44,0.4394,1.0,0.0,1,15,4,40,5,55
3247,2011-05-20,2,0,5,4,0,5,1,1,0.44,0.4394,0.94,0.0896,1,15,4,40,5,55
3248,2011-05-20,2,0,5,5,0,5,1,1,0.44,0.4394,0.94,0.1045,0,0,28,280,28,280
3249,2011-05-20,2,0,5,6,0,5,1,1,0.46,0.4545,0.88,0.1045,15,225,102,1020,117,1245
3250,2011-05-20,2,0,5,7,0,5,1,1,0.5,0.4848,0.77,0.1642,30,450,289,2890,319,3340
3251,2011-05-20,2,0,5,8,0,5,1,1,0.54,0.5152,0.68,0.0,41,615,476,4760,517,5375
3252,2011-05-20,2,0,5,9,0,5,1,1,0.54,0.5152,0.68,0.2239,35,525,199,1990,234,2515
3253,2011-05-20,2,0,5,10,0,5,1,1,0.56,0.5303,0.64,0.194,44,660,104,1040,148,1700
3254,2011-05-20,2,0,5,11,0,5,1,2,0.58,0.5455,0.6,0.194,63,945,133,1330,196,2275
3255,2011-05-20,2,0,5,12,0,5,1,2,0.6,0.6212,0.56,0.2537,69,1035,186,1860,255,2895
3256,2011-05-20,2,0,5,13,0,5,1,3,0.6,0.6212,0.56,0.2836,60,900,172,1720,232,2620
3257,2011-05-20,2,0,5,14,0,5,1,1,0.62,0.6212,0.53,0.2239,66,990,131,1310,197,2300
3258,2011-05-20,2,0,5,15,0,5,1,2,0.6,0.6212,0.56,0.194,74,1110,168,1680,242,2790
3259,2011-05-20,2,0,5,16,0,5,1,2,0.6,0.6212,0.53,0.1642,61,915,269,2690,330,3605
3260,2011-05-20,2,0,5,17,0,5,1,1,0.62,0.6212,0.53,0.0,71,1065,483,4830,554,5895
3261,2011-05-20,2,0,5,18,0,5,1,1,0.6,0.6212,0.56,0.1642,79,1185,394,3940,473,5125
3262,2011-05-20,2,0,5,19,0,5,1,1,0.58,0.5455,0.64,0.0896,49,735,253,2530,302,3265
3263,2011-05-20,2,0,5,20,0,5,1,1,0.58,0.5455,0.64,0.1045,40,600,180,1800,220,2400
3264,2011-05-20,2,0,5,21,0,5,1,1,0.56,0.5303,0.64,0.1045,40,600,155,1550,195,2150
3265,2011-05-20,2,0,5,22,0,5,1,1,0.54,0.5152,0.73,0.0,28,420,124,1240,152,1660
3266,2011-05-20,2,0,5,23,0,5,1,1,0.52,0.5,0.72,0.1642,15,225,100,1000,115,1225
3267,2011-05-21,2,0,5,0,0,6,0,1,0.52,0.5,0.77,0.1045,20,300,78,780,98,1080
3268,2011-05-21,2,0,5,1,0,6,0,1,0.52,0.5,0.72,0.0,8,120,64,640,72,760
3269,2011-05-21,2,0,5,2,0,6,0,1,0.52,0.5,0.72,0.1045,5,75,35,350,40,425
3270,2011-05-21,2,0,5,3,0,6,0,1,0.48,0.4697,0.82,0.1045,7,105,12,120,19,225
3271,2011-05-21,2,0,5,4,0,6,0,1,0.46,0.4545,0.88,0.1343,1,15,6,60,7,75
3272,2011-05-21,2,0,5,5,0,6,0,1,0.46,0.4545,0.88,0.1045,1,15,4,40,5,55
3273,2011-05-21,2,0,5,6,0,6,0,1,0.5,0.4848,0.82,0.1343,6,90,22,220,28,310
3274,2011-05-21,2,0,5,7,0,6,0,1,0.54,0.5152,0.73,0.1343,10,150,33,330,43,480
3275,2011-05-21,2,0,5,8,0,6,0,1,0.56,0.5303,0.68,0.2836,29,435,97,970,126,1405
3276,2011-05-21,2,0,5,9,0,6,0,1,0.6,0.6061,0.64,0.2239,60,900,165,1650,225,2550
3277,2011-05-21,2,0,5,10,0,6,0,1,0.62,0.6061,0.61,0.1045,122,1830,201,2010,323,3840
3278,2011-05-21,2,0,5,11,0,6,0,1,0.64,0.6212,0.53,0.1343,173,2595,245,2450,418,5045
3279,2011-05-21,2,0,5,12,0,6,0,1,0.66,0.6212,0.5,0.0,222,3330,271,2710,493,6040
3280,2011-05-21,2,0,5,13,0,6,0,1,0.7,0.6364,0.45,0.0,191,2865,271,2710,462,5575
3281,2011-05-21,2,0,5,14,0,6,0,1,0.72,0.6515,0.42,0.0,187,2805,269,2690,456,5495
3282,2011-05-21,2,0,5,15,0,6,0,1,0.72,0.6515,0.45,0.2537,232,3480,274,2740,506,6220
3283,2011-05-21,2,0,5,16,0,6,0,2,0.72,0.6515,0.39,0.2537,204,3060,267,2670,471,5730
3284,2011-05-21,2,0,5,17,0,6,0,2,0.72,0.6515,0.42,0.1642,191,2865,253,2530,444,5395
3285,2011-05-21,2,0,5,18,0,6,0,2,0.7,0.6364,0.45,0.1642,191,2865,253,2530,444,5395
3286,2011-05-21,2,0,5,19,0,6,0,1,0.68,0.6364,0.47,0.1642,117,1755,184,1840,301,3595
3287,2011-05-21,2,0,5,20,0,6,0,1,0.62,0.6061,0.61,0.0,84,1260,164,1640,248,2900
3288,2011-05-21,2,0,5,21,0,6,0,1,0.62,0.6061,0.61,0.1045,77,1155,150,1500,227,2655
3289,2011-05-21,2,0,5,22,0,6,0,1,0.6,0.5909,0.69,0.1343,78,1170,126,1260,204,2430
3290,2011-05-21,2,0,5,23,0,6,0,1,0.58,0.5455,0.78,0.0896,42,630,103,1030,145,1660
3291,2011-05-22,2,0,5,0,0,0,0,1,0.54,0.5152,0.88,0.1642,31,465,100,1000,131,1465
3292,2011-05-22,2,0,5,1,0,0,0,1,0.52,0.5,0.94,0.1343,17,255,81,810,98,1065
3293,2011-05-22,2,0,5,2,0,0,0,1,0.52,0.5,0.94,0.1045,18,270,50,500,68,770
3294,2011-05-22,2,0,5,3,0,0,0,1,0.5,0.4848,1.0,0.1045,10,150,23,230,33,380
3295,2011-05-22,2,0,5,4,0,0,0,1,0.5,0.4848,1.0,0.0,3,45,9,90,12,135
3296,2011-05-22,2,0,5,5,0,0,0,1,0.5,0.4848,1.0,0.1045,1,15,5,50,6,65
3297,2011-05-22,2,0,5,6,0,0,0,1,0.52,0.5,0.94,0.1045,5,75,13,130,18,205
3298,2011-05-22,2,0,5,7,0,0,0,1,0.54,0.5152,0.88,0.1045,13,195,27,270,40,465
3299,2011-05-22,2,0,5,8,0,0,0,1,0.6,0.5909,0.73,0.0896,29,435,65,650,94,1085
3300,2011-05-22,2,0,5,9,0,0,0,1,0.62,0.6061,0.69,0.1045,59,885,130,1300,189,2185
3301,2011-05-22,2,0,5,10,0,0,0,1,0.64,0.6061,0.65,0.1343,135,2025,170,1700,305,3725
3302,2011-05-22,2,0,5,11,0,0,0,1,0.7,0.6515,0.54,0.194,164,2460,209,2090,373,4550
3303,2011-05-22,2,0,5,12,0,0,0,2,0.72,0.6667,0.51,0.194,146,2190,255,2550,401,4740
3304,2011-05-22,2,0,5,13,0,0,0,2,0.66,0.6212,0.54,0.2239,180,2700,275,2750,455,5450
3305,2011-05-22,2,0,5,14,0,0,0,3,0.62,0.6061,0.69,0.194,125,1875,191,1910,316,3785
3306,2011-05-22,2,0,5,15,0,0,0,2,0.66,0.6212,0.61,0.1642,110,1650,221,2210,331,3860
3307,2011-05-22,2,0,5,16,0,0,0,1,0.68,0.6364,0.61,0.1343,72,1080,201,2010,273,3090
3308,2011-05-22,2,0,5,17,0,0,0,1,0.7,0.6515,0.58,0.2537,93,1395,213,2130,306,3525
3309,2011-05-22,2,0,5,18,0,0,0,1,0.66,0.6212,0.61,0.2239,120,1800,238,2380,358,4180
3310,2011-05-22,2,0,5,19,0,0,0,1,0.66,0.6212,0.61,0.194,107,1605,193,1930,300,3535
3311,2011-05-22,2,0,5,20,0,0,0,1,0.64,0.6061,0.65,0.1642,57,855,174,1740,231,2595
3312,2011-05-22,2,0,5,21,0,0,0,1,0.62,0.5909,0.73,0.194,27,405,109,1090,136,1495
3313,2011-05-22,2,0,5,22,0,0,0,1,0.6,0.5606,0.83,0.1343,35,525,86,860,121,1385
3314,2011-05-22,2,0,5,23,0,0,0,2,0.58,0.5455,0.83,0.1343,19,285,46,460,65,745
3315,2011-05-23,2,0,5,0,0,1,1,2,0.56,0.5303,0.88,0.1343,23,345,18,180,41,525
3316,2011-05-23,2,0,5,1,0,1,1,1,0.56,0.5303,0.88,0.1045,4,60,5,50,9,110
3317,2011-05-23,2,0,5,2,0,1,1,3,0.56,0.5303,0.88,0.1642,2,30,3,30,5,60
3318,2011-05-23,2,0,5,3,0,1,1,3,0.54,0.5152,0.94,0.1642,0,0,4,40,4,40
3319,2011-05-23,2,0,5,4,0,1,1,2,0.54,0.5152,0.94,0.0,2,30,2,20,4,50
3320,2011-05-23,2,0,5,5,0,1,1,2,0.54,0.5152,0.94,0.0,0,0,11,110,11,110
3321,2011-05-23,2,0,5,6,0,1,1,2,0.54,0.5152,1.0,0.0,4,60,92,920,96,980
3322,2011-05-23,2,0,5,7,0,1,1,2,0.56,0.5303,0.94,0.1045,13,195,223,2230,236,2425
3323,2011-05-23,2,0,5,8,0,1,1,1,0.6,0.5455,0.88,0.194,50,750,359,3590,409,4340
3324,2011-05-23,2,0,5,9,0,1,1,1,0.6,0.5455,0.88,0.2239,36,540,131,1310,167,1850
3325,2011-05-23,2,0,5,10,0,1,1,1,0.66,0.6212,0.74,0.2985,49,735,72,720,121,1455
3326,2011-05-23,2,0,5,11,0,1,1,1,0.68,0.6364,0.69,0.3881,73,1095,107,1070,180,2165
3327,2011-05-23,2,0,5,12,0,1,1,1,0.68,0.6364,0.69,0.3881,65,975,139,1390,204,2365
3328,2011-05-23,2,0,5,13,0,1,1,2,0.74,0.6818,0.58,0.4179,49,735,155,1550,204,2285
3329,2011-05-23,2,0,5,14,0,1,1,2,0.72,0.6818,0.62,0.5224,57,855,130,1300,187,2155
3330,2011-05-23,2,0,5,15,0,1,1,2,0.72,0.6818,0.62,0.4478,57,855,119,1190,176,2045
3331,2011-05-23,2,0,5,16,0,1,1,2,0.72,0.6818,0.62,0.2985,56,840,223,2230,279,3070
3332,2011-05-23,2,0,5,17,0,1,1,3,0.72,0.6818,0.7,0.3881,56,840,373,3730,429,4570
3333,2011-05-23,2,0,5,18,0,1,1,1,0.7,0.6667,0.74,0.2836,68,1020,385,3850,453,4870
3334,2011-05-23,2,0,5,19,0,1,1,1,0.7,0.6667,0.74,0.2239,56,840,302,3020,358,3860
3335,2011-05-23,2,0,5,20,0,1,1,1,0.64,0.5758,0.83,0.2239,39,585,271,2710,310,3295
3336,2011-05-23,2,0,5,21,0,1,1,1,0.64,0.5758,0.89,0.2239,33,495,155,1550,188,2045
3337,2011-05-23,2,0,5,22,0,1,1,1,0.62,0.5455,0.94,0.2239,25,375,106,1060,131,1435
3338,2011-05-23,2,0,5,23,0,1,1,2,0.62,0.5606,0.88,0.194,19,285,53,530,72,815
3339,2011-05-24,2,0,5,0,0,2,1,2,0.6,0.5152,0.94,0.194,12,180,23,230,35,410
3340,2011-05-24,2,0,5,1,0,2,1,2,0.6,0.5152,0.94,0.1642,6,90,9,90,15,180
3341,2011-05-24,2,0,5,2,0,2,1,2,0.6,0.5152,0.94,0.194,2,30,8,80,10,110
3342,2011-05-24,2,0,5,3,0,2,1,2,0.58,0.5455,0.94,0.1045,0,0,2,20,2,20
3343,2011-05-24,2,0,5,4,0,2,1,1,0.6,0.5455,0.88,0.1045,1,15,3,30,4,45
3344,2011-05-24,2,0,5,5,0,2,1,2,0.58,0.5455,0.94,0.2537,2,30,22,220,24,250
3345,2011-05-24,2,0,5,6,0,2,1,2,0.58,0.5455,0.94,0.194,10,150,102,1020,112,1170
3346,2011-05-24,2,0,5,7,0,2,1,3,0.64,0.5909,0.78,0.194,26,390,288,2880,314,3270
3347,2011-05-24,2,0,5,8,0,2,1,3,0.62,0.5758,0.83,0.2239,31,465,403,4030,434,4495
3348,2011-05-24,2,0,5,9,0,2,1,2,0.64,0.6061,0.73,0.194,27,405,111,1110,138,1515
3349,2011-05-24,2,0,5,10,0,2,1,1,0.7,0.6515,0.61,0.3284,18,270,90,900,108,1170
3350,2011-05-24,2,0,5,11,0,2,1,1,0.74,0.6667,0.51,0.2239,33,495,142,1420,175,1915
3351,2011-05-24,2,0,5,12,0,2,1,1,0.76,0.6818,0.45,0.3881,41,615,129,1290,170,1905
3352,2011-05-24,2,0,5,13,0,2,1,1,0.78,0.697,0.46,0.2537,38,570,152,1520,190,2090
3353,2011-05-24,2,0,5,14,0,2,1,1,0.78,0.697,0.46,0.2836,27,405,126,1260,153,1665
3354,2011-05-24,2,0,5,15,0,2,1,3,0.74,0.6818,0.55,0.4179,59,885,129,1290,188,2175
3355,2011-05-24,2,0,5,16,0,2,1,1,0.66,0.6212,0.69,0.194,52,780,225,2250,277,3030
3356,2011-05-24,2,0,5,17,0,2,1,1,0.7,0.6515,0.61,0.1045,56,840,492,4920,548,5760
3357,2011-05-24,2,0,5,18,0,2,1,1,0.7,0.6515,0.7,0.194,74,1110,490,4900,564,6010
3358,2011-05-24,2,0,5,19,0,2,1,1,0.66,0.6212,0.74,0.194,45,675,310,3100,355,3775
3359,2011-05-24,2,0,5,20,0,2,1,1,0.66,0.6212,0.74,0.0896,39,585,241,2410,280,2995
3360,2011-05-24,2,0,5,21,0,2,1,1,0.64,0.5909,0.78,0.0896,21,315,168,1680,189,1995
3361,2011-05-24,2,0,5,22,0,2,1,3,0.62,0.5606,0.88,0.2239,26,390,115,1150,141,1540
3362,2011-05-24,2,0,5,23,0,2,1,3,0.66,0.6212,0.74,0.1642,13,195,53,530,66,725
3363,2011-05-25,2,0,5,0,0,3,1,3,0.6,0.5606,0.83,0.2239,3,45,32,320,35,365
3364,2011-05-25,2,0,5,1,0,3,1,3,0.58,0.5455,0.83,0.194,6,90,2,20,8,110
3365,2011-05-25,2,0,5,2,0,3,1,2,0.56,0.5303,0.94,0.0,0,0,8,80,8,80
3366,2011-05-25,2,0,5,3,0,3,1,1,0.54,0.5152,1.0,0.1343,0,0,9,90,9,90
3367,2011-05-25,2,0,5,4,0,3,1,1,0.54,0.5152,1.0,0.1045,0,0,3,30,3,30
3368,2011-05-25,2,0,5,5,0,3,1,1,0.56,0.5303,0.88,0.0896,2,30,23,230,25,260
3369,2011-05-25,2,0,5,6,0,3,1,1,0.56,0.5303,0.94,0.0896,4,60,113,1130,117,1190
3370,2011-05-25,2,0,5,7,0,3,1,1,0.62,0.5909,0.73,0.1343,29,435,284,2840,313,3275
3371,2011-05-25,2,0,5,8,0,3,1,1,0.64,0.6061,0.69,0.2239,36,540,495,4950,531,5490
3372,2011-05-25,2,0,5,9,0,3,1,1,0.68,0.6364,0.65,0.0896,27,405,207,2070,234,2475
3373,2011-05-25,2,0,5,10,0,3,1,1,0.7,0.6515,0.61,0.0896,30,450,105,1050,135,1500
3374,2011-05-25,2,0,5,11,0,3,1,1,0.74,0.6667,0.51,0.0896,36,540,104,1040,140,1580
3375,2011-05-25,2,0,5,12,0,3,1,1,0.74,0.6818,0.55,0.1343,32,480,178,1780,210,2260
3376,2011-05-25,2,0,5,13,0,3,1,1,0.74,0.6818,0.55,0.1343,39,585,163,1630,202,2215
3377,2011-05-25,2,0,5,14,0,3,1,1,0.74,0.6818,0.55,0.1642,47,705,121,1210,168,1915
3378,2011-05-25,2,0,5,15,0,3,1,1,0.76,0.697,0.52,0.2537,37,555,145,1450,182,2005
3379,2011-05-25,2,0,5,16,0,3,1,1,0.74,0.6667,0.51,0.2836,61,915,238,2380,299,3295
3380,2011-05-25,2,0,5,17,0,3,1,1,0.74,0.6667,0.51,0.2239,77,1155,524,5240,601,6395
3381,2011-05-25,2,0,5,18,0,3,1,1,0.72,0.6667,0.58,0.2239,66,990,451,4510,517,5500
3382,2011-05-25,2,0,5,19,0,3,1,1,0.7,0.6515,0.61,0.1343,73,1095,332,3320,405,4415
3383,2011-05-25,2,0,5,20,0,3,1,1,0.7,0.6515,0.61,0.1642,56,840,284,2840,340,3680
3384,2011-05-25,2,0,5,21,0,3,1,1,0.66,0.6212,0.69,0.1343,33,495,203,2030,236,2525
3385,2011-05-25,2,0,5,22,0,3,1,1,0.66,0.6212,0.69,0.2537,34,510,140,1400,174,1910
3386,2011-05-25,2,0,5,23,0,3,1,1,0.64,0.6061,0.73,0.1343,12,180,74,740,86,920
3387,2011-05-26,2,0,5,0,0,4,1,1,0.64,0.6061,0.73,0.1343,11,165,34,340,45,505
3388,2011-05-26,2,0,5,1,0,4,1,1,0.64,0.6061,0.73,0.1343,3,45,13,130,16,175
3389,2011-05-26,2,0,5,2,0,4,1,1,0.62,0.5758,0.83,0.1045,7,105,7,70,14,175
3390,2011-05-26,2,0,5,3,0,4,1,1,0.6,0.5455,0.88,0.0896,0,0,4,40,4,40
3391,2011-05-26,2,0,5,4,0,4,1,1,0.6,0.5455,0.88,0.0,0,0,2,20,2,20
3392,2011-05-26,2,0,5,5,0,4,1,2,0.6,0.5455,0.88,0.0896,2,30,25,250,27,280
3393,2011-05-26,2,0,5,6,0,4,1,2,0.6,0.5,1.0,0.0896,4,60,94,940,98,1000
3394,2011-05-26,2,0,5,7,0,4,1,2,0.62,0.5455,0.94,0.2537,16,240,270,2700,286,2940
3395,2011-05-26,2,0,5,8,0,4,1,2,0.66,0.6061,0.83,0.1642,31,465,458,4580,489,5045
3396,2011-05-26,2,0,5,9,0,4,1,1,0.72,0.6818,0.7,0.1642,22,330,194,1940,216,2270
3397,2011-05-26,2,0,5,10,0,4,1,1,0.7,0.6667,0.74,0.2836,49,735,94,940,143,1675
3398,2011-05-26,2,0,5,11,0,4,1,1,0.74,0.697,0.66,0.2239,36,540,124,1240,160,1780
3399,2011-05-26,2,0,5,12,0,4,1,1,0.78,0.7424,0.59,0.3284,53,795,141,1410,194,2205
3400,2011-05-26,2,0,5,13,0,4,1,1,0.82,0.7727,0.52,0.2836,52,780,145,1450,197,2230
3401,2011-05-26,2,0,5,14,0,4,1,1,0.82,0.7727,0.52,0.2836,44,660,145,1450,189,2110
3402,2011-05-26,2,0,5,15,0,4,1,2,0.82,0.7576,0.46,0.2836,40,600,101,1010,141,1610
3403,2011-05-26,2,0,5,16,0,4,1,2,0.8,0.7424,0.49,0.3582,58,870,233,2330,291,3200
3404,2011-05-26,2,0,5,17,0,4,1,1,0.8,0.7273,0.46,0.2836,49,735,445,4450,494,5185
3405,2011-05-26,2,0,5,18,0,4,1,1,0.8,0.7273,0.46,0.3284,74,1110,404,4040,478,5150
3406,2011-05-26,2,0,5,19,0,4,1,1,0.78,0.697,0.46,0.3284,67,1005,311,3110,378,4115
3407,2011-05-26,2,0,5,20,0,4,1,1,0.72,0.6667,0.58,0.1642,55,825,267,2670,322,3495
3408,2011-05-26,2,0,5,21,0,4,1,1,0.72,0.6818,0.62,0.0896,45,675,178,1780,223,2455
3409,2011-05-26,2,0,5,22,0,4,1,1,0.7,0.6515,0.65,0.1343,23,345,157,1570,180,1915
3410,2011-05-26,2,0,5,23,0,4,1,1,0.7,0.6515,0.65,0.194,17,255,73,730,90,985
3411,2011-05-27,2,0,5,0,0,5,1,1,0.68,0.6364,0.69,0.2537,14,210,55,550,69,760
3412,2011-05-27,2,0,5,1,0,5,1,1,0.7,0.6515,0.58,0.2985,14,210,36,360,50,570
3413,2011-05-27,2,0,5,2,0,5,1,1,0.68,0.6364,0.61,0.2239,6,90,12,120,18,210
3414,2011-05-27,2,0,5,3,0,5,1,1,0.66,0.6212,0.65,0.0896,1,15,11,110,12,125
3415,2011-05-27,2,0,5,4,0,5,1,1,0.64,0.6061,0.69,0.1343,2,30,5,50,7,80
3416,2011-05-27,2,0,5,5,0,5,1,1,0.64,0.6061,0.65,0.2836,2,30,29,290,31,320
3417,2011-05-27,2,0,5,6,0,5,1,1,0.64,0.6061,0.69,0.0896,8,120,73,730,81,850
3418,2011-05-27,2,0,5,7,0,5,1,1,0.64,0.6061,0.73,0.1642,20,300,229,2290,249,2590
3419,2011-05-27,2,0,5,8,0,5,1,1,0.66,0.6212,0.74,0.2836,25,375,393,3930,418,4305
3420,2011-05-27,2,0,5,9,0,5,1,1,0.7,0.6515,0.65,0.2836,37,555,190,1900,227,2455
3421,2011-05-27,2,0,5,10,0,5,1,1,0.72,0.6667,0.54,0.3881,42,630,111,1110,153,1740
3422,2011-05-27,2,0,5,11,0,5,1,2,0.74,0.6818,0.55,0.3284,40,600,126,1260,166,1860
3423,2011-05-27,2,0,5,12,0,5,1,2,0.76,0.697,0.55,0.2985,53,795,190,1900,243,2695
3424,2011-05-27,2,0,5,13,0,5,1,1,0.74,0.6818,0.58,0.194,51,765,158,1580,209,2345
3425,2011-05-27,2,0,5,14,0,5,1,1,0.76,0.697,0.55,0.2537,51,765,188,1880,239,2645
3426,2011-05-27,2,0,5,15,0,5,1,1,0.78,0.7121,0.49,0.2836,98,1470,258,2580,356,4050
3427,2011-05-27,2,0,5,16,0,5,1,2,0.76,0.697,0.55,0.3881,63,945,356,3560,419,4505
3428,2011-05-27,2,0,5,17,0,5,1,1,0.74,0.6818,0.58,0.3881,77,1155,414,4140,491,5295
3429,2011-05-27,2,0,5,18,0,5,1,2,0.72,0.6818,0.62,0.2985,89,1335,310,3100,399,4435
3430,2011-05-27,2,0,5,19,0,5,1,3,0.6,0.5758,0.78,0.2537,69,1035,210,2100,279,3135
3431,2011-05-27,2,0,5,20,0,5,1,2,0.62,0.5909,0.73,0.2239,24,360,120,1200,144,1560
3432,2011-05-27,2,0,5,21,0,5,1,1,0.6,0.5606,0.83,0.1045,37,555,114,1140,151,1695
3433,2011-05-27,2,0,5,22,0,5,1,1,0.6,0.5758,0.78,0.1343,25,375,116,1160,141,1535
3434,2011-05-27,2,0,5,23,0,5,1,1,0.58,0.5455,0.88,0.1343,23,345,104,1040,127,1385
3435,2011-05-28,2,0,5,0,0,6,0,1,0.58,0.5455,0.88,0.1343,15,225,79,790,94,1015
3436,2011-05-28,2,0,5,1,0,6,0,1,0.58,0.5455,0.88,0.194,8,120,47,470,55,590
3437,2011-05-28,2,0,5,2,0,6,0,1,0.56,0.5303,0.94,0.194,13,195,35,350,48,545
3438,2011-05-28,2,0,5,3,0,6,0,1,0.56,0.5303,0.88,0.2239,2,30,13,130,15,160
3439,2011-05-28,2,0,5,4,0,6,0,1,0.56,0.5303,0.88,0.2537,0,0,4,40,4,40
3440,2011-05-28,2,0,5,5,0,6,0,1,0.56,0.5303,0.88,0.2239,4,60,3,30,7,90
3441,2011-05-28,2,0,5,6,0,6,0,1,0.58,0.5455,0.83,0.2537,3,45,16,160,19,205
3442,2011-05-28,2,0,5,7,0,6,0,1,0.6,0.5606,0.83,0.2537,17,255,33,330,50,585
3443,2011-05-28,2,0,5,8,0,6,0,1,0.62,0.5909,0.78,0.194,27,405,75,750,102,1155
3444,2011-05-28,2,0,5,9,0,6,0,1,0.64,0.6061,0.73,0.2537,61,915,116,1160,177,2075
3445,2011-05-28,2,0,5,10,0,6,0,1,0.7,0.6515,0.65,0.2239,110,1650,166,1660,276,3310
3446,2011-05-28,2,0,5,11,0,6,0,1,0.7,0.6515,0.65,0.2239,171,2565,178,1780,349,4345
3447,2011-05-28,2,0,5,12,0,6,0,1,0.72,0.6667,0.58,0.2537,145,2175,213,2130,358,4305
3448,2011-05-28,2,0,5,13,0,6,0,1,0.72,0.6818,0.62,0.2239,168,2520,217,2170,385,4690
3449,2011-05-28,2,0,5,14,0,6,0,1,0.74,0.6818,0.58,0.2239,172,2580,210,2100,382,4680
3450,2011-05-28,2,0,5,15,0,6,0,1,0.74,0.6818,0.55,0.2239,187,2805,187,1870,374,4675
3451,2011-05-28,2,0,5,16,0,6,0,1,0.76,0.697,0.55,0.2836,201,3015,201,2010,402,5025
3452,2011-05-28,2,0,5,17,0,6,0,1,0.74,0.6818,0.55,0.2985,180,2700,161,1610,341,4310
3453,2011-05-28,2,0,5,18,0,6,0,1,0.72,0.6818,0.62,0.2537,173,2595,212,2120,385,4715
3454,2011-05-28,2,0,5,19,0,6,0,1,0.7,0.6515,0.65,0.194,99,1485,153,1530,252,3015
3455,2011-05-28,2,0,5,20,0,6,0,1,0.7,0.6515,0.65,0.2239,68,1020,128,1280,196,2300
3456,2011-05-28,2,0,5,21,0,6,0,1,0.66,0.6212,0.74,0.2985,87,1305,114,1140,201,2445
3457,2011-05-28,2,0,5,22,0,6,0,1,0.66,0.6061,0.78,0.2239,46,690,115,1150,161,1840
3458,2011-05-28,2,0,5,23,0,6,0,1,0.64,0.5758,0.83,0.194,44,660,81,810,125,1470
3459,2011-05-29,2,0,5,0,0,0,0,1,0.64,0.5758,0.83,0.2239,32,480,51,510,83,990
3460,2011-05-29,2,0,5,1,0,0,0,1,0.62,0.5606,0.88,0.1642,17,255,49,490,66,745
3461,2011-05-29,2,0,5,2,0,0,0,1,0.62,0.5606,0.88,0.1045,12,180,49,490,61,670
3462,2011-05-29,2,0,5,3,0,0,0,1,0.62,0.5606,0.88,0.1045,2,30,24,240,26,270
3463,2011-05-29,2,0,5,4,0,0,0,1,0.6,0.5455,0.88,0.0896,13,195,10,100,23,295
3464,2011-05-29,2,0,5,5,0,0,0,1,0.6,0.5152,0.94,0.1642,3,45,3,30,6,75
3465,2011-05-29,2,0,5,6,0,0,0,2,0.62,0.5606,0.88,0.194,5,75,10,100,15,175
3466,2011-05-29,2,0,5,7,0,0,0,2,0.62,0.5606,0.88,0.2537,13,195,17,170,30,365
3467,2011-05-29,2,0,5,8,0,0,0,2,0.62,0.5606,0.88,0.2239,34,510,62,620,96,1130
3468,2011-05-29,2,0,5,9,0,0,0,2,0.62,0.5455,0.94,0.2537,74,1110,78,780,152,1890
3469,2011-05-29,2,0,5,10,0,0,0,2,0.66,0.6061,0.83,0.2239,130,1950,121,1210,251,3160
3470,2011-05-29,2,0,5,11,0,0,0,2,0.66,0.6061,0.83,0.2836,139,2085,180,1800,319,3885
3471,2011-05-29,2,0,5,12,0,0,0,2,0.7,0.6667,0.74,0.2239,216,3240,186,1860,402,5100
3472,2011-05-29,2,0,5,13,0,0,0,1,0.72,0.6818,0.7,0.2836,237,3555,181,1810,418,5365
3473,2011-05-29,2,0,5,14,0,0,0,1,0.74,0.697,0.7,0.2836,183,2745,168,1680,351,4425
3474,2011-05-29,2,0,5,15,0,0,0,1,0.74,0.697,0.7,0.2985,221,3315,155,1550,376,4865
3475,2011-05-29,2,0,5,16,0,0,0,1,0.74,0.697,0.7,0.2836,194,2910,167,1670,361,4580
3476,2011-05-29,2,0,5,17,0,0,0,1,0.74,0.697,0.7,0.2836,214,3210,169,1690,383,4900
3477,2011-05-29,2,0,5,18,0,0,0,1,0.72,0.697,0.74,0.2836,151,2265,177,1770,328,4035
3478,2011-05-29,2,0,5,19,0,0,0,1,0.72,0.697,0.74,0.2537,141,2115,146,1460,287,3575
3479,2011-05-29,2,0,5,20,0,0,0,1,0.7,0.6667,0.79,0.194,91,1365,128,1280,219,2645
3480,2011-05-29,2,0,5,21,0,0,0,1,0.68,0.6364,0.83,0.1642,107,1605,122,1220,229,2825
3481,2011-05-29,2,0,5,22,0,0,0,1,0.66,0.5909,0.89,0.1343,78,1170,93,930,171,2100
3482,2011-05-29,2,0,5,23,0,0,0,1,0.66,0.5909,0.89,0.1642,48,720,87,870,135,1590
3483,2011-05-30,2,0,5,0,1,1,0,1,0.64,0.5606,0.94,0.194,38,570,65,650,103,1220
3484,2011-05-30,2,0,5,1,1,1,0,1,0.64,0.5606,0.94,0.1343,26,390,53,530,79,920
3485,2011-05-30,2,0,5,2,1,1,0,1,0.64,0.5606,0.94,0.194,17,255,28,280,45,535
3486,2011-05-30,2,0,5,3,1,1,0,1,0.64,0.5606,0.94,0.194,10,150,8,80,18,230
3487,2011-05-30,2,0,5,4,1,1,0,1,0.62,0.5455,0.94,0.1642,2,30,4,40,6,70
3488,2011-05-30,2,0,5,5,1,1,0,2,0.62,0.5455,0.94,0.1045,1,15,6,60,7,75
3489,2011-05-30,2,0,5,6,1,1,0,2,0.64,0.5606,0.94,0.0896,6,90,10,100,16,190
3490,2011-05-30,2,0,5,7,1,1,0,2,0.64,0.5606,0.94,0.0,12,180,19,190,31,370
3491,2011-05-30,2,0,5,8,1,1,0,2,0.66,0.5909,0.89,0.1045,36,540,58,580,94,1120
3492,2011-05-30,2,0,5,9,1,1,0,1,0.72,0.697,0.74,0.0896,47,705,81,810,128,1515
3493,2011-05-30,2,0,5,10,1,1,0,1,0.8,0.7576,0.55,0.2537,116,1740,153,1530,269,3270
3494,2011-05-30,2,0,5,11,1,1,0,1,0.82,0.7727,0.52,0.0,153,2295,168,1680,321,3975
3495,2011-05-30,2,0,5,12,1,1,0,1,0.86,0.803,0.47,0.1045,179,2685,187,1870,366,4555
3496,2011-05-30,2,0,5,13,1,1,0,1,0.86,0.7879,0.44,0.0896,133,1995,217,2170,350,4165
3497,2011-05-30,2,0,5,14,1,1,0,1,0.88,0.803,0.39,0.0,142,2130,185,1850,327,3980
3498,2011-05-30,2,0,5,15,1,1,0,1,0.88,0.803,0.39,0.2537,132,1980,179,1790,311,3770
3499,2011-05-30,2,0,5,16,1,1,0,1,0.88,0.7879,0.37,0.2836,101,1515,208,2080,309,3595
3500,2011-05-30,2,0,5,17,1,1,0,1,0.86,0.7879,0.41,0.2239,102,1530,202,2020,304,3550
3501,2011-05-30,2,0,5,18,1,1,0,1,0.86,0.7879,0.41,0.1642,77,1155,172,1720,249,2875
3502,2011-05-30,2,0,5,19,1,1,0,2,0.52,0.5,0.48,0.1045,68,1020,157,1570,225,2590
3503,2011-05-30,2,0,5,20,1,1,0,1,0.76,0.7121,0.58,0.0,69,1035,168,1680,237,2715
3504,2011-05-30,2,0,5,21,1,1,0,1,0.74,0.697,0.7,0.1343,42,630,107,1070,149,1700
3505,2011-05-30,2,0,5,22,1,1,0,1,0.72,0.697,0.74,0.1642,26,390,80,800,106,1190
3506,2011-05-30,2,0,5,23,1,1,0,1,0.7,0.6667,0.84,0.1045,14,210,34,340,48,550
3507,2011-05-31,2,0,5,0,0,2,1,1,0.7,0.6667,0.79,0.0896,9,135,20,200,29,335
3508,2011-05-31,2,0,5,1,0,2,1,1,0.68,0.6364,0.89,0.0896,8,120,9,90,17,210
3509,2011-05-31,2,0,5,2,0,2,1,2,0.66,0.5909,0.94,0.1343,5,75,7,70,12,145
3510,2011-05-31,2,0,5,3,0,2,1,2,0.64,0.5606,0.94,0.0,1,15,3,30,4,45
3511,2011-05-31,2,0,5,4,0,2,1,1,0.66,0.6061,0.83,0.0896,0,0,3,30,3,30
3512,2011-05-31,2,0,5,5,0,2,1,1,0.66,0.6061,0.83,0.0896,0,0,26,260,26,260
3513,2011-05-31,2,0,5,6,0,2,1,1,0.68,0.6364,0.79,0.0896,11,165,98,980,109,1145
3514,2011-05-31,2,0,5,7,0,2,1,1,0.74,0.697,0.66,0.1045,16,240,219,2190,235,2430
3515,2011-05-31,2,0,5,8,0,2,1,1,0.78,0.7424,0.59,0.1343,34,510,372,3720,406,4230
3516,2011-05-31,2,0,5,9,0,2,1,1,0.8,0.7576,0.55,0.1343,22,330,153,1530,175,1860
3517,2011-05-31,2,0,5,10,0,2,1,1,0.82,0.7879,0.56,0.1343,37,555,72,720,109,1275
3518,2011-05-31,2,0,5,11,0,2,1,1,0.86,0.803,0.47,0.0,28,420,78,780,106,1200
3519,2011-05-31,2,0,5,12,0,2,1,1,0.86,0.803,0.47,0.1343,37,555,125,1250,162,1805
3520,2011-05-31,2,0,5,13,0,2,1,1,0.9,0.8333,0.39,0.1642,37,555,110,1100,147,1655
3521,2011-05-31,2,0,5,14,0,2,1,1,0.9,0.8182,0.37,0.0,41,615,99,990,140,1605
3522,2011-05-31,2,0,5,15,0,2,1,1,0.9,0.8182,0.37,0.1642,42,630,133,1330,175,1960
3523,2011-05-31,2,0,5,16,0,2,1,1,0.9,0.8333,0.39,0.1343,44,660,205,2050,249,2710
3524,2011-05-31,2,0,5,17,0,2,1,1,0.84,0.803,0.53,0.2239,67,1005,428,4280,495,5285
3525,2011-05-31,2,0,5,18,0,2,1,1,0.84,0.803,0.53,0.194,55,825,362,3620,417,4445
3526,2011-05-31,2,0,5,19,0,2,1,1,0.78,0.7424,0.62,0.1045,39,585,246,2460,285,3045
3527,2011-05-31,2,0,5,20,0,2,1,1,0.78,0.7424,0.62,0.1045,38,570,213,2130,251,2700
3528,2011-05-31,2,0,5,21,0,2,1,1,0.76,0.7273,0.66,0.1045,45,675,165,1650,210,2325
3529,2011-05-31,2,0,5,22,0,2,1,1,0.74,0.697,0.7,0.1642,42,630,117,1170,159,1800
3530,2011-05-31,2,0,5,23,0,2,1,1,0.72,0.697,0.79,0.0896,15,225,46,460,61,685
3531,2011-06-01,2,0,6,0,0,3,1,1,0.7,0.6667,0.79,0.1642,9,135,25,250,34,385
3532,2011-06-01,2,0,6,1,0,3,1,1,0.7,0.6667,0.84,0.2537,8,120,9,90,17,210
3533,2011-06-01,2,0,6,2,0,3,1,1,0.7,0.6667,0.79,0.1642,0,0,3,30,3,30
3534,2011-06-01,2,0,6,3,0,3,1,1,0.68,0.6364,0.89,0.194,0,0,6,60,6,60
3535,2011-06-01,2,0,6,4,0,3,1,2,0.68,0.6364,0.89,0.2239,0,0,4,40,4,40
3536,2011-06-01,2,0,6,5,0,3,1,2,0.66,0.5909,0.89,0.0896,2,30,19,190,21,220
3537,2011-06-01,2,0,6,6,0,3,1,2,0.68,0.6364,0.89,0.0896,7,105,121,1210,128,1315
3538,2011-06-01,2,0,6,7,0,3,1,2,0.7,0.6667,0.79,0.1642,19,285,265,2650,284,2935
3539,2011-06-01,2,0,6,8,0,3,1,2,0.72,0.697,0.79,0.194,37,555,417,4170,454,4725
3540,2011-06-01,2,0,6,9,0,3,1,2,0.74,0.7121,0.74,0.2239,34,510,173,1730,207,2240
3541,2011-06-01,2,0,6,10,0,3,1,2,0.76,0.7424,0.75,0.2537,31,465,84,840,115,1305
3542,2011-06-01,2,0,6,11,0,3,1,2,0.82,0.803,0.59,0.2239,26,390,86,860,112,1250
3543,2011-06-01,2,0,6,12,0,3,1,1,0.86,0.8333,0.53,0.0,32,480,137,1370,169,1850
3544,2011-06-01,2,0,6,13,0,3,1,1,0.9,0.8182,0.37,0.194,29,435,125,1250,154,1685
3545,2011-06-01,2,0,6,14,0,3,1,1,0.9,0.8182,0.37,0.2537,40,600,105,1050,145,1650
3546,2011-06-01,2,0,6,15,0,3,1,1,0.9,0.8333,0.39,0.2985,25,375,127,1270,152,1645
3547,2011-06-01,2,0,6,16,0,3,1,1,0.86,0.803,0.47,0.2985,39,585,227,2270,266,2855
3548,2011-06-01,2,0,6,17,0,3,1,1,0.86,0.803,0.47,0.2985,52,780,434,4340,486,5120
3549,2011-06-01,2,0,6,18,0,3,1,3,0.82,0.7879,0.56,0.3881,31,465,278,2780,309,3245
3550,2011-06-01,2,0,6,19,0,3,1,2,0.74,0.7121,0.79,0.1642,16,240,248,2480,264,2720
3551,2011-06-01,2,0,6,20,0,3,1,2,0.74,0.7121,0.79,0.2537,23,345,233,2330,256,2675
3552,2011-06-01,2,0,6,21,0,3,1,1,0.74,0.697,0.7,0.2836,29,435,161,1610,190,2045
3553,2011-06-01,2,0,6,22,0,3,1,1,0.74,0.697,0.66,0.1343,14,210,115,1150,129,1360
3554,2011-06-01,2,0,6,23,0,3,1,1,0.74,0.6667,0.51,0.1642,10,150,59,590,69,740
3555,2011-06-02,2,0,6,0,0,4,1,1,0.74,0.6515,0.4,0.3582,11,165,31,310,42,475
3556,2011-06-02,2,0,6,1,0,4,1,1,0.72,0.6515,0.38,0.1045,3,45,12,120,15,165
3557,2011-06-02,2,0,6,2,0,4,1,1,0.7,0.6364,0.39,0.0,0,0,6,60,6,60
3558,2011-06-02,2,0,6,3,0,4,1,1,0.66,0.6212,0.44,0.1045,0,0,4,40,4,40
3559,2011-06-02,2,0,6,4,0,4,1,1,0.66,0.6212,0.41,0.194,0,0,3,30,3,30
3560,2011-06-02,2,0,6,5,0,4,1,1,0.66,0.6212,0.39,0.2239,3,45,28,280,31,325
3561,2011-06-02,2,0,6,6,0,4,1,1,0.66,0.6212,0.39,0.1343,7,105,106,1060,113,1165
3562,2011-06-02,2,0,6,7,0,4,1,1,0.7,0.6364,0.34,0.2537,19,285,285,2850,304,3135
3563,2011-06-02,2,0,6,8,0,4,1,1,0.7,0.6364,0.32,0.2985,25,375,442,4420,467,4795
3564,2011-06-02,2,0,6,9,0,4,1,1,0.72,0.6364,0.26,0.3582,28,420,197,1970,225,2390
3565,2011-06-02,2,0,6,10,0,4,1,1,0.72,0.6515,0.28,0.4925,33,495,106,1060,139,1555
3566,2011-06-02,2,0,6,11,0,4,1,1,0.74,0.6515,0.28,0.3881,42,630,123,1230,165,1860
3567,2011-06-02,2,0,6,12,0,4,1,1,0.76,0.6667,0.25,0.4627,39,585,193,1930,232,2515
3568,2011-06-02,2,0,6,13,0,4,1,1,0.8,0.6818,0.24,0.3582,35,525,168,1680,203,2205
3569,2011-06-02,2,0,6,14,0,4,1,1,0.78,0.6667,0.24,0.3284,43,645,142,1420,185,2065
3570,2011-06-02,2,0,6,15,0,4,1,1,0.8,0.6818,0.21,0.3881,44,660,144,1440,188,2100
3571,2011-06-02,2,0,6,16,0,4,1,1,0.8,0.6818,0.22,0.4925,63,945,255,2550,318,3495
3572,2011-06-02,2,0,6,17,0,4,1,1,0.76,0.6515,0.2,0.5224,88,1320,484,4840,572,6160
3573,2011-06-02,2,0,6,18,0,4,1,1,0.74,0.6515,0.22,0.3881,74,1110,451,4510,525,5620
3574,2011-06-02,2,0,6,19,0,4,1,1,0.72,0.6364,0.23,0.2985,58,870,321,3210,379,4080
3575,2011-06-02,2,0,6,20,0,4,1,1,0.7,0.6364,0.24,0.194,51,765,286,2860,337,3625
3576,2011-06-02,2,0,6,21,0,4,1,1,0.66,0.6212,0.31,0.194,33,495,215,2150,248,2645
3577,2011-06-02,2,0,6,22,0,4,1,1,0.64,0.6212,0.33,0.2537,14,210,141,1410,155,1620
3578,2011-06-02,2,0,6,23,0,4,1,1,0.62,0.6212,0.35,0.2239,23,345,89,890,112,1235
3579,2011-06-03,2,0,6,0,0,5,1,1,0.62,0.6212,0.38,0.2836,15,225,53,530,68,755
3580,2011-06-03,2,0,6,1,0,5,1,1,0.6,0.6212,0.38,0.3582,7,105,15,150,22,255
3581,2011-06-03,2,0,6,2,0,5,1,1,0.56,0.5303,0.43,0.2239,0,0,12,120,12,120
3582,2011-06-03,2,0,6,3,0,5,1,1,0.54,0.5152,0.49,0.2239,0,0,5,50,5,50
3583,2011-06-03,2,0,6,4,0,5,1,1,0.52,0.5,0.48,0.3284,1,15,5,50,6,65
3584,2011-06-03,2,0,6,5,0,5,1,1,0.52,0.5,0.48,0.3582,4,60,24,240,28,300
3585,2011-06-03,2,0,6,6,0,5,1,1,0.54,0.5152,0.45,0.2985,8,120,98,980,106,1100
3586,2011-06-03,2,0,6,7,0,5,1,1,0.54,0.5152,0.45,0.2537,25,375,252,2520,277,2895
3587,2011-06-03,2,0,6,8,0,5,1,2,0.56,0.5303,0.43,0.3284,31,465,471,4710,502,5175
3588,2011-06-03,2,0,6,9,0,5,1,1,0.58,0.5455,0.4,0.1642,36,540,194,1940,230,2480
3589,2011-06-03,2,0,6,10,0,5,1,1,0.62,0.6212,0.33,0.2537,54,810,107,1070,161,1880
3590,2011-06-03,2,0,6,11,0,5,1,1,0.64,0.6212,0.31,0.3284,57,855,135,1350,192,2205
3591,2011-06-03,2,0,6,12,0,5,1,1,0.66,0.6212,0.27,0.2836,51,765,208,2080,259,2845
3592,2011-06-03,2,0,6,13,0,5,1,1,0.68,0.6212,0.26,0.2537,58,870,190,1900,248,2770
3593,2011-06-03,2,0,6,14,0,5,1,1,0.7,0.6364,0.28,0.2836,66,990,174,1740,240,2730
3594,2011-06-03,2,0,6,15,0,5,1,1,0.7,0.6364,0.28,0.2836,56,840,156,1560,212,2400
3595,2011-06-03,2,0,6,16,0,5,1,1,0.72,0.6364,0.26,0.3284,63,945,286,2860,349,3805
3596,2011-06-03,2,0,6,17,0,5,1,1,0.72,0.6364,0.25,0.2836,73,1095,485,4850,558,5945
3597,2011-06-03,2,0,6,18,0,5,1,1,0.7,0.6364,0.24,0.2985,76,1140,488,4880,564,6020
3598,2011-06-03,2,0,6,19,0,5,1,1,0.68,0.6212,0.26,0.2836,53,795,338,3380,391,4175
3599,2011-06-03,2,0,6,20,0,5,1,1,0.64,0.6212,0.29,0.1642,57,855,236,2360,293,3215
3600,2011-06-03,2,0,6,21,0,5,1,1,0.64,0.6212,0.29,0.1045,51,765,196,1960,247,2725
3601,2011-06-03,2,0,6,22,0,5,1,1,0.62,0.6212,0.35,0.0,26,390,145,1450,171,1840
3602,2011-06-03,2,0,6,23,0,5,1,1,0.58,0.5455,0.46,0.1045,30,450,141,1410,171,1860
3603,2011-06-04,2,0,6,0,0,6,0,1,0.56,0.5303,0.52,0.0,24,360,69,690,93,1050
3604,2011-06-04,2,0,6,1,0,6,0,1,0.54,0.5152,0.64,0.1045,14,210,80,800,94,1010
3605,2011-06-04,2,0,6,2,0,6,0,1,0.54,0.5152,0.56,0.194,18,270,41,410,59,680
3606,2011-06-04,2,0,6,3,0,6,0,1,0.52,0.5,0.59,0.1045,8,120,10,100,18,220
3607,2011-06-04,2,0,6,4,0,6,0,1,0.52,0.5,0.59,0.0896,4,60,11,110,15,170
3608,2011-06-04,2,0,6,5,0,6,0,1,0.5,0.4848,0.64,0.0,3,45,5,50,8,95
3609,2011-06-04,2,0,6,6,0,6,0,1,0.54,0.5152,0.6,0.0,11,165,17,170,28,335
3610,2011-06-04,2,0,6,7,0,6,0,1,0.56,0.5303,0.56,0.0,27,405,60,600,87,1005
3611,2011-06-04,2,0,6,8,0,6,0,1,0.6,0.6212,0.46,0.0896,29,435,96,960,125,1395
3612,2011-06-04,2,0,6,9,0,6,0,1,0.62,0.6212,0.43,0.1343,55,825,169,1690,224,2515
3613,2011-06-04,2,0,6,10,0,6,0,1,0.64,0.6212,0.38,0.1045,115,1725,202,2020,317,3745
3614,2011-06-04,2,0,6,11,0,6,0,1,0.66,0.6212,0.36,0.1343,120,1800,249,2490,369,4290
3615,2011-06-04,2,0,6,12,0,6,0,1,0.7,0.6364,0.32,0.1642,150,2250,270,2700,420,4950
3616,2011-06-04,2,0,6,13,0,6,0,1,0.74,0.6515,0.28,0.1343,188,2820,268,2680,456,5500
3617,2011-06-04,2,0,6,14,0,6,0,1,0.74,0.6515,0.33,0.2239,193,2895,258,2580,451,5475
3618,2011-06-04,2,0,6,15,0,6,0,2,0.74,0.6515,0.27,0.4179,180,2700,224,2240,404,4940
3619,2011-06-04,2,0,6,16,0,6,0,2,0.72,0.6515,0.3,0.1343,168,2520,272,2720,440,5240
3620,2011-06-04,2,0,6,17,0,6,0,2,0.72,0.6515,0.34,0.2537,142,2130,202,2020,344,4150
3621,2011-06-04,2,0,6,18,0,6,0,2,0.74,0.6515,0.3,0.1642,127,1905,214,2140,341,4045
3622,2011-06-04,2,0,6,19,0,6,0,2,0.7,0.6364,0.39,0.0896,79,1185,206,2060,285,3245
3623,2011-06-04,2,0,6,20,0,6,0,2,0.7,0.6515,0.48,0.0896,90,1350,149,1490,239,2840
3624,2011-06-04,2,0,6,21,0,6,0,2,0.66,0.6212,0.47,0.1045,46,690,139,1390,185,2080
3625,2011-06-04,2,0,6,22,0,6,0,1,0.64,0.6212,0.57,0.2239,49,735,141,1410,190,2145
3626,2011-06-04,2,0,6,23,0,6,0,2,0.64,0.6212,0.57,0.0,29,435,121,1210,150,1645
3627,2011-06-05,2,0,6,0,0,0,0,1,0.64,0.6212,0.57,0.0896,23,345,90,900,113,1245
3628,2011-06-05,2,0,6,1,0,0,0,2,0.64,0.6212,0.61,0.1642,26,390,70,700,96,1090
3629,2011-06-05,2,0,6,2,0,0,0,2,0.64,0.6212,0.61,0.1642,16,240,48,480,64,720
3630,2011-06-05,2,0,6,3,0,0,0,2,0.62,0.6061,0.65,0.1642,22,330,25,250,47,580
3631,2011-06-05,2,0,6,4,0,0,0,2,0.62,0.6061,0.65,0.1642,4,60,8,80,12,140
3632,2011-06-05,2,0,6,5,0,0,0,2,0.62,0.6061,0.61,0.1343,1,15,5,50,6,65
3633,2011-06-05,2,0,6,6,0,0,0,2,0.62,0.6061,0.61,0.1045,10,150,11,110,21,260
3634,2011-06-05,2,0,6,7,0,0,0,2,0.6,0.5909,0.73,0.2537,8,120,19,190,27,310
3635,2011-06-05,2,0,6,8,0,0,0,2,0.6,0.5909,0.73,0.2537,24,360,74,740,98,1100
3636,2011-06-05,2,0,6,9,0,0,0,2,0.6,0.5758,0.78,0.194,53,795,111,1110,164,1905
3637,2011-06-05,2,0,6,10,0,0,0,2,0.62,0.5909,0.73,0.0896,83,1245,168,1680,251,2925
3638,2011-06-05,2,0,6,11,0,0,0,2,0.64,0.6061,0.69,0.1045,121,1815,214,2140,335,3955
3639,2011-06-05,2,0,6,12,0,0,0,2,0.64,0.6061,0.69,0.1045,123,1845,212,2120,335,3965
3640,2011-06-05,2,0,6,13,0,0,0,1,0.66,0.6212,0.65,0.1045,154,2310,213,2130,367,4440
3641,2011-06-05,2,0,6,14,0,0,0,1,0.7,0.6515,0.58,0.1642,161,2415,224,2240,385,4655
3642,2011-06-05,2,0,6,15,0,0,0,1,0.7,0.6515,0.54,0.0,161,2415,256,2560,417,4975
3643,2011-06-05,2,0,6,16,0,0,0,1,0.72,0.6667,0.51,0.0896,138,2070,260,2600,398,4670
3644,2011-06-05,2,0,6,17,0,0,0,1,0.74,0.6667,0.51,0.0,126,1890,264,2640,390,4530
3645,2011-06-05,2,0,6,18,0,0,0,1,0.7,0.6515,0.58,0.1045,124,1860,239,2390,363,4250
3646,2011-06-05,2,0,6,19,0,0,0,1,0.68,0.6364,0.65,0.1642,108,1620,249,2490,357,4110
3647,2011-06-05,2,0,6,20,0,0,0,1,0.66,0.6212,0.69,0.194,84,1260,195,1950,279,3210
3648,2011-06-05,2,0,6,21,0,0,0,1,0.64,0.6061,0.73,0.1642,54,810,111,1110,165,1920
3649,2011-06-05,2,0,6,22,0,0,0,1,0.64,0.5909,0.78,0.2239,36,540,94,940,130,1480
3650,2011-06-05,2,0,6,23,0,0,0,1,0.62,0.5909,0.78,0.1343,25,375,61,610,86,985
3651,2011-06-06,2,0,6,0,0,1,1,1,0.62,0.5909,0.78,0.1343,11,165,18,180,29,345
3652,2011-06-06,2,0,6,1,0,1,1,1,0.6,0.5606,0.83,0.1343,9,135,5,50,14,185
3653,2011-06-06,2,0,6,2,0,1,1,1,0.58,0.5455,0.88,0.1045,4,60,4,40,8,100
3654,2011-06-06,2,0,6,3,0,1,1,1,0.58,0.5455,0.88,0.0,2,30,3,30,5,60
3655,2011-06-06,2,0,6,4,0,1,1,1,0.56,0.5303,0.94,0.1045,4,60,4,40,8,100
3656,2011-06-06,2,0,6,5,0,1,1,1,0.56,0.5303,0.88,0.0896,7,105,24,240,31,345
3657,2011-06-06,2,0,6,6,0,1,1,1,0.58,0.5455,0.88,0.0,11,165,101,1010,112,1175
3658,2011-06-06,2,0,6,7,0,1,1,1,0.62,0.5909,0.78,0.1045,18,270,281,2810,299,3080
3659,2011-06-06,2,0,6,8,0,1,1,1,0.64,0.6061,0.73,0.0896,28,420,410,4100,438,4520
3660,2011-06-06,2,0,6,9,0,1,1,1,0.7,0.6515,0.58,0.1642,26,390,162,1620,188,2010
3661,2011-06-06,2,0,6,10,0,1,1,1,0.72,0.6667,0.51,0.2239,31,465,64,640,95,1105
3662,2011-06-06,2,0,6,11,0,1,1,1,0.74,0.6667,0.42,0.1343,39,585,72,720,111,1305
3663,2011-06-06,2,0,6,12,0,1,1,1,0.76,0.6667,0.37,0.1642,25,375,128,1280,153,1655
3664,2011-06-06,2,0,6,13,0,1,1,1,0.78,0.6818,0.35,0.0,28,420,152,1520,180,1940
3665,2011-06-06,2,0,6,14,0,1,1,1,0.78,0.6818,0.31,0.1343,46,690,99,990,145,1680
3666,2011-06-06,2,0,6,15,0,1,1,1,0.8,0.697,0.29,0.194,38,570,127,1270,165,1840
3667,2011-06-06,2,0,6,16,0,1,1,1,0.76,0.6667,0.33,0.1343,34,510,233,2330,267,2840
3668,2011-06-06,2,0,6,17,0,1,1,1,0.78,0.6818,0.33,0.2836,63,945,516,5160,579,6105
3669,2011-06-06,2,0,6,18,0,1,1,1,0.76,0.6667,0.31,0.1343,56,840,500,5000,556,5840
3670,2011-06-06,2,0,6,19,0,1,1,1,0.72,0.6667,0.54,0.194,64,960,343,3430,407,4390
3671,2011-06-06,2,0,6,20,0,1,1,1,0.68,0.6364,0.61,0.1343,59,885,277,2770,336,3655
3672,2011-06-06,2,0,6,21,0,1,1,1,0.66,0.6212,0.57,0.0896,29,435,160,1600,189,2035
3673,2011-06-06,2,0,6,22,0,1,1,1,0.66,0.6212,0.61,0.0896,36,540,137,1370,173,1910
3674,2011-06-06,2,0,6,23,0,1,1,1,0.64,0.6061,0.69,0.0896,5,75,55,550,60,625
3675,2011-06-07,2,0,6,0,0,2,1,1,0.64,0.6061,0.65,0.0896,5,75,15,150,20,225
3676,2011-06-07,2,0,6,1,0,2,1,1,0.62,0.6061,0.69,0.1343,2,30,2,20,4,50
3677,2011-06-07,2,0,6,2,0,2,1,1,0.6,0.5909,0.73,0.0896,3,45,2,20,5,65
3678,2011-06-07,2,0,6,3,0,2,1,1,0.6,0.5909,0.73,0.0896,1,15,1,10,2,25
3679,2011-06-07,2,0,6,4,0,2,1,1,0.58,0.5455,0.83,0.1343,2,30,3,30,5,60
3680,2011-06-07,2,0,6,5,0,2,1,1,0.58,0.5455,0.88,0.1642,2,30,30,300,32,330
3681,2011-06-07,2,0,6,6,0,2,1,1,0.6,0.5758,0.78,0.1343,10,150,116,1160,126,1310
3682,2011-06-07,2,0,6,7,0,2,1,2,0.64,0.6061,0.69,0.194,23,345,311,3110,334,3455
3683,2011-06-07,2,0,6,8,0,2,1,2,0.68,0.6364,0.61,0.1343,45,675,432,4320,477,4995
3684,2011-06-07,2,0,6,9,0,2,1,2,0.72,0.6667,0.58,0.2239,27,405,190,1900,217,2305
3685,2011-06-07,2,0,6,10,0,2,1,2,0.76,0.6818,0.48,0.194,37,555,86,860,123,1415
3686,2011-06-07,2,0,6,11,0,2,1,2,0.76,0.697,0.52,0.2537,38,570,113,1130,151,1700
3687,2011-06-07,2,0,6,12,0,2,1,2,0.8,0.7273,0.46,0.2836,42,630,141,1410,183,2040
3688,2011-06-07,2,0,6,13,0,2,1,2,0.8,0.7273,0.43,0.2537,55,825,141,1410,196,2235
3689,2011-06-07,2,0,6,14,0,2,1,2,0.8,0.7273,0.43,0.2836,34,510,112,1120,146,1630
3690,2011-06-07,2,0,6,15,0,2,1,2,0.82,0.7424,0.41,0.3284,56,840,127,1270,183,2110
3691,2011-06-07,2,0,6,16,0,2,1,1,0.8,0.7121,0.38,0.2239,55,825,253,2530,308,3355
3692,2011-06-07,2,0,6,17,0,2,1,1,0.8,0.7273,0.43,0.2537,64,960,475,4750,539,5710
3693,2011-06-07,2,0,6,18,0,2,1,1,0.78,0.697,0.46,0.2836,72,1080,479,4790,551,5870
3694,2011-06-07,2,0,6,19,0,2,1,1,0.76,0.6818,0.48,0.2537,69,1035,355,3550,424,4585
3695,2011-06-07,2,0,6,20,0,2,1,1,0.74,0.6818,0.56,0.1343,45,675,301,3010,346,3685
3696,2011-06-07,2,0,6,21,0,2,1,1,0.72,0.6818,0.7,0.1343,31,465,187,1870,218,2335
3697,2011-06-07,2,0,6,22,0,2,1,1,0.7,0.6515,0.65,0.1343,27,405,126,1260,153,1665
3698,2011-06-07,2,0,6,23,0,2,1,1,0.68,0.6364,0.79,0.1045,18,270,72,720,90,990
3699,2011-06-08,2,0,6,0,0,3,1,1,0.66,0.5909,0.89,0.1343,12,180,29,290,41,470
3700,2011-06-08,2,0,6,1,0,3,1,1,0.66,0.6061,0.78,0.0,3,45,20,200,23,245
3701,2011-06-08,2,0,6,2,0,3,1,1,0.64,0.5758,0.89,0.0896,0,0,7,70,7,70
3702,2011-06-08,2,0,6,3,0,3,1,1,0.64,0.5758,0.89,0.0896,2,30,1,10,3,40
3703,2011-06-08,2,0,6,4,0,3,1,1,0.62,0.5758,0.83,0.0,0,0,6,60,6,60
3704,2011-06-08,2,0,6,5,0,3,1,1,0.62,0.5606,0.88,0.0,0,0,21,210,21,210
3705,2011-06-08,2,0,6,6,0,3,1,1,0.64,0.5758,0.89,0.1343,13,195,103,1030,116,1225
3706,2011-06-08,2,0,6,7,0,3,1,1,0.66,0.6212,0.74,0.1045,24,360,329,3290,353,3650
3707,2011-06-08,2,0,6,8,0,3,1,1,0.76,0.7121,0.58,0.1642,46,690,435,4350,481,5040
3708,2011-06-08,2,0,6,9,0,3,1,1,0.76,0.7121,0.58,0.1642,34,510,168,1680,202,2190
3709,2011-06-08,2,0,6,10,0,3,1,1,0.82,0.7424,0.43,0.2239,27,405,63,630,90,1035
3710,2011-06-08,2,0,6,11,0,3,1,1,0.84,0.7576,0.41,0.194,28,420,106,1060,134,1480
3711,2011-06-08,2,0,6,12,0,3,1,1,0.88,0.8182,0.42,0.1343,15,225,134,1340,149,1565
3712,2011-06-08,2,0,6,13,0,3,1,1,0.9,0.8485,0.42,0.0,20,300,116,1160,136,1460
3713,2011-06-08,2,0,6,14,0,3,1,1,0.92,0.8788,0.4,0.2537,44,660,111,1110,155,1770
3714,2011-06-08,2,0,6,15,0,3,1,1,0.92,0.8788,0.4,0.1642,28,420,100,1000,128,1420
3715,2011-06-08,2,0,6,16,0,3,1,1,0.92,0.8788,0.4,0.2239,34,510,199,1990,233,2500
3716,2011-06-08,2,0,6,17,0,3,1,1,0.92,0.8485,0.35,0.2239,80,1200,426,4260,506,5460
3717,2011-06-08,2,0,6,18,0,3,1,1,0.9,0.8182,0.37,0.2239,61,915,398,3980,459,4895
3718,2011-06-08,2,0,6,19,0,3,1,1,0.82,0.803,0.59,0.1343,61,915,323,3230,384,4145
3719,2011-06-08,2,0,6,20,0,3,1,1,0.8,0.7879,0.63,0.1343,55,825,225,2250,280,3075
3720,2011-06-08,2,0,6,21,0,3,1,1,0.8,0.803,0.66,0.1343,34,510,168,1680,202,2190
3721,2011-06-08,2,0,6,22,0,3,1,1,0.76,0.7424,0.75,0.1642,37,555,139,1390,176,1945
3722,2011-06-08,2,0,6,23,0,3,1,1,0.76,0.7424,0.75,0.194,18,270,98,980,116,1250
3723,2011-06-09,2,0,6,0,0,4,1,2,0.74,0.7121,0.79,0.1343,7,105,40,400,47,505
3724,2011-06-09,2,0,6,1,0,4,1,1,0.74,0.7121,0.79,0.1045,3,45,13,130,16,175
3725,2011-06-09,2,0,6,2,0,4,1,2,0.72,0.7121,0.84,0.1642,0,0,6,60,6,60
3726,2011-06-09,2,0,6,3,0,4,1,2,0.72,0.7121,0.84,0.1045,0,0,2,20,2,20
3727,2011-06-09,2,0,6,4,0,4,1,2,0.72,0.697,0.79,0.0896,2,30,4,40,6,70
3728,2011-06-09,2,0,6,5,0,4,1,2,0.7,0.6667,0.84,0.0,1,15,19,190,20,205
3729,2011-06-09,2,0,6,6,0,4,1,2,0.72,0.7121,0.84,0.0896,13,195,105,1050,118,1245
3730,2011-06-09,2,0,6,7,0,4,1,2,0.72,0.697,0.79,0.1343,31,465,283,2830,314,3295
3731,2011-06-09,2,0,6,8,0,4,1,2,0.76,0.7273,0.7,0.1045,32,480,400,4000,432,4480
3732,2011-06-09,2,0,6,9,0,4,1,1,0.84,0.7879,0.49,0.0,20,300,148,1480,168,1780
3733,2011-06-09,2,0,6,10,0,4,1,1,0.86,0.8182,0.5,0.2836,20,300,74,740,94,1040
3734,2011-06-09,2,0,6,11,0,4,1,1,0.9,0.8485,0.42,0.2239,36,540,82,820,118,1360
3735,2011-06-09,2,0,6,12,0,4,1,1,0.92,0.8485,0.35,0.194,40,600,100,1000,140,1600
3736,2011-06-09,2,0,6,13,0,4,1,1,0.9,0.8182,0.37,0.0896,18,270,118,1180,136,1450
3737,2011-06-09,2,0,6,14,0,4,1,1,0.92,0.8788,0.4,0.194,25,375,93,930,118,1305
3738,2011-06-09,2,0,6,15,0,4,1,1,0.94,0.8333,0.31,0.1642,18,270,86,860,104,1130
3739,2011-06-09,2,0,6,16,0,4,1,1,0.92,0.8333,0.33,0.1343,30,450,170,1700,200,2150
3740,2011-06-09,2,0,6,17,0,4,1,1,0.9,0.8182,0.37,0.2537,54,810,355,3550,409,4360
3741,2011-06-09,2,0,6,18,0,4,1,1,0.88,0.803,0.39,0.2836,52,780,414,4140,466,4920
3742,2011-06-09,2,0,6,19,0,4,1,2,0.84,0.7424,0.39,0.3284,55,825,271,2710,326,3535
3743,2011-06-09,2,0,6,20,0,4,1,2,0.8,0.7273,0.43,0.194,40,600,214,2140,254,2740
3744,2011-06-09,2,0,6,21,0,4,1,3,0.76,0.697,0.52,0.0,29,435,142,1420,171,1855
3745,2011-06-09,2,0,6,22,0,4,1,2,0.74,0.6818,0.58,0.1642,22,330,131,1310,153,1640
3746,2011-06-09,2,0,6,23,0,4,1,2,0.74,0.697,0.57,0.1642,15,225,82,820,97,1045
3747,2011-06-10,2,0,6,0,0,5,1,3,0.7,0.6515,0.65,0.2239,8,120,61,610,69,730
3748,2011-06-10,2,0,6,1,0,5,1,3,0.7,0.6515,0.65,0.2239,5,75,18,180,23,255
3749,2011-06-10,2,0,6,2,0,5,1,1,0.68,0.6364,0.69,0.1642,6,90,7,70,13,160
3750,2011-06-10,2,0,6,3,0,5,1,1,0.68,0.6364,0.69,0.1642,3,45,3,30,6,75
3751,2011-06-10,2,0,6,4,0,5,1,1,0.66,0.6061,0.78,0.1642,0,0,4,40,4,40
3752,2011-06-10,2,0,6,5,0,5,1,1,0.66,0.6061,0.78,0.1642,0,0,28,280,28,280
3753,2011-06-10,2,0,6,6,0,5,1,1,0.66,0.6061,0.78,0.0896,10,150,94,940,104,1090
3754,2011-06-10,2,0,6,7,0,5,1,1,0.72,0.6818,0.66,0.1045,25,375,242,2420,267,2795
3755,2011-06-10,2,0,6,8,0,5,1,1,0.74,0.6818,0.58,0.1343,29,435,423,4230,452,4665
3756,2011-06-10,2,0,6,9,0,5,1,1,0.76,0.697,0.55,0.0,37,555,176,1760,213,2315
3757,2011-06-10,2,0,6,10,0,5,1,1,0.78,0.7121,0.52,0.0,23,345,88,880,111,1225
3758,2011-06-10,2,0,6,11,0,5,1,1,0.82,0.7576,0.46,0.0,46,690,107,1070,153,1760
3759,2011-06-10,2,0,6,12,0,5,1,1,0.84,0.7576,0.44,0.1343,40,600,167,1670,207,2270
3760,2011-06-10,2,0,6,13,0,5,1,1,0.84,0.7576,0.44,0.1045,40,600,149,1490,189,2090
3761,2011-06-10,2,0,6,14,0,5,1,1,0.86,0.7727,0.39,0.0,44,660,121,1210,165,1870
3762,2011-06-10,2,0,6,15,0,5,1,1,0.84,0.7576,0.44,0.1045,49,735,163,1630,212,2365
3763,2011-06-10,2,0,6,16,0,5,1,1,0.82,0.7879,0.56,0.2985,46,690,239,2390,285,3080
3764,2011-06-10,2,0,6,17,0,5,1,1,0.82,0.7727,0.52,0.2239,63,945,454,4540,517,5485
3765,2011-06-10,2,0,6,18,0,5,1,1,0.8,0.7727,0.59,0.2239,96,1440,367,3670,463,5110
3766,2011-06-10,2,0,6,19,0,5,1,1,0.78,0.7424,0.59,0.194,61,915,245,2450,306,3365
3767,2011-06-10,2,0,6,20,0,5,1,1,0.76,0.7121,0.62,0.1045,53,795,197,1970,250,2765
3768,2011-06-10,2,0,6,21,0,5,1,1,0.76,0.7273,0.66,0.1343,55,825,163,1630,218,2455
3769,2011-06-10,2,0,6,22,0,5,1,1,0.72,0.697,0.74,0.2537,40,600,145,1450,185,2050
3770,2011-06-10,2,0,6,23,0,5,1,1,0.72,0.697,0.74,0.1642,36,540,110,1100,146,1640
3771,2011-06-11,2,0,6,0,0,6,0,1,0.7,0.6667,0.79,0.1343,28,420,89,890,117,1310
3772,2011-06-11,2,0,6,1,0,6,0,1,0.7,0.6667,0.79,0.0896,10,150,67,670,77,820
3773,2011-06-11,2,0,6,2,0,6,0,1,0.7,0.6667,0.79,0.1045,10,150,50,500,60,650
3774,2011-06-11,2,0,6,3,0,6,0,1,0.68,0.6364,0.83,0.0896,10,150,18,180,28,330
3775,2011-06-11,2,0,6,4,0,6,0,1,0.68,0.6364,0.79,0.0896,4,60,9,90,13,150
3776,2011-06-11,2,0,6,5,0,6,0,1,0.68,0.6364,0.74,0.1343,4,60,12,120,16,180
3777,2011-06-11,2,0,6,6,0,6,0,1,0.7,0.6515,0.61,0.1343,9,135,31,310,40,445
3778,2011-06-11,2,0,6,7,0,6,0,1,0.72,0.6667,0.58,0.194,18,270,50,500,68,770
3779,2011-06-11,2,0,6,8,0,6,0,1,0.74,0.6818,0.58,0.194,32,480,111,1110,143,1590
3780,2011-06-11,2,0,6,9,0,6,0,1,0.74,0.6818,0.62,0.1343,59,885,171,1710,230,2595
3781,2011-06-11,2,0,6,10,0,6,0,1,0.74,0.6818,0.58,0.1642,91,1365,173,1730,264,3095
3782,2011-06-11,2,0,6,11,0,6,0,1,0.76,0.7121,0.62,0.1343,110,1650,215,2150,325,3800
3783,2011-06-11,2,0,6,12,0,6,0,1,0.8,0.7576,0.55,0.2239,112,1680,235,2350,347,4030
3784,2011-06-11,2,0,6,13,0,6,0,1,0.8,0.7576,0.55,0.194,150,2250,237,2370,387,4620
3785,2011-06-11,2,0,6,14,0,6,0,1,0.82,0.7727,0.49,0.1045,148,2220,232,2320,380,4540
3786,2011-06-11,2,0,6,15,0,6,0,1,0.82,0.7727,0.49,0.1045,142,2130,232,2320,374,4450
3787,2011-06-11,2,0,6,16,0,6,0,2,0.8,0.7273,0.46,0.194,169,2535,225,2250,394,4785
3788,2011-06-11,2,0,6,17,0,6,0,2,0.74,0.6818,0.58,0.1642,147,2205,190,1900,337,4105
3789,2011-06-11,2,0,6,18,0,6,0,2,0.72,0.6818,0.62,0.1343,131,1965,155,1550,286,3515
3790,2011-06-11,2,0,6,19,0,6,0,1,0.7,0.6515,0.65,0.194,97,1455,167,1670,264,3125
3791,2011-06-11,2,0,6,20,0,6,0,1,0.68,0.6364,0.74,0.2537,95,1425,180,1800,275,3225
3792,2011-06-11,2,0,6,21,0,6,0,1,0.66,0.6212,0.74,0.2239,76,1140,144,1440,220,2580
3793,2011-06-11,2,0,6,22,0,6,0,1,0.66,0.6061,0.78,0.2239,53,795,137,1370,190,2165
3794,2011-06-11,2,0,6,23,0,6,0,1,0.66,0.6212,0.74,0.1045,24,360,107,1070,131,1430
3795,2011-06-12,2,0,6,0,0,0,0,1,0.66,0.6061,0.78,0.2239,19,285,100,1000,119,1285
3796,2011-06-12,2,0,6,1,0,0,0,1,0.64,0.5758,0.83,0.1045,19,285,74,740,93,1025
3797,2011-06-12,2,0,6,2,0,0,0,1,0.64,0.5758,0.89,0.2537,9,135,57,570,66,705
3798,2011-06-12,2,0,6,3,0,0,0,1,0.64,0.5758,0.89,0.2836,8,120,20,200,28,320
3799,2011-06-12,2,0,6,4,0,0,0,1,0.62,0.5606,0.88,0.1642,8,120,6,60,14,180
3800,2011-06-12,2,0,6,5,0,0,0,1,0.62,0.5606,0.88,0.2239,5,75,5,50,10,125
3801,2011-06-12,2,0,6,6,0,0,0,1,0.62,0.5606,0.88,0.1045,5,75,9,90,14,165
3802,2011-06-12,2,0,6,7,0,0,0,1,0.64,0.5909,0.78,0.1045,7,105,27,270,34,375
3803,2011-06-12,2,0,6,8,0,0,0,1,0.7,0.6667,0.74,0.0,28,420,64,640,92,1060
3804,2011-06-12,2,0,6,9,0,0,0,1,0.72,0.6818,0.66,0.0,75,1125,107,1070,182,2195
3805,2011-06-12,2,0,6,10,0,0,0,1,0.76,0.7121,0.58,0.0896,120,1800,191,1910,311,3710
3806,2011-06-12,2,0,6,11,0,0,0,1,0.78,0.7273,0.55,0.1045,131,1965,236,2360,367,4325
3807,2011-06-12,2,0,6,12,0,0,0,1,0.82,0.7576,0.46,0.0,176,2640,244,2440,420,5080
3808,2011-06-12,2,0,6,13,0,0,0,1,0.78,0.7424,0.59,0.2836,109,1635,264,2640,373,4275
3809,2011-06-12,2,0,6,14,0,0,0,1,0.82,0.7879,0.56,0.2537,96,1440,219,2190,315,3630
3810,2011-06-12,2,0,6,15,0,0,0,1,0.8,0.7727,0.59,0.2985,142,2130,218,2180,360,4310
3811,2011-06-12,2,0,6,16,0,0,0,3,0.68,0.6364,0.83,0.2836,115,1725,235,2350,350,4075
3812,2011-06-12,2,0,6,17,0,0,0,3,0.68,0.6364,0.83,0.2836,94,1410,158,1580,252,2990
3813,2011-06-12,2,0,6,18,0,0,0,1,0.7,0.6667,0.74,0.1642,69,1035,187,1870,256,2905
3814,2011-06-12,2,0,6,19,0,0,0,1,0.7,0.6667,0.74,0.1045,67,1005,156,1560,223,2565
3815,2011-06-12,2,0,6,20,0,0,0,1,0.66,0.6061,0.83,0.1642,62,930,144,1440,206,2370
3816,2011-06-12,2,0,6,21,0,0,0,1,0.66,0.6061,0.83,0.1045,39,585,101,1010,140,1595
3817,2011-06-12,2,0,6,22,0,0,0,1,0.64,0.5758,0.83,0.1343,31,465,97,970,128,1435
3818,2011-06-12,2,0,6,23,0,0,0,1,0.64,0.5909,0.78,0.194,33,495,74,740,107,1235
3819,2011-06-13,2,0,6,0,0,1,1,1,0.64,0.5909,0.78,0.1343,8,120,20,200,28,320
3820,2011-06-13,2,0,6,1,0,1,1,1,0.64,0.6061,0.73,0.2239,6,90,10,100,16,190
3821,2011-06-13,2,0,6,2,0,1,1,1,0.62,0.5909,0.73,0.2836,2,30,8,80,10,110
3822,2011-06-13,2,0,6,3,0,1,1,1,0.6,0.6061,0.6,0.4925,1,15,6,60,7,75
3823,2011-06-13,2,0,6,4,0,1,1,1,0.56,0.5303,0.64,0.2985,1,15,3,30,4,45
3824,2011-06-13,2,0,6,5,0,1,1,1,0.54,0.5152,0.64,0.3881,2,30,27,270,29,300
3825,2011-06-13,2,0,6,6,0,1,1,1,0.54,0.5152,0.64,0.4179,7,105,98,980,105,1085
3826,2011-06-13,2,0,6,7,0,1,1,1,0.56,0.5303,0.56,0.3582,26,390,302,3020,328,3410
3827,2011-06-13,2,0,6,8,0,1,1,1,0.58,0.5455,0.49,0.4478,44,660,432,4320,476,4980
3828,2011-06-13,2,0,6,9,0,1,1,1,0.62,0.6212,0.46,0.3582,35,525,189,1890,224,2415
3829,2011-06-13,2,0,6,10,0,1,1,1,0.64,0.6212,0.41,0.3284,38,570,80,800,118,1370
3830,2011-06-13,2,0,6,11,0,1,1,1,0.66,0.6212,0.41,0.2985,53,795,106,1060,159,1855
3831,2011-06-13,2,0,6,12,0,1,1,1,0.66,0.6212,0.41,0.2836,35,525,161,1610,196,2135
3832,2011-06-13,2,0,6,13,0,1,1,1,0.7,0.6364,0.37,0.0,53,795,174,1740,227,2535
3833,2011-06-13,2,0,6,14,0,1,1,1,0.7,0.6364,0.34,0.2537,55,825,145,1450,200,2275
3834,2011-06-13,2,0,6,15,0,1,1,1,0.7,0.6364,0.37,0.4478,58,870,127,1270,185,2140
3835,2011-06-13,2,0,6,16,0,1,1,1,0.7,0.6364,0.37,0.4179,64,960,262,2620,326,3580
3836,2011-06-13,2,0,6,17,0,1,1,1,0.7,0.6364,0.39,0.3284,72,1080,529,5290,601,6370
3837,2011-06-13,2,0,6,18,0,1,1,1,0.7,0.6364,0.37,0.3582,76,1140,510,5100,586,6240
3838,2011-06-13,2,0,6,19,0,1,1,1,0.66,0.6212,0.39,0.2836,75,1125,348,3480,423,4605
3839,2011-06-13,2,0,6,20,0,1,1,1,0.64,0.6212,0.44,0.2537,78,1170,253,2530,331,3700
3840,2011-06-13,2,0,6,21,0,1,1,1,0.64,0.6212,0.41,0.2537,40,600,178,1780,218,2380
3841,2011-06-13,2,0,6,22,0,1,1,1,0.62,0.6212,0.46,0.2239,20,300,114,1140,134,1440
3842,2011-06-13,2,0,6,23,0,1,1,1,0.62,0.6212,0.46,0.194,14,210,75,750,89,960
3843,2011-06-14,2,0,6,0,0,2,1,1,0.6,0.6212,0.49,0.194,13,195,18,180,31,375
3844,2011-06-14,2,0,6,1,0,2,1,1,0.6,0.6212,0.49,0.2537,3,45,10,100,13,145
3845,2011-06-14,2,0,6,2,0,2,1,1,0.6,0.6212,0.49,0.2836,2,30,8,80,10,110
3846,2011-06-14,2,0,6,3,0,2,1,1,0.58,0.5455,0.53,0.3284,1,15,1,10,2,25
3847,2011-06-14,2,0,6,4,0,2,1,1,0.54,0.5152,0.6,0.2537,0,0,3,30,3,30
3848,2011-06-14,2,0,6,5,0,2,1,1,0.54,0.5152,0.56,0.3284,3,45,23,230,26,275
3849,2011-06-14,2,0,6,6,0,2,1,1,0.54,0.5152,0.56,0.2985,6,90,107,1070,113,1160
3850,2011-06-14,2,0,6,7,0,2,1,1,0.56,0.5303,0.52,0.4179,19,285,346,3460,365,3745
3851,2011-06-14,2,0,6,8,0,2,1,1,0.58,0.5455,0.49,0.3881,45,675,441,4410,486,5085
3852,2011-06-14,2,0,6,9,0,2,1,1,0.62,0.6212,0.46,0.194,19,285,174,1740,193,2025
3853,2011-06-14,2,0,6,10,0,2,1,1,0.62,0.6212,0.46,0.2239,33,495,97,970,130,1465
3854,2011-06-14,2,0,6,11,0,2,1,1,0.64,0.6212,0.41,0.2836,40,600,103,1030,143,1630
3855,2011-06-14,2,0,6,12,0,2,1,1,0.64,0.6212,0.41,0.3582,30,450,139,1390,169,1840
3856,2011-06-14,2,0,6,13,0,2,1,1,0.64,0.6212,0.44,0.2239,33,495,176,1760,209,2255
3857,2011-06-14,2,0,6,14,0,2,1,2,0.64,0.6212,0.47,0.194,41,615,118,1180,159,1795
3858,2011-06-14,2,0,6,15,0,2,1,1,0.64,0.6212,0.47,0.1642,42,630,136,1360,178,1990
3859,2011-06-14,2,0,6,16,0,2,1,1,0.68,0.6364,0.41,0.194,51,765,279,2790,330,3555
3860,2011-06-14,2,0,6,17,0,2,1,3,0.64,0.6212,0.5,0.2836,85,1275,484,4840,569,6115
3861,2011-06-14,2,0,6,18,0,2,1,1,0.62,0.6212,0.51,0.3284,65,975,473,4730,538,5705
3862,2011-06-14,2,0,6,19,0,2,1,1,0.64,0.6212,0.5,0.3582,51,765,335,3350,386,4115
3863,2011-06-14,2,0,6,20,0,2,1,1,0.6,0.6212,0.56,0.1642,60,900,237,2370,297,3270
3864,2011-06-14,2,0,6,21,0,2,1,1,0.6,0.6212,0.56,0.2985,37,555,206,2060,243,2615
3865,2011-06-14,2,0,6,22,0,2,1,1,0.58,0.5455,0.6,0.2239,29,435,159,1590,188,2025
3866,2011-06-14,2,0,6,23,0,2,1,1,0.56,0.5303,0.68,0.2239,19,285,91,910,110,1195
3867,2011-06-15,2,0,6,0,0,3,1,1,0.56,0.5303,0.64,0.3582,8,120,44,440,52,560
3868,2011-06-15,2,0,6,1,0,3,1,1,0.54,0.5152,0.64,0.2836,0,0,14,140,14,140
3869,2011-06-15,2,0,6,2,0,3,1,1,0.52,0.5,0.63,0.2239,0,0,9,90,9,90
3870,2011-06-15,2,0,6,3,0,3,1,1,0.5,0.4848,0.68,0.2537,0,0,1,10,1,10
3871,2011-06-15,2,0,6,4,0,3,1,1,0.5,0.4848,0.63,0.2836,0,0,4,40,4,40
3872,2011-06-15,2,0,6,5,0,3,1,1,0.48,0.4697,0.67,0.2836,1,15,20,200,21,215
3873,2011-06-15,2,0,6,6,0,3,1,1,0.5,0.4848,0.63,0.2537,11,165,110,1100,121,1265
3874,2011-06-15,2,0,6,7,0,3,1,1,0.54,0.5152,0.6,0.1343,22,330,348,3480,370,3810
3875,2011-06-15,2,0,6,8,0,3,1,1,0.58,0.5455,0.53,0.1343,53,795,445,4450,498,5245
3876,2011-06-15,2,0,6,9,0,3,1,1,0.6,0.6212,0.49,0.0,22,330,185,1850,207,2180
3877,2011-06-15,2,0,6,10,0,3,1,1,0.64,0.6212,0.47,0.1642,27,405,108,1080,135,1485
3878,2011-06-15,2,0,6,11,0,3,1,1,0.68,0.6364,0.36,0.0,49,735,115,1150,164,1885
3879,2011-06-15,2,0,6,12,0,3,1,1,0.7,0.6364,0.34,0.2239,33,495,178,1780,211,2275
3880,2011-06-15,2,0,6,13,0,3,1,1,0.74,0.6515,0.28,0.2836,43,645,146,1460,189,2105
3881,2011-06-15,2,0,6,14,0,3,1,1,0.74,0.6515,0.28,0.0,50,750,128,1280,178,2030
3882,2011-06-15,2,0,6,15,0,3,1,1,0.76,0.6667,0.27,0.0,33,495,131,1310,164,1805
3883,2011-06-15,2,0,6,16,0,3,1,1,0.76,0.6667,0.27,0.1343,47,705,265,2650,312,3355
3884,2011-06-15,2,0,6,17,0,3,1,1,0.74,0.6515,0.28,0.1045,83,1245,555,5550,638,6795
3885,2011-06-15,2,0,6,18,0,3,1,1,0.72,0.6515,0.32,0.1343,80,1200,527,5270,607,6470
3886,2011-06-15,2,0,6,19,0,3,1,1,0.7,0.6364,0.37,0.2836,54,810,362,3620,416,4430
3887,2011-06-15,2,0,6,20,0,3,1,1,0.66,0.6212,0.44,0.1642,57,855,273,2730,330,3585
3888,2011-06-15,2,0,6,21,0,3,1,1,0.64,0.6212,0.47,0.2239,48,720,209,2090,257,2810
3889,2011-06-15,2,0,6,22,0,3,1,1,0.62,0.6212,0.5,0.1045,31,465,144,1440,175,1905
3890,2011-06-15,2,0,6,23,0,3,1,1,0.62,0.6212,0.53,0.0,17,255,90,900,107,1155
3891,2011-06-16,2,0,6,0,0,4,1,1,0.6,0.6212,0.56,0.1045,9,135,38,380,47,515
3892,2011-06-16,2,0,6,1,0,4,1,1,0.58,0.5455,0.6,0.0,4,60,13,130,17,190
3893,2011-06-16,2,0,6,2,0,4,1,1,0.6,0.6212,0.56,0.0896,1,15,4,40,5,55
3894,2011-06-16,2,0,6,3,0,4,1,2,0.56,0.5303,0.73,0.0896,0,0,4,40,4,40
3895,2011-06-16,2,0,6,4,0,4,1,2,0.56,0.5303,0.68,0.1045,0,0,6,60,6,60
3896,2011-06-16,2,0,6,5,0,4,1,1,0.6,0.6061,0.64,0.194,7,105,18,180,25,285
3897,2011-06-16,2,0,6,6,0,4,1,3,0.58,0.5455,0.73,0.1642,8,120,104,1040,112,1160
3898,2011-06-16,2,0,6,7,0,4,1,3,0.56,0.5303,0.78,0.1642,16,240,172,1720,188,1960
3899,2011-06-16,2,0,6,8,0,4,1,2,0.6,0.5909,0.69,0.1343,24,360,364,3640,388,4000
3900,2011-06-16,2,0,6,9,0,4,1,2,0.62,0.6061,0.65,0.194,29,435,232,2320,261,2755
3901,2011-06-16,2,0,6,10,0,4,1,2,0.66,0.6212,0.61,0.2537,18,270,103,1030,121,1300
3902,2011-06-16,2,0,6,11,0,4,1,2,0.68,0.6364,0.61,0.2985,33,495,117,1170,150,1665
3903,2011-06-16,2,0,6,12,0,4,1,1,0.72,0.6667,0.54,0.3881,41,615,165,1650,206,2265
3904,2011-06-16,2,0,6,13,0,4,1,2,0.72,0.6667,0.54,0.2537,37,555,114,1140,151,1695
3905,2011-06-16,2,0,6,14,0,4,1,2,0.72,0.6667,0.54,0.3284,39,585,114,1140,153,1725
3906,2011-06-16,2,0,6,15,0,4,1,2,0.7,0.6515,0.61,0.2985,32,480,127,1270,159,1750
3907,2011-06-16,2,0,6,16,0,4,1,3,0.66,0.6212,0.69,0.194,36,540,258,2580,294,3120
3908,2011-06-16,2,0,6,17,0,4,1,2,0.64,0.5909,0.78,0.1045,42,630,230,2300,272,2930
3909,2011-06-16,2,0,6,18,0,4,1,1,0.64,0.5758,0.83,0.2239,26,390,299,2990,325,3380
3910,2011-06-16,2,0,6,19,0,4,1,1,0.62,0.5758,0.83,0.2836,58,870,269,2690,327,3560
3911,2011-06-16,2,0,6,20,0,4,1,1,0.62,0.5758,0.83,0.3284,25,375,176,1760,201,2135
3912,2011-06-16,2,0,6,21,0,4,1,3,0.62,0.5758,0.83,0.2537,34,510,154,1540,188,2050
3913,2011-06-16,2,0,6,22,0,4,1,3,0.62,0.5758,0.83,0.2537,24,360,127,1270,151,1630
3914,2011-06-16,2,0,6,23,0,4,1,3,0.6,0.5606,0.83,0.2537,2,30,14,140,16,170
3915,2011-06-17,2,0,6,0,0,5,1,1,0.56,0.5303,0.88,0.0896,3,45,21,210,24,255
3916,2011-06-17,2,0,6,1,0,5,1,1,0.56,0.5303,0.94,0.1343,4,60,19,190,23,250
3917,2011-06-17,2,0,6,2,0,5,1,1,0.56,0.5303,0.94,0.1045,2,30,11,110,13,140
3918,2011-06-17,2,0,6,3,0,5,1,1,0.56,0.5303,0.94,0.1045,1,15,5,50,6,65
3919,2011-06-17,2,0,6,4,0,5,1,1,0.54,0.5152,0.94,0.1343,1,15,5,50,6,65
3920,2011-06-17,2,0,6,5,0,5,1,1,0.54,0.5152,1.0,0.0,1,15,12,120,13,135
3921,2011-06-17,2,0,6,6,0,5,1,1,0.56,0.5303,0.94,0.0,8,120,89,890,97,1010
3922,2011-06-17,2,0,6,7,0,5,1,1,0.6,0.5606,0.83,0.0,25,375,225,2250,250,2625
3923,2011-06-17,2,0,6,8,0,5,1,2,0.6,0.5606,0.83,0.0,28,420,426,4260,454,4680
3924,2011-06-17,2,0,6,9,0,5,1,1,0.7,0.6515,0.58,0.194,28,420,196,1960,224,2380
3925,2011-06-17,2,0,6,10,0,5,1,1,0.7,0.6515,0.58,0.194,44,660,126,1260,170,1920
3926,2011-06-17,2,0,6,11,0,5,1,1,0.68,0.6364,0.69,0.2537,43,645,138,1380,181,2025
3927,2011-06-17,2,0,6,12,0,5,1,1,0.7,0.6515,0.65,0.2537,49,735,194,1940,243,2675
3928,2011-06-17,2,0,6,13,0,5,1,1,0.74,0.6818,0.62,0.2836,48,720,156,1560,204,2280
3929,2011-06-17,2,0,6,14,0,5,1,1,0.76,0.697,0.52,0.194,73,1095,142,1420,215,2515
3930,2011-06-17,2,0,6,15,0,5,1,1,0.78,0.697,0.43,0.2239,62,930,181,1810,243,2740
3931,2011-06-17,2,0,6,16,0,5,1,1,0.76,0.6818,0.45,0.1642,69,1035,286,2860,355,3895
3932,2011-06-17,2,0,6,17,0,5,1,3,0.76,0.6818,0.4,0.194,85,1275,467,4670,552,5945
3933,2011-06-17,2,0,6,18,0,5,1,3,0.76,0.6818,0.4,0.194,62,930,388,3880,450,4810
3934,2011-06-17,2,0,6,19,0,5,1,3,0.64,0.5758,0.83,0.2537,53,795,275,2750,328,3545
3935,2011-06-17,2,0,6,20,0,5,1,1,0.64,0.5909,0.78,0.1045,40,600,192,1920,232,2520
3936,2011-06-17,2,0,6,21,0,5,1,1,0.64,0.5909,0.78,0.0896,49,735,159,1590,208,2325
3937,2011-06-17,2,0,6,22,0,5,1,1,0.62,0.5606,0.88,0.1343,48,720,127,1270,175,1990
3938,2011-06-17,2,0,6,23,0,5,1,1,0.62,0.5758,0.83,0.1343,37,555,141,1410,178,1965
3939,2011-06-18,2,0,6,0,0,6,0,1,0.62,0.5606,0.88,0.1343,21,315,83,830,104,1145
3940,2011-06-18,2,0,6,1,0,6,0,1,0.62,0.5758,0.83,0.1045,15,225,80,800,95,1025
3941,2011-06-18,2,0,6,2,0,6,0,1,0.6,0.5455,0.88,0.0,16,240,37,370,53,610
3942,2011-06-18,2,0,6,3,0,6,0,1,0.6,0.5455,0.88,0.0896,4,60,16,160,20,220
3943,2011-06-18,2,0,6,4,0,6,0,1,0.6,0.5455,0.88,0.0896,1,15,4,40,5,55
3944,2011-06-18,2,0,6,5,0,6,0,1,0.62,0.5758,0.83,0.0,1,15,6,60,7,75
3945,2011-06-18,2,0,6,6,0,6,0,1,0.62,0.5758,0.83,0.1045,9,135,18,180,27,315
3946,2011-06-18,2,0,6,7,0,6,0,1,0.64,0.5909,0.78,0.1343,12,180,45,450,57,630
3947,2011-06-18,2,0,6,8,0,6,0,1,0.66,0.6061,0.78,0.0896,28,420,103,1030,131,1450
3948,2011-06-18,2,0,6,9,0,6,0,1,0.7,0.6515,0.61,0.2239,62,930,156,1560,218,2490
3949,2011-06-18,2,0,6,10,0,6,0,1,0.72,0.6818,0.62,0.194,68,1020,176,1760,244,2780
3950,2011-06-18,2,0,6,11,0,6,0,1,0.72,0.6818,0.62,0.1343,134,2010,270,2700,404,4710
3951,2011-06-18,2,0,6,12,0,6,0,1,0.74,0.697,0.66,0.0896,162,2430,258,2580,420,5010
3952,2011-06-18,2,0,6,13,0,6,0,1,0.76,0.697,0.55,0.0,135,2025,192,1920,327,3945
3953,2011-06-18,2,0,6,14,0,6,0,2,0.8,0.7273,0.46,0.2836,138,2070,196,1960,334,4030
3954,2011-06-18,2,0,6,15,0,6,0,2,0.82,0.7576,0.46,0.1343,153,2295,214,2140,367,4435
3955,2011-06-18,2,0,6,16,0,6,0,2,0.76,0.697,0.52,0.2239,193,2895,275,2750,468,5645
3956,2011-06-18,2,0,6,17,0,6,0,2,0.76,0.6818,0.48,0.1642,210,3150,239,2390,449,5540
3957,2011-06-18,2,0,6,18,0,6,0,2,0.74,0.6818,0.55,0.194,118,1770,263,2630,381,4400
3958,2011-06-18,2,0,6,19,0,6,0,2,0.74,0.6667,0.51,0.1045,99,1485,227,2270,326,3755
3959,2011-06-18,2,0,6,20,0,6,0,2,0.72,0.6667,0.58,0.1343,61,915,127,1270,188,2185
3960,2011-06-18,2,0,6,21,0,6,0,2,0.72,0.6818,0.66,0.1045,58,870,125,1250,183,2120
3961,2011-06-18,2,0,6,22,0,6,0,2,0.72,0.6818,0.62,0.1343,56,840,105,1050,161,1890
3962,2011-06-18,2,0,6,23,0,6,0,2,0.72,0.6818,0.62,0.0,53,795,97,970,150,1765
3963,2011-06-19,2,0,6,0,0,0,0,1,0.7,0.6515,0.65,0.0,18,270,71,710,89,980
3964,2011-06-19,2,0,6,1,0,0,0,2,0.7,0.6515,0.65,0.0896,17,255,59,590,76,845
3965,2011-06-19,2,0,6,2,0,0,0,1,0.68,0.6364,0.74,0.0896,13,195,59,590,72,785
3966,2011-06-19,2,0,6,3,0,0,0,2,0.66,0.6061,0.78,0.1343,14,210,16,160,30,370
3967,2011-06-19,2,0,6,4,0,0,0,2,0.66,0.6212,0.74,0.1343,7,105,10,100,17,205
3968,2011-06-19,2,0,6,5,0,0,0,2,0.66,0.6061,0.78,0.0,7,105,12,120,19,225
3969,2011-06-19,2,0,6,6,0,0,0,2,0.66,0.6061,0.78,0.1642,11,165,22,220,33,385
3970,2011-06-19,2,0,6,7,0,0,0,2,0.66,0.6061,0.78,0.1642,35,525,36,360,71,885
3971,2011-06-19,2,0,6,8,0,0,0,3,0.68,0.6364,0.74,0.1045,25,375,59,590,84,965
3972,2011-06-19,2,0,6,9,0,0,0,2,0.68,0.6364,0.74,0.1045,58,870,111,1110,169,1980
3973,2011-06-19,2,0,6,10,0,0,0,2,0.7,0.6515,0.61,0.1045,86,1290,158,1580,244,2870
3974,2011-06-19,2,0,6,11,0,0,0,2,0.72,0.6667,0.58,0.0896,141,2115,236,2360,377,4475
3975,2011-06-19,2,0,6,12,0,0,0,2,0.74,0.6818,0.55,0.0896,141,2115,255,2550,396,4665
3976,2011-06-19,2,0,6,13,0,0,0,2,0.74,0.6667,0.51,0.0,149,2235,214,2140,363,4375
3977,2011-06-19,2,0,6,14,0,0,0,3,0.74,0.6818,0.58,0.1045,124,1860,193,1930,317,3790
3978,2011-06-19,2,0,6,15,0,0,0,2,0.74,0.6818,0.55,0.1045,146,2190,216,2160,362,4350
3979,2011-06-19,2,0,6,16,0,0,0,2,0.76,0.6818,0.48,0.0,121,1815,257,2570,378,4385
3980,2011-06-19,2,0,6,17,0,0,0,1,0.74,0.6667,0.51,0.0,159,2385,238,2380,397,4765
3981,2011-06-19,2,0,6,18,0,0,0,2,0.74,0.6818,0.58,0.0896,78,1170,218,2180,296,3350
3982,2011-06-19,2,0,6,19,0,0,0,1,0.72,0.6818,0.62,0.1343,94,1410,217,2170,311,3580
3983,2011-06-19,2,0,6,20,0,0,0,1,0.7,0.6515,0.7,0.194,86,1290,146,1460,232,2750
3984,2011-06-19,2,0,6,21,0,0,0,1,0.68,0.6364,0.79,0.1343,57,855,110,1100,167,1955
3985,2011-06-19,2,0,6,22,0,0,0,1,0.66,0.6061,0.78,0.2239,38,570,114,1140,152,1710
3986,2011-06-19,2,0,6,23,0,0,0,1,0.66,0.6061,0.78,0.194,14,210,78,780,92,990
3987,2011-06-20,2,0,6,0,0,1,1,1,0.66,0.6061,0.83,0.1642,7,105,19,190,26,295
3988,2011-06-20,2,0,6,1,0,1,1,1,0.64,0.5758,0.89,0.0896,9,135,3,30,12,165
3989,2011-06-20,2,0,6,2,0,1,1,1,0.64,0.5758,0.89,0.0896,2,30,0,0,2,30
3990,2011-06-20,2,0,6,3,0,1,1,3,0.64,0.5758,0.89,0.0,1,15,0,0,1,15
3991,2011-06-20,2,0,6,4,0,1,1,3,0.62,0.5606,0.88,0.1642,1,15,2,20,3,35
3992,2011-06-20,2,0,6,5,0,1,1,3,0.62,0.5758,0.83,0.1343,0,0,3,30,3,30
3993,2011-06-20,2,0,6,6,0,1,1,3,0.6,0.5758,0.78,0.1343,1,15,25,250,26,265
3994,2011-06-20,2,0,6,7,0,1,1,3,0.56,0.5303,0.88,0.194,0,0,46,460,46,460
3995,2011-06-20,2,0,6,8,0,1,1,3,0.56,0.5303,0.83,0.194,12,180,209,2090,221,2270
3996,2011-06-20,2,0,6,9,0,1,1,2,0.6,0.5758,0.78,0.2537,19,285,200,2000,219,2285
3997,2011-06-20,2,0,6,10,0,1,1,2,0.6,0.5758,0.78,0.2537,33,495,58,580,91,1075
3998,2011-06-20,2,0,6,11,0,1,1,2,0.6,0.5758,0.78,0.1045,27,405,67,670,94,1075
3999,2011-06-20,2,0,6,12,0,1,1,2,0.62,0.6061,0.69,0.1045,33,495,129,1290,162,1785
4000,2011-06-20,2,0,6,13,0,1,1,1,0.64,0.6061,0.65,0.1045,50,750,129,1290,179,2040
4001,2011-06-20,2,0,6,14,0,1,1,1,0.66,0.6212,0.61,0.1045,45,675,130,1300,175,1975
4002,2011-06-20,2,0,6,15,0,1,1,1,0.66,0.6212,0.61,0.1343,66,990,139,1390,205,2380
4003,2011-06-20,2,0,6,16,0,1,1,1,0.7,0.6515,0.58,0.1642,61,915,238,2380,299,3295
4004,2011-06-20,2,0,6,17,0,1,1,1,0.7,0.6515,0.54,0.0,81,1215,484,4840,565,6055
4005,2011-06-20,2,0,6,18,0,1,1,1,0.7,0.6515,0.61,0.2537,64,960,474,4740,538,5700
4006,2011-06-20,2,0,6,19,0,1,1,1,0.66,0.6212,0.65,0.2239,62,930,369,3690,431,4620
4007,2011-06-20,2,0,6,20,0,1,1,1,0.66,0.6212,0.69,0.2239,52,780,264,2640,316,3420
4008,2011-06-20,2,0,6,21,0,1,1,1,0.64,0.6061,0.73,0.1642,39,585,167,1670,206,2255
4009,2011-06-20,2,0,6,22,0,1,1,2,0.64,0.6061,0.73,0.2239,24,360,106,1060,130,1420
4010,2011-06-20,2,0,6,23,0,1,1,1,0.62,0.5909,0.78,0.2537,10,150,50,500,60,650
4011,2011-06-21,3,0,6,0,0,2,1,1,0.62,0.5909,0.78,0.1642,10,150,23,230,33,380
4012,2011-06-21,3,0,6,1,0,2,1,3,0.62,0.5909,0.78,0.1642,2,30,12,120,14,150
4013,2011-06-21,3,0,6,2,0,2,1,3,0.62,0.5758,0.83,0.1642,1,15,5,50,6,65
4014,2011-06-21,3,0,6,3,0,2,1,3,0.62,0.5758,0.83,0.1642,0,0,2,20,2,20
4015,2011-06-21,3,0,6,4,0,2,1,2,0.6,0.5455,0.88,0.1045,2,30,7,70,9,100
4016,2011-06-21,3,0,6,5,0,2,1,2,0.6,0.5455,0.88,0.1343,3,45,22,220,25,265
4017,2011-06-21,3,0,6,6,0,2,1,2,0.6,0.5455,0.88,0.1343,8,120,107,1070,115,1190
4018,2011-06-21,3,0,6,7,0,2,1,2,0.6,0.5152,0.94,0.0,21,315,288,2880,309,3195
4019,2011-06-21,3,0,6,8,0,2,1,2,0.62,0.5606,0.88,0.1045,33,495,368,3680,401,4175
4020,2011-06-21,3,0,6,9,0,2,1,2,0.62,0.5606,0.88,0.2537,32,480,243,2430,275,2910
4021,2011-06-21,3,0,6,10,0,2,1,2,0.64,0.5758,0.83,0.194,41,615,120,1200,161,1815
4022,2011-06-21,3,0,6,11,0,2,1,1,0.66,0.6061,0.83,0.1642,52,780,119,1190,171,1970
4023,2011-06-21,3,0,6,12,0,2,1,1,0.7,0.6667,0.74,0.1642,40,600,149,1490,189,2090
4024,2011-06-21,3,0,6,13,0,2,1,1,0.74,0.697,0.66,0.1642,49,735,158,1580,207,2315
4025,2011-06-21,3,0,6,14,0,2,1,1,0.76,0.7121,0.62,0.2239,44,660,108,1080,152,1740
4026,2011-06-21,3,0,6,15,0,2,1,1,0.78,0.7424,0.59,0.2537,42,630,128,1280,170,1910
4027,2011-06-21,3,0,6,16,0,2,1,1,0.8,0.7727,0.59,0.2239,62,930,273,2730,335,3660
4028,2011-06-21,3,0,6,17,0,2,1,1,0.78,0.7576,0.66,0.2239,65,975,507,5070,572,6045
4029,2011-06-21,3,0,6,18,0,2,1,2,0.76,0.7273,0.7,0.2537,67,1005,469,4690,536,5695
4030,2011-06-21,3,0,6,19,0,2,1,2,0.74,0.7121,0.74,0.2239,67,1005,358,3580,425,4585
4031,2011-06-21,3,0,6,20,0,2,1,3,0.74,0.697,0.7,0.2239,72,1080,254,2540,326,3620
4032,2011-06-21,3,0,6,21,0,2,1,1,0.72,0.697,0.74,0.194,38,570,191,1910,229,2480
4033,2011-06-21,3,0,6,22,0,2,1,1,0.7,0.6667,0.79,0.1045,12,180,97,970,109,1150
4034,2011-06-21,3,0,6,23,0,2,1,1,0.7,0.6667,0.74,0.1045,11,165,53,530,64,695
4035,2011-06-22,3,0,6,0,0,3,1,1,0.66,0.6061,0.78,0.194,15,225,18,180,33,405
4036,2011-06-22,3,0,6,1,0,3,1,1,0.66,0.6061,0.78,0.1343,2,30,19,190,21,220
4037,2011-06-22,3,0,6,2,0,3,1,1,0.66,0.6061,0.78,0.0,2,30,5,50,7,80
4038,2011-06-22,3,0,6,3,0,3,1,1,0.66,0.6061,0.78,0.1343,0,0,7,70,7,70
4039,2011-06-22,3,0,6,4,0,3,1,1,0.64,0.5758,0.83,0.0,3,45,8,80,11,125
4040,2011-06-22,3,0,6,5,0,3,1,1,0.64,0.5758,0.89,0.0,2,30,21,210,23,240
4041,2011-06-22,3,0,6,6,0,3,1,1,0.66,0.6061,0.83,0.0,12,180,110,1100,122,1280
4042,2011-06-22,3,0,6,7,0,3,1,1,0.7,0.6667,0.79,0.0,23,345,288,2880,311,3225
4043,2011-06-22,3,0,6,8,0,3,1,1,0.72,0.697,0.74,0.1045,27,405,396,3960,423,4365
4044,2011-06-22,3,0,6,9,0,3,1,1,0.72,0.697,0.79,0.1642,14,210,205,2050,219,2260
4045,2011-06-22,3,0,6,10,0,3,1,1,0.74,0.697,0.7,0.2537,31,465,104,1040,135,1505
4046,2011-06-22,3,0,6,11,0,3,1,1,0.74,0.697,0.7,0.1642,37,555,108,1080,145,1635
4047,2011-06-22,3,0,6,12,0,3,1,2,0.8,0.7727,0.59,0.2239,44,660,144,1440,188,2100
4048,2011-06-22,3,0,6,13,0,3,1,2,0.82,0.7879,0.56,0.2537,34,510,113,1130,147,1640
4049,2011-06-22,3,0,6,14,0,3,1,2,0.82,0.7727,0.52,0.2836,32,480,113,1130,145,1610
4050,2011-06-22,3,0,6,15,0,3,1,2,0.82,0.7879,0.56,0.2836,32,480,114,1140,146,1620
4051,2011-06-22,3,0,6,16,0,3,1,2,0.82,0.803,0.59,0.3284,34,510,224,2240,258,2750
4052,2011-06-22,3,0,6,17,0,3,1,2,0.8,0.7576,0.55,0.3881,67,1005,462,4620,529,5625
4053,2011-06-22,3,0,6,18,0,3,1,2,0.8,0.7727,0.59,0.2537,66,990,447,4470,513,5460
4054,2011-06-22,3,0,6,19,0,3,1,2,0.8,0.7424,0.52,0.2537,62,930,280,2800,342,3730
4055,2011-06-22,3,0,6,20,0,3,1,1,0.74,0.7121,0.74,0.1343,52,780,230,2300,282,3080
4056,2011-06-22,3,0,6,21,0,3,1,1,0.74,0.7121,0.79,0.1642,31,465,216,2160,247,2625
4057,2011-06-22,3,0,6,22,0,3,1,2,0.72,0.697,0.79,0.194,25,375,123,1230,148,1605
4058,2011-06-22,3,0,6,23,0,3,1,2,0.72,0.697,0.79,0.2239,14,210,91,910,105,1120
4059,2011-06-23,3,0,6,0,0,4,1,1,0.72,0.697,0.79,0.2239,5,75,44,440,49,515
4060,2011-06-23,3,0,6,1,0,4,1,1,0.72,0.697,0.74,0.2239,5,75,26,260,31,335
4061,2011-06-23,3,0,6,2,0,4,1,1,0.72,0.697,0.74,0.2239,0,0,4,40,4,40
4062,2011-06-23,3,0,6,3,0,4,1,2,0.72,0.697,0.74,0.1642,1,15,4,40,5,55
4063,2011-06-23,3,0,6,4,0,4,1,2,0.7,0.6667,0.79,0.1343,0,0,7,70,7,70
4064,2011-06-23,3,0,6,5,0,4,1,1,0.72,0.697,0.74,0.1642,2,30,22,220,24,250
4065,2011-06-23,3,0,6,6,0,4,1,1,0.72,0.697,0.74,0.1642,8,120,92,920,100,1040
4066,2011-06-23,3,0,6,7,0,4,1,2,0.72,0.697,0.74,0.1343,26,390,301,3010,327,3400
4067,2011-06-23,3,0,6,8,0,4,1,2,0.74,0.697,0.7,0.194,20,300,412,4120,432,4420
4068,2011-06-23,3,0,6,9,0,4,1,2,0.74,0.697,0.7,0.1343,33,495,194,1940,227,2435
4069,2011-06-23,3,0,6,10,0,4,1,2,0.76,0.7273,0.66,0.1343,39,585,88,880,127,1465
4070,2011-06-23,3,0,6,11,0,4,1,3,0.76,0.7273,0.66,0.2537,28,420,108,1080,136,1500
4071,2011-06-23,3,0,6,12,0,4,1,2,0.76,0.7273,0.66,0.2836,30,450,130,1300,160,1750
4072,2011-06-23,3,0,6,13,0,4,1,2,0.76,0.7121,0.62,0.2836,37,555,149,1490,186,2045
4073,2011-06-23,3,0,6,14,0,4,1,2,0.76,0.7273,0.66,0.2985,46,690,103,1030,149,1720
4074,2011-06-23,3,0,6,15,0,4,1,2,0.76,0.697,0.52,0.3582,62,930,127,1270,189,2200
4075,2011-06-23,3,0,6,16,0,4,1,2,0.74,0.6818,0.62,0.2985,58,870,217,2170,275,3040
4076,2011-06-23,3,0,6,17,0,4,1,2,0.72,0.6818,0.7,0.3582,74,1110,495,4950,569,6060
4077,2011-06-23,3,0,6,18,0,4,1,1,0.72,0.6818,0.7,0.4179,57,855,483,4830,540,5685
4078,2011-06-23,3,0,6,19,0,4,1,1,0.72,0.6818,0.7,0.3582,56,840,344,3440,400,4280
4079,2011-06-23,3,0,6,20,0,4,1,1,0.7,0.6667,0.74,0.2239,75,1125,277,2770,352,3895
4080,2011-06-23,3,0,6,21,0,4,1,1,0.7,0.6667,0.74,0.194,46,690,188,1880,234,2570
4081,2011-06-23,3,0,6,22,0,4,1,2,0.7,0.6667,0.74,0.2239,23,345,139,1390,162,1735
4082,2011-06-23,3,0,6,23,0,4,1,1,0.7,0.6667,0.74,0.2836,15,225,90,900,105,1125
4083,2011-06-24,3,0,6,0,0,5,1,1,0.68,0.6364,0.79,0.194,10,150,53,530,63,680
4084,2011-06-24,3,0,6,1,0,5,1,1,0.66,0.6061,0.83,0.3284,8,120,20,200,28,320
4085,2011-06-24,3,0,6,2,0,5,1,1,0.66,0.6061,0.83,0.3284,4,60,10,100,14,160
4086,2011-06-24,3,0,6,3,0,5,1,1,0.66,0.6061,0.83,0.1642,1,15,4,40,5,55
4087,2011-06-24,3,0,6,4,0,5,1,1,0.66,0.6061,0.83,0.0896,1,15,8,80,9,95
4088,2011-06-24,3,0,6,5,0,5,1,1,0.64,0.5758,0.89,0.0896,2,30,18,180,20,210
4089,2011-06-24,3,0,6,6,0,5,1,1,0.66,0.6061,0.83,0.1343,4,60,87,870,91,930
4090,2011-06-24,3,0,6,7,0,5,1,2,0.66,0.6061,0.83,0.2239,21,315,247,2470,268,2785
4091,2011-06-24,3,0,6,8,0,5,1,1,0.7,0.6667,0.74,0.2239,27,405,439,4390,466,4795
4092,2011-06-24,3,0,6,9,0,5,1,1,0.74,0.6818,0.62,0.1343,28,420,203,2030,231,2450
4093,2011-06-24,3,0,6,10,0,5,1,1,0.8,0.7273,0.43,0.2836,43,645,102,1020,145,1665
4094,2011-06-24,3,0,6,11,0,5,1,1,0.8,0.7121,0.38,0.3284,56,840,147,1470,203,2310
4095,2011-06-24,3,0,6,12,0,5,1,1,0.8,0.7121,0.41,0.2836,51,765,150,1500,201,2265
4096,2011-06-24,3,0,6,13,0,5,1,1,0.8,0.7121,0.36,0.2239,43,645,178,1780,221,2425
4097,2011-06-24,3,0,6,14,0,5,1,1,0.78,0.697,0.43,0.2836,67,1005,162,1620,229,2625
4098,2011-06-24,3,0,6,15,0,5,1,1,0.82,0.7273,0.34,0.3881,69,1035,147,1470,216,2505
4099,2011-06-24,3,0,6,16,0,5,1,1,0.8,0.697,0.33,0.4179,80,1200,247,2470,327,3670
4100,2011-06-24,3,0,6,17,0,5,1,1,0.76,0.6667,0.37,0.2537,85,1275,472,4720,557,5995
4101,2011-06-24,3,0,6,18,0,5,1,1,0.76,0.6667,0.37,0.2985,87,1305,365,3650,452,4955
4102,2011-06-24,3,0,6,19,0,5,1,1,0.74,0.6515,0.4,0.2239,92,1380,293,2930,385,4310
4103,2011-06-24,3,0,6,20,0,5,1,1,0.72,0.6515,0.45,0.1642,66,990,222,2220,288,3210
4104,2011-06-24,3,0,6,21,0,5,1,1,0.7,0.6515,0.48,0.1343,50,750,183,1830,233,2580
4105,2011-06-24,3,0,6,22,0,5,1,1,0.7,0.6515,0.48,0.0,41,615,126,1260,167,1875
4106,2011-06-24,3,0,6,23,0,5,1,1,0.68,0.6364,0.51,0.1343,33,495,139,1390,172,1885
4107,2011-06-25,3,0,6,0,0,6,0,1,0.68,0.6364,0.47,0.1642,19,285,97,970,116,1255
4108,2011-06-25,3,0,6,1,0,6,0,1,0.66,0.6212,0.5,0.1642,20,300,75,750,95,1050
4109,2011-06-25,3,0,6,2,0,6,0,2,0.66,0.6212,0.5,0.194,8,120,51,510,59,630
4110,2011-06-25,3,0,6,3,0,6,0,1,0.64,0.6212,0.57,0.194,18,270,21,210,39,480
4111,2011-06-25,3,0,6,4,0,6,0,1,0.64,0.6212,0.57,0.194,7,105,4,40,11,145
4112,2011-06-25,3,0,6,5,0,6,0,1,0.62,0.6061,0.61,0.1343,6,90,8,80,14,170
4113,2011-06-25,3,0,6,6,0,6,0,1,0.64,0.6212,0.57,0.2239,12,180,17,170,29,350
4114,2011-06-25,3,0,6,7,0,6,0,1,0.64,0.6212,0.57,0.2836,7,105,35,350,42,455
4115,2011-06-25,3,0,6,8,0,6,0,1,0.7,0.6515,0.48,0.2537,27,405,85,850,112,1255
4116,2011-06-25,3,0,6,9,0,6,0,1,0.72,0.6515,0.45,0.2537,47,705,139,1390,186,2095
4117,2011-06-25,3,0,6,10,0,6,0,1,0.72,0.6515,0.45,0.194,99,1485,203,2030,302,3515
4118,2011-06-25,3,0,6,11,0,6,0,1,0.74,0.6667,0.42,0.0,122,1830,209,2090,331,3920
4119,2011-06-25,3,0,6,12,0,6,0,1,0.74,0.6515,0.4,0.2836,140,2100,252,2520,392,4620
4120,2011-06-25,3,0,6,13,0,6,0,1,0.74,0.6515,0.4,0.2836,140,2100,231,2310,371,4410
4121,2011-06-25,3,0,6,14,0,6,0,1,0.74,0.6667,0.45,0.2985,151,2265,232,2320,383,4585
4122,2011-06-25,3,0,6,15,0,6,0,1,0.74,0.6667,0.45,0.0,157,2355,235,2350,392,4705
4123,2011-06-25,3,0,6,16,0,6,0,1,0.76,0.6818,0.43,0.2985,175,2625,235,2350,410,4975
4124,2011-06-25,3,0,6,17,0,6,0,1,0.74,0.6667,0.42,0.2239,152,2280,247,2470,399,4750
4125,2011-06-25,3,0,6,18,0,6,0,1,0.72,0.6515,0.45,0.2537,108,1620,199,1990,307,3610
4126,2011-06-25,3,0,6,19,0,6,0,1,0.72,0.6667,0.48,0.2836,121,1815,254,2540,375,4355
4127,2011-06-25,3,0,6,20,0,6,0,1,0.7,0.6515,0.48,0.194,74,1110,195,1950,269,3060
4128,2011-06-25,3,0,6,21,0,6,0,1,0.68,0.6364,0.51,0.1642,62,930,140,1400,202,2330
4129,2011-06-25,3,0,6,22,0,6,0,1,0.68,0.6364,0.47,0.194,61,915,126,1260,187,2175
4130,2011-06-25,3,0,6,23,0,6,0,2,0.66,0.6212,0.5,0.2985,49,735,130,1300,179,2035
4131,2011-06-26,3,0,6,0,0,0,0,1,0.64,0.6212,0.53,0.0,30,450,85,850,115,1300
4132,2011-06-26,3,0,6,1,0,0,0,1,0.64,0.6212,0.53,0.1045,17,255,73,730,90,985
4133,2011-06-26,3,0,6,2,0,0,0,1,0.62,0.6212,0.57,0.1045,17,255,70,700,87,955
4134,2011-06-26,3,0,6,3,0,0,0,1,0.6,0.6061,0.64,0.1045,12,180,22,220,34,400
4135,2011-06-26,3,0,6,4,0,0,0,1,0.6,0.6061,0.64,0.0896,3,45,8,80,11,125
4136,2011-06-26,3,0,6,5,0,0,0,1,0.6,0.6061,0.64,0.0,3,45,9,90,12,135
4137,2011-06-26,3,0,6,6,0,0,0,1,0.6,0.6061,0.64,0.0,7,105,13,130,20,235
4138,2011-06-26,3,0,6,7,0,0,0,1,0.62,0.6061,0.61,0.0,24,360,27,270,51,630
4139,2011-06-26,3,0,6,8,0,0,0,1,0.64,0.6212,0.61,0.194,29,435,78,780,107,1215
4140,2011-06-26,3,0,6,9,0,0,0,1,0.66,0.6212,0.54,0.0896,75,1125,131,1310,206,2435
4141,2011-06-26,3,0,6,10,0,0,0,1,0.72,0.6667,0.48,0.1045,136,2040,196,1960,332,4000
4142,2011-06-26,3,0,6,11,0,0,0,1,0.72,0.6515,0.45,0.1343,127,1905,219,2190,346,4095
4143,2011-06-26,3,0,6,12,0,0,0,1,0.74,0.6515,0.4,0.1642,175,2625,268,2680,443,5305
4144,2011-06-26,3,0,6,13,0,0,0,1,0.74,0.6515,0.4,0.0,197,2955,245,2450,442,5405
4145,2011-06-26,3,0,6,14,0,0,0,1,0.74,0.6515,0.4,0.1343,197,2955,246,2460,443,5415
4146,2011-06-26,3,0,6,15,0,0,0,1,0.74,0.6515,0.4,0.0,174,2610,229,2290,403,4900
4147,2011-06-26,3,0,6,16,0,0,0,1,0.74,0.6667,0.42,0.194,177,2655,278,2780,455,5435
4148,2011-06-26,3,0,6,17,0,0,0,2,0.72,0.6515,0.42,0.1642,178,2670,243,2430,421,5100
4149,2011-06-26,3,0,6,18,0,0,0,2,0.72,0.6515,0.45,0.2537,117,1755,265,2650,382,4405
4150,2011-06-26,3,0,6,19,0,0,0,2,0.72,0.6667,0.48,0.1343,89,1335,228,2280,317,3615
4151,2011-06-26,3,0,6,20,0,0,0,2,0.7,0.6515,0.48,0.1045,55,825,158,1580,213,2405
4152,2011-06-26,3,0,6,21,0,0,0,2,0.7,0.6515,0.54,0.1045,48,720,135,1350,183,2070
4153,2011-06-26,3,0,6,22,0,0,0,1,0.7,0.6515,0.51,0.0,19,285,95,950,114,1235
4154,2011-06-26,3,0,6,23,0,0,0,1,0.7,0.6515,0.54,0.0896,14,210,64,640,78,850
4155,2011-06-27,3,0,6,0,0,1,1,3,0.64,0.6061,0.73,0.2836,7,105,25,250,32,355
4156,2011-06-27,3,0,6,1,0,1,1,2,0.62,0.5909,0.78,0.1343,4,60,11,110,15,170
4157,2011-06-27,3,0,6,2,0,1,1,3,0.62,0.5909,0.78,0.1343,3,45,3,30,6,75
4158,2011-06-27,3,0,6,3,0,1,1,3,0.62,0.5909,0.78,0.1343,0,0,2,20,2,20
4159,2011-06-27,3,0,6,4,0,1,1,2,0.6,0.5606,0.83,0.1642,1,15,8,80,9,95
4160,2011-06-27,3,0,6,5,0,1,1,2,0.62,0.5758,0.83,0.1642,1,15,21,210,22,225
4161,2011-06-27,3,0,6,6,0,1,1,2,0.62,0.5909,0.78,0.1642,4,60,90,900,94,960
4162,2011-06-27,3,0,6,7,0,1,1,2,0.64,0.6061,0.73,0.2239,14,210,247,2470,261,2680
4163,2011-06-27,3,0,6,8,0,1,1,1,0.66,0.6212,0.74,0.194,29,435,418,4180,447,4615
4164,2011-06-27,3,0,6,9,0,1,1,2,0.72,0.6667,0.54,0.0,37,555,150,1500,187,2055
4165,2011-06-27,3,0,6,10,0,1,1,2,0.72,0.6667,0.54,0.1343,55,825,95,950,150,1775
4166,2011-06-27,3,0,6,11,0,1,1,2,0.7,0.6515,0.58,0.0,55,825,95,950,150,1775
4167,2011-06-27,3,0,6,12,0,1,1,2,0.72,0.6667,0.54,0.0,40,600,130,1300,170,1900
4168,2011-06-27,3,0,6,13,0,1,1,2,0.72,0.6667,0.58,0.2239,37,555,127,1270,164,1825
4169,2011-06-27,3,0,6,14,0,1,1,2,0.72,0.6667,0.58,0.0896,58,870,100,1000,158,1870
4170,2011-06-27,3,0,6,15,0,1,1,2,0.74,0.6818,0.55,0.0,76,1140,126,1260,202,2400
4171,2011-06-27,3,0,6,16,0,1,1,1,0.74,0.6818,0.55,0.1045,53,795,222,2220,275,3015
4172,2011-06-27,3,0,6,17,0,1,1,1,0.74,0.6818,0.55,0.1343,90,1350,514,5140,604,6490
4173,2011-06-27,3,0,6,18,0,1,1,1,0.74,0.6667,0.51,0.0,79,1185,512,5120,591,6305
4174,2011-06-27,3,0,6,19,0,1,1,1,0.72,0.6818,0.62,0.194,56,840,340,3400,396,4240
4175,2011-06-27,3,0,6,20,0,1,1,1,0.7,0.6515,0.65,0.1045,54,810,251,2510,305,3320
4176,2011-06-27,3,0,6,21,0,1,1,1,0.7,0.6515,0.65,0.0,52,780,190,1900,242,2680
4177,2011-06-27,3,0,6,22,0,1,1,1,0.68,0.6364,0.69,0.0,33,495,112,1120,145,1615
4178,2011-06-27,3,0,6,23,0,1,1,1,0.68,0.6364,0.69,0.0,16,240,65,650,81,890
4179,2011-06-28,3,0,6,0,0,2,1,2,0.66,0.6061,0.78,0.1343,5,75,25,250,30,325
4180,2011-06-28,3,0,6,1,0,2,1,1,0.66,0.6212,0.74,0.0,5,75,8,80,13,155
4181,2011-06-28,3,0,6,2,0,2,1,2,0.66,0.6212,0.74,0.0,2,30,9,90,11,120
4182,2011-06-28,3,0,6,3,0,2,1,2,0.66,0.6212,0.74,0.0,0,0,2,20,2,20
4183,2011-06-28,3,0,6,4,0,2,1,1,0.66,0.6212,0.74,0.0,1,15,7,70,8,85
4184,2011-06-28,3,0,6,5,0,2,1,1,0.66,0.6061,0.78,0.0,1,15,20,200,21,215
4185,2011-06-28,3,0,6,6,0,2,1,1,0.66,0.6061,0.83,0.1642,7,105,117,1170,124,1275
4186,2011-06-28,3,0,6,7,0,2,1,1,0.68,0.6364,0.83,0.194,27,405,320,3200,347,3605
4187,2011-06-28,3,0,6,8,0,2,1,1,0.7,0.6667,0.79,0.1642,39,585,417,4170,456,4755
4188,2011-06-28,3,0,6,9,0,2,1,1,0.74,0.697,0.7,0.0,38,570,208,2080,246,2650
4189,2011-06-28,3,0,6,10,0,2,1,1,0.8,0.7424,0.49,0.1642,45,675,112,1120,157,1795
4190,2011-06-28,3,0,6,11,0,2,1,1,0.82,0.7576,0.46,0.0,49,735,118,1180,167,1915
4191,2011-06-28,3,0,6,12,0,2,1,1,0.84,0.7727,0.47,0.2239,41,615,161,1610,202,2225
4192,2011-06-28,3,0,6,13,0,2,1,1,0.84,0.7576,0.44,0.0,33,495,156,1560,189,2055
4193,2011-06-28,3,0,6,14,0,2,1,1,0.86,0.7879,0.44,0.2239,43,645,117,1170,160,1815
4194,2011-06-28,3,0,6,15,0,2,1,1,0.86,0.7879,0.41,0.0,39,585,127,1270,166,1855
4195,2011-06-28,3,0,6,16,0,2,1,1,0.86,0.803,0.47,0.2836,41,615,220,2200,261,2815
4196,2011-06-28,3,0,6,17,0,2,1,3,0.82,0.7879,0.56,0.2836,70,1050,509,5090,579,6140
4197,2011-06-28,3,0,6,18,0,2,1,3,0.8,0.7576,0.55,0.2985,68,1020,436,4360,504,5380
4198,2011-06-28,3,0,6,19,0,2,1,2,0.74,0.6818,0.58,0.4627,44,660,255,2550,299,3210
4199,2011-06-28,3,0,6,20,0,2,1,1,0.74,0.6818,0.62,0.0,50,750,246,2460,296,3210
4200,2011-06-28,3,0,6,21,0,2,1,1,0.74,0.697,0.66,0.2836,31,465,164,1640,195,2105
4201,2011-06-28,3,0,6,22,0,2,1,1,0.7,0.6515,0.7,0.2985,30,450,104,1040,134,1490
4202,2011-06-28,3,0,6,23,0,2,1,1,0.7,0.6515,0.7,0.2836,23,345,58,580,81,925
4203,2011-06-29,3,0,6,0,0,3,1,2,0.68,0.6364,0.79,0.2836,11,165,25,250,36,415
4204,2011-06-29,3,0,6,1,0,3,1,1,0.68,0.6364,0.79,0.2985,10,150,18,180,28,330
4205,2011-06-29,3,0,6,2,0,3,1,1,0.66,0.6061,0.83,0.2239,7,105,9,90,16,195
4206,2011-06-29,3,0,6,3,0,3,1,2,0.66,0.6061,0.83,0.1045,2,30,3,30,5,60
4207,2011-06-29,3,0,6,4,0,3,1,1,0.66,0.6061,0.83,0.1045,0,0,5,50,5,50
4208,2011-06-29,3,0,6,5,0,3,1,1,0.64,0.5758,0.83,0.194,3,45,19,190,22,235
4209,2011-06-29,3,0,6,6,0,3,1,1,0.66,0.6212,0.69,0.2985,12,180,104,1040,116,1220
4210,2011-06-29,3,0,6,7,0,3,1,1,0.7,0.6515,0.54,0.2239,18,270,318,3180,336,3450
4211,2011-06-29,3,0,6,8,0,3,1,1,0.7,0.6515,0.48,0.2836,41,615,499,4990,540,5605
4212,2011-06-29,3,0,6,9,0,3,1,1,0.72,0.6515,0.45,0.3881,32,480,189,1890,221,2370
4213,2011-06-29,3,0,6,10,0,3,1,1,0.74,0.6667,0.42,0.2836,31,465,95,950,126,1415
4214,2011-06-29,3,0,6,11,0,3,1,1,0.76,0.6667,0.35,0.2239,53,795,117,1170,170,1965
4215,2011-06-29,3,0,6,12,0,3,1,1,0.76,0.6667,0.35,0.2537,55,825,188,1880,243,2705
4216,2011-06-29,3,0,6,13,0,3,1,1,0.8,0.697,0.31,0.3284,45,675,186,1860,231,2535
4217,2011-06-29,3,0,6,14,0,3,1,1,0.8,0.697,0.31,0.194,50,750,138,1380,188,2130
4218,2011-06-29,3,0,6,15,0,3,1,1,0.82,0.7121,0.3,0.1642,43,645,146,1460,189,2105
4219,2011-06-29,3,0,6,16,0,3,1,1,0.82,0.7121,0.3,0.4179,60,900,268,2680,328,3580
4220,2011-06-29,3,0,6,17,0,3,1,1,0.82,0.7121,0.26,0.4179,78,1170,492,4920,570,6090
4221,2011-06-29,3,0,6,18,0,3,1,1,0.8,0.697,0.29,0.2985,78,1170,510,5100,588,6270
4222,2011-06-29,3,0,6,19,0,3,1,1,0.76,0.6667,0.35,0.3881,60,900,341,3410,401,4310
4223,2011-06-29,3,0,6,20,0,3,1,1,0.74,0.6515,0.37,0.2985,69,1035,264,2640,333,3675
4224,2011-06-29,3,0,6,21,0,3,1,1,0.72,0.6515,0.39,0.2239,26,390,195,1950,221,2340
4225,2011-06-29,3,0,6,22,0,3,1,1,0.7,0.6364,0.42,0.194,32,480,151,1510,183,1990
4226,2011-06-29,3,0,6,23,0,3,1,1,0.68,0.6364,0.47,0.194,32,480,97,970,129,1450
4227,2011-06-30,3,0,6,0,0,4,1,1,0.66,0.6212,0.5,0.1642,15,225,39,390,54,615
4228,2011-06-30,3,0,6,1,0,4,1,1,0.64,0.6212,0.53,0.1343,13,195,19,190,32,385
4229,2011-06-30,3,0,6,2,0,4,1,1,0.62,0.6212,0.57,0.1343,2,30,6,60,8,90
4230,2011-06-30,3,0,6,3,0,4,1,1,0.6,0.6061,0.6,0.1642,2,30,7,70,9,100
4231,2011-06-30,3,0,6,4,0,4,1,1,0.58,0.5455,0.64,0.1343,2,30,4,40,6,70
4232,2011-06-30,3,0,6,5,0,4,1,1,0.58,0.5455,0.64,0.2537,1,15,24,240,25,255
4233,2011-06-30,3,0,6,6,0,4,1,1,0.6,0.6061,0.64,0.2537,4,60,119,1190,123,1250
4234,2011-06-30,3,0,6,7,0,4,1,1,0.62,0.6061,0.61,0.2239,29,435,291,2910,320,3345
4235,2011-06-30,3,0,6,8,0,4,1,1,0.68,0.6364,0.47,0.2239,44,660,511,5110,555,5770
4236,2011-06-30,3,0,6,9,0,4,1,1,0.7,0.6364,0.42,0.2239,33,495,227,2270,260,2765
4237,2011-06-30,3,0,6,10,0,4,1,1,0.72,0.6515,0.42,0.194,35,525,97,970,132,1495
4238,2011-06-30,3,0,6,11,0,4,1,1,0.74,0.6515,0.37,0.1343,47,705,122,1220,169,1925
4239,2011-06-30,3,0,6,12,0,4,1,1,0.76,0.6667,0.35,0.1642,50,750,183,1830,233,2580
4240,2011-06-30,3,0,6,13,0,4,1,1,0.76,0.6667,0.33,0.194,70,1050,162,1620,232,2670
4241,2011-06-30,3,0,6,14,0,4,1,1,0.78,0.6818,0.31,0.194,46,690,117,1170,163,1860
4242,2011-06-30,3,0,6,15,0,4,1,1,0.78,0.6667,0.25,0.2537,64,960,176,1760,240,2720
4243,2011-06-30,3,0,6,16,0,4,1,1,0.8,0.697,0.26,0.1343,63,945,260,2600,323,3545
4244,2011-06-30,3,0,6,17,0,4,1,1,0.78,0.6818,0.27,0.3582,98,1470,496,4960,594,6430
4245,2011-06-30,3,0,6,18,0,4,1,1,0.76,0.6667,0.29,0.2537,114,1710,472,4720,586,6430
4246,2011-06-30,3,0,6,19,0,4,1,1,0.74,0.6515,0.33,0.194,89,1335,366,3660,455,4995
4247,2011-06-30,3,0,6,20,0,4,1,1,0.74,0.6515,0.33,0.194,55,825,285,2850,340,3675
4248,2011-06-30,3,0,6,21,0,4,1,1,0.72,0.6515,0.37,0.1045,81,1215,242,2420,323,3635
4249,2011-06-30,3,0,6,22,0,4,1,1,0.7,0.6364,0.42,0.1642,43,645,164,1640,207,2285
4250,2011-06-30,3,0,6,23,0,4,1,1,0.66,0.6212,0.5,0.0,27,405,99,990,126,1395
4251,2011-07-01,3,0,7,0,0,5,1,1,0.66,0.6212,0.5,0.0,20,300,48,480,68,780
4252,2011-07-01,3,0,7,1,0,5,1,1,0.66,0.6212,0.5,0.0,15,225,16,160,31,385
4253,2011-07-01,3,0,7,2,0,5,1,1,0.62,0.6061,0.69,0.0,6,90,7,70,13,160
4254,2011-07-01,3,0,7,3,0,5,1,1,0.64,0.6212,0.53,0.0,5,75,6,60,11,135
4255,2011-07-01,3,0,7,4,0,5,1,1,0.62,0.6212,0.57,0.0,1,15,5,50,6,65
4256,2011-07-01,3,0,7,5,0,5,1,1,0.6,0.6061,0.64,0.1343,3,45,27,270,30,315
4257,2011-07-01,3,0,7,6,0,5,1,1,0.62,0.6061,0.61,0.1343,11,165,97,970,108,1135
4258,2011-07-01,3,0,7,7,0,5,1,1,0.66,0.6212,0.54,0.1045,25,375,218,2180,243,2555
4259,2011-07-01,3,0,7,8,0,5,1,1,0.7,0.6364,0.42,0.1642,39,585,453,4530,492,5115
4260,2011-07-01,3,0,7,9,0,5,1,1,0.74,0.6515,0.35,0.1642,58,870,202,2020,260,2890
4261,2011-07-01,3,0,7,10,0,5,1,1,0.76,0.6667,0.33,0.1642,61,915,109,1090,170,2005
4262,2011-07-01,3,0,7,11,0,5,1,1,0.8,0.697,0.26,0.0,68,1020,146,1460,214,2480
4263,2011-07-01,3,0,7,12,0,5,1,1,0.8,0.697,0.26,0.0,83,1245,180,1800,263,3045
4264,2011-07-01,3,0,7,13,0,5,1,1,0.8,0.6818,0.24,0.0,83,1245,209,2090,292,3335
4265,2011-07-01,3,0,7,14,0,5,1,1,0.82,0.697,0.23,0.194,78,1170,225,2250,303,3420
4266,2011-07-01,3,0,7,15,0,5,1,1,0.82,0.697,0.21,0.2537,82,1230,299,2990,381,4220
4267,2011-07-01,3,0,7,16,0,5,1,1,0.82,0.697,0.17,0.0,85,1275,342,3420,427,4695
4268,2011-07-01,3,0,7,17,0,5,1,1,0.82,0.697,0.21,0.194,99,1485,362,3620,461,5105
4269,2011-07-01,3,0,7,18,0,5,1,1,0.8,0.6818,0.24,0.2537,98,1470,324,3240,422,4710
4270,2011-07-01,3,0,7,19,0,5,1,1,0.78,0.6667,0.25,0.194,80,1200,238,2380,318,3580
4271,2011-07-01,3,0,7,20,0,5,1,1,0.72,0.6515,0.42,0.2239,84,1260,185,1850,269,3110
4272,2011-07-01,3,0,7,21,0,5,1,1,0.7,0.6364,0.45,0.194,69,1035,149,1490,218,2525
4273,2011-07-01,3,0,7,22,0,5,1,1,0.7,0.6364,0.42,0.0,49,735,173,1730,222,2465
4274,2011-07-01,3,0,7,23,0,5,1,1,0.68,0.6364,0.47,0.0896,44,660,96,960,140,1620
4275,2011-07-02,3,0,7,0,0,6,0,1,0.68,0.6364,0.47,0.0896,31,465,84,840,115,1305
4276,2011-07-02,3,0,7,1,0,6,0,1,0.66,0.6212,0.54,0.0,20,300,58,580,78,880
4277,2011-07-02,3,0,7,2,0,6,0,1,0.64,0.6212,0.53,0.0,9,135,43,430,52,565
4278,2011-07-02,3,0,7,3,0,6,0,1,0.64,0.6212,0.53,0.0,5,75,21,210,26,285
4279,2011-07-02,3,0,7,4,0,6,0,1,0.62,0.6061,0.61,0.0,3,45,8,80,11,125
4280,2011-07-02,3,0,7,5,0,6,0,1,0.58,0.5455,0.73,0.1045,1,15,13,130,14,145
4281,2011-07-02,3,0,7,6,0,6,0,1,0.62,0.6061,0.69,0.1045,11,165,21,210,32,375
4282,2011-07-02,3,0,7,7,0,6,0,1,0.64,0.6061,0.65,0.0,10,150,35,350,45,500
4283,2011-07-02,3,0,7,8,0,6,0,1,0.68,0.6364,0.57,0.0,38,570,94,940,132,1510
4284,2011-07-02,3,0,7,9,0,6,0,1,0.74,0.6667,0.51,0.0896,55,825,124,1240,179,2065
4285,2011-07-02,3,0,7,10,0,6,0,1,0.8,0.7121,0.36,0.0,103,1545,168,1680,271,3225
4286,2011-07-02,3,0,7,11,0,6,0,1,0.8,0.7121,0.36,0.0896,144,2160,213,2130,357,4290
4287,2011-07-02,3,0,7,12,0,6,0,1,0.82,0.7121,0.3,0.1343,142,2130,232,2320,374,4450
4288,2011-07-02,3,0,7,13,0,6,0,1,0.82,0.7121,0.3,0.1045,178,2670,226,2260,404,4930
4289,2011-07-02,3,0,7,14,0,6,0,1,0.84,0.7121,0.2,0.0,177,2655,215,2150,392,4805
4290,2011-07-02,3,0,7,15,0,6,0,1,0.86,0.7273,0.19,0.1642,168,2520,163,1630,331,4150
4291,2011-07-02,3,0,7,16,0,6,0,1,0.88,0.7424,0.22,0.2239,206,3090,192,1920,398,5010
4292,2011-07-02,3,0,7,17,0,6,0,1,0.84,0.7273,0.3,0.2239,179,2685,170,1700,349,4385
4293,2011-07-02,3,0,7,18,0,6,0,1,0.82,0.7121,0.3,0.2836,193,2895,190,1900,383,4795
4294,2011-07-02,3,0,7,19,0,6,0,1,0.8,0.697,0.33,0.2239,156,2340,149,1490,305,3830
4295,2011-07-02,3,0,7,20,0,6,0,1,0.76,0.6818,0.45,0.2836,136,2040,148,1480,284,3520
4296,2011-07-02,3,0,7,21,0,6,0,1,0.74,0.6667,0.48,0.194,95,1425,137,1370,232,2795
4297,2011-07-02,3,0,7,22,0,6,0,1,0.72,0.6667,0.51,0.1642,78,1170,123,1230,201,2400
4298,2011-07-02,3,0,7,23,0,6,0,1,0.72,0.6667,0.54,0.2836,66,990,88,880,154,1870
4299,2011-07-03,3,0,7,0,0,0,0,1,0.7,0.6515,0.58,0.2239,47,705,97,970,144,1675
4300,2011-07-03,3,0,7,1,0,0,0,2,0.7,0.6515,0.61,0.1642,23,345,55,550,78,895
4301,2011-07-03,3,0,7,2,0,0,0,1,0.7,0.6515,0.58,0.194,19,285,50,500,69,785
4302,2011-07-03,3,0,7,3,0,0,0,3,0.68,0.6364,0.65,0.0896,8,120,25,250,33,370
4303,2011-07-03,3,0,7,4,0,0,0,3,0.68,0.6364,0.65,0.0896,3,45,2,20,5,65
4304,2011-07-03,3,0,7,5,0,0,0,3,0.62,0.5758,0.83,0.194,0,0,1,10,1,10
4305,2011-07-03,3,0,7,6,0,0,0,2,0.62,0.5455,0.94,0.0896,0,0,3,30,3,30
4306,2011-07-03,3,0,7,7,0,0,0,2,0.64,0.5758,0.89,0.194,3,45,22,220,25,265
4307,2011-07-03,3,0,7,8,0,0,0,1,0.68,0.6364,0.79,0.2239,39,585,53,530,92,1115
4308,2011-07-03,3,0,7,9,0,0,0,1,0.7,0.6667,0.74,0.2537,82,1230,99,990,181,2220
4309,2011-07-03,3,0,7,10,0,0,0,1,0.74,0.697,0.66,0.1642,131,1965,133,1330,264,3295
4310,2011-07-03,3,0,7,11,0,0,0,1,0.76,0.7121,0.62,0.1045,215,3225,175,1750,390,4975
4311,2011-07-03,3,0,7,12,0,0,0,1,0.8,0.7576,0.55,0.1045,198,2970,206,2060,404,5030
4312,2011-07-03,3,0,7,13,0,0,0,1,0.8,0.7727,0.59,0.2239,248,3720,173,1730,421,5450
4313,2011-07-03,3,0,7,14,0,0,0,1,0.82,0.7879,0.56,0.2537,225,3375,150,1500,375,4875
4314,2011-07-03,3,0,7,15,0,0,0,1,0.84,0.803,0.53,0.2985,194,2910,182,1820,376,4730
4315,2011-07-03,3,0,7,16,0,0,0,1,0.84,0.803,0.53,0.2985,195,2925,219,2190,414,5115
4316,2011-07-03,3,0,7,17,0,0,0,3,0.8,0.7424,0.49,0.8507,181,2715,177,1770,358,4485
4317,2011-07-03,3,0,7,18,0,0,0,3,0.8,0.7424,0.49,0.8507,74,1110,107,1070,181,2180
4318,2011-07-03,3,0,7,19,0,0,0,2,0.66,0.6061,0.83,0.194,100,1500,83,830,183,2330
4319,2011-07-03,3,0,7,20,0,0,0,3,0.66,0.6061,0.83,0.0,83,1245,93,930,176,2175
4320,2011-07-03,3,0,7,21,0,0,0,2,0.66,0.6061,0.83,0.1642,75,1125,92,920,167,2045
4321,2011-07-03,3,0,7,22,0,0,0,2,0.66,0.6061,0.78,0.1045,69,1035,93,930,162,1965
4322,2011-07-03,3,0,7,23,0,0,0,1,0.64,0.5758,0.83,0.1642,70,1050,77,770,147,1820
4323,2011-07-04,3,0,7,0,1,1,0,1,0.64,0.5758,0.83,0.1343,63,945,77,770,140,1715
4324,2011-07-04,3,0,7,1,1,1,0,1,0.64,0.5758,0.83,0.0896,43,645,76,760,119,1405
4325,2011-07-04,3,0,7,2,1,1,0,1,0.64,0.5758,0.83,0.0,33,495,30,300,63,795
4326,2011-07-04,3,0,7,3,1,1,0,1,0.64,0.5909,0.78,0.0,13,195,13,130,26,325
4327,2011-07-04,3,0,7,4,1,1,0,2,0.66,0.6061,0.78,0.0896,8,120,4,40,12,160
4328,2011-07-04,3,0,7,5,1,1,0,2,0.64,0.5758,0.83,0.1343,1,15,3,30,4,45
4329,2011-07-04,3,0,7,6,1,1,0,1,0.64,0.5758,0.89,0.1642,5,75,11,110,16,185
4330,2011-07-04,3,0,7,7,1,1,0,1,0.66,0.6061,0.83,0.1343,17,255,19,190,36,445
4331,2011-07-04,3,0,7,8,1,1,0,1,0.7,0.6667,0.74,0.1045,42,630,44,440,86,1070
4332,2011-07-04,3,0,7,9,1,1,0,2,0.72,0.6818,0.66,0.0896,142,2130,96,960,238,3090
4333,2011-07-04,3,0,7,10,1,1,0,2,0.76,0.697,0.55,0.0896,166,2490,114,1140,280,3630
4334,2011-07-04,3,0,7,11,1,1,0,2,0.76,0.697,0.55,0.0896,177,2655,172,1720,349,4375
4335,2011-07-04,3,0,7,12,1,1,0,2,0.78,0.7121,0.52,0.0,237,3555,210,2100,447,5655
4336,2011-07-04,3,0,7,13,1,1,0,2,0.78,0.7121,0.49,0.0,242,3630,181,1810,423,5440
4337,2011-07-04,3,0,7,14,1,1,0,1,0.8,0.7273,0.46,0.0,235,3525,173,1730,408,5255
4338,2011-07-04,3,0,7,15,1,1,0,1,0.82,0.7424,0.43,0.0896,224,3360,184,1840,408,5200
4339,2011-07-04,3,0,7,16,1,1,0,1,0.82,0.7424,0.41,0.0,236,3540,216,2160,452,5700
4340,2011-07-04,3,0,7,17,1,1,0,1,0.8,0.7273,0.46,0.0,240,3600,196,1960,436,5560
4341,2011-07-04,3,0,7,18,1,1,0,1,0.8,0.7273,0.46,0.1343,222,3330,196,1960,418,5290
4342,2011-07-04,3,0,7,19,1,1,0,2,0.78,0.7121,0.49,0.1642,170,2550,205,2050,375,4600
4343,2011-07-04,3,0,7,20,1,1,0,2,0.76,0.697,0.55,0.1045,195,2925,191,1910,386,4835
4344,2011-07-04,3,0,7,21,1,1,0,2,0.74,0.6818,0.62,0.1045,195,2925,262,2620,457,5545
4345,2011-07-04,3,0,7,22,1,1,0,2,0.74,0.6818,0.62,0.1343,115,1725,211,2110,326,3835
4346,2011-07-04,3,0,7,23,1,1,0,2,0.72,0.6818,0.7,0.1045,44,660,94,940,138,1600
4347,2011-07-05,3,0,7,0,0,2,1,2,0.7,0.6515,0.65,0.1642,19,285,36,360,55,645
4348,2011-07-05,3,0,7,1,0,2,1,1,0.7,0.6515,0.65,0.1045,15,225,24,240,39,465
4349,2011-07-05,3,0,7,2,0,2,1,1,0.66,0.6212,0.74,0.0896,8,120,5,50,13,170
4350,2011-07-05,3,0,7,3,0,2,1,1,0.66,0.6212,0.74,0.2239,1,15,7,70,8,85
4351,2011-07-05,3,0,7,4,0,2,1,1,0.66,0.6212,0.69,0.1642,1,15,4,40,5,55
4352,2011-07-05,3,0,7,5,0,2,1,1,0.66,0.6212,0.69,0.0,1,15,19,190,20,205
4353,2011-07-05,3,0,7,6,0,2,1,1,0.66,0.6212,0.74,0.0896,3,45,91,910,94,955
4354,2011-07-05,3,0,7,7,0,2,1,1,0.7,0.6515,0.65,0.0896,22,330,248,2480,270,2810
4355,2011-07-05,3,0,7,8,0,2,1,1,0.72,0.6818,0.62,0.1343,41,615,391,3910,432,4525
4356,2011-07-05,3,0,7,9,0,2,1,1,0.74,0.6818,0.58,0.1343,50,750,177,1770,227,2520
4357,2011-07-05,3,0,7,10,0,2,1,1,0.76,0.697,0.52,0.1045,55,825,84,840,139,1665
4358,2011-07-05,3,0,7,11,0,2,1,1,0.78,0.697,0.46,0.1045,75,1125,97,970,172,2095
4359,2011-07-05,3,0,7,12,0,2,1,1,0.8,0.7273,0.43,0.1045,71,1065,130,1300,201,2365
4360,2011-07-05,3,0,7,13,0,2,1,1,0.82,0.7424,0.43,0.1045,67,1005,136,1360,203,2365
4361,2011-07-05,3,0,7,14,0,2,1,1,0.8,0.7424,0.49,0.1642,66,990,112,1120,178,2110
4362,2011-07-05,3,0,7,15,0,2,1,1,0.82,0.7424,0.43,0.0,51,765,111,1110,162,1875
4363,2011-07-05,3,0,7,16,0,2,1,1,0.82,0.7576,0.46,0.1045,79,1185,202,2020,281,3205
4364,2011-07-05,3,0,7,17,0,2,1,1,0.82,0.7576,0.46,0.1045,79,1185,466,4660,545,5845
4365,2011-07-05,3,0,7,18,0,2,1,1,0.8,0.7576,0.55,0.1642,70,1050,426,4260,496,5310
4366,2011-07-05,3,0,7,19,0,2,1,1,0.8,0.7727,0.59,0.1343,71,1065,297,2970,368,4035
4367,2011-07-05,3,0,7,20,0,2,1,1,0.76,0.7273,0.66,0.1045,59,885,225,2250,284,3135
4368,2011-07-05,3,0,7,21,0,2,1,1,0.78,0.7424,0.62,0.2537,77,1155,168,1680,245,2835
4369,2011-07-05,3,0,7,22,0,2,1,1,0.76,0.7273,0.66,0.2239,31,465,124,1240,155,1705
4370,2011-07-05,3,0,7,23,0,2,1,1,0.74,0.697,0.66,0.1642,19,285,54,540,73,825
4371,2011-07-06,3,0,7,0,0,3,1,1,0.72,0.697,0.74,0.194,11,165,26,260,37,425
4372,2011-07-06,3,0,7,1,0,3,1,1,0.7,0.6667,0.74,0.1343,4,60,11,110,15,170
4373,2011-07-06,3,0,7,2,0,3,1,1,0.7,0.6667,0.79,0.0896,1,15,4,40,5,55
4374,2011-07-06,3,0,7,3,0,3,1,1,0.7,0.6667,0.79,0.0,0,0,6,60,6,60
4375,2011-07-06,3,0,7,4,0,3,1,2,0.68,0.6364,0.83,0.0896,0,0,6,60,6,60
4376,2011-07-06,3,0,7,5,0,3,1,1,0.68,0.6364,0.83,0.0896,5,75,30,300,35,375
4377,2011-07-06,3,0,7,6,0,3,1,1,0.7,0.6667,0.79,0.0896,9,135,112,1120,121,1255
4378,2011-07-06,3,0,7,7,0,3,1,2,0.72,0.697,0.79,0.0,24,360,288,2880,312,3240
4379,2011-07-06,3,0,7,8,0,3,1,2,0.72,0.697,0.74,0.1045,31,465,397,3970,428,4435
4380,2011-07-06,3,0,7,9,0,3,1,3,0.7,0.6667,0.79,0.194,31,465,158,1580,189,2045
4381,2011-07-06,3,0,7,10,0,3,1,3,0.7,0.6667,0.79,0.0896,13,195,30,300,43,495
4382,2011-07-06,3,0,7,11,0,3,1,2,0.72,0.697,0.74,0.0,24,360,103,1030,127,1390
4383,2011-07-06,3,0,7,12,0,3,1,2,0.74,0.697,0.66,0.0896,38,570,114,1140,152,1710
4384,2011-07-06,3,0,7,13,0,3,1,2,0.74,0.697,0.7,0.1045,33,495,107,1070,140,1565
4385,2011-07-06,3,0,7,14,0,3,1,1,0.76,0.7273,0.66,0.2836,50,750,113,1130,163,1880
4386,2011-07-06,3,0,7,15,0,3,1,1,0.76,0.7273,0.7,0.2836,55,825,130,1300,185,2125
4387,2011-07-06,3,0,7,16,0,3,1,1,0.76,0.7273,0.7,0.2537,57,855,218,2180,275,3035
4388,2011-07-06,3,0,7,17,0,3,1,1,0.78,0.7424,0.59,0.2239,79,1185,517,5170,596,6355
4389,2011-07-06,3,0,7,18,0,3,1,1,0.76,0.7121,0.62,0.194,77,1155,486,4860,563,6015
4390,2011-07-06,3,0,7,19,0,3,1,1,0.74,0.697,0.7,0.2239,71,1065,323,3230,394,4295
4391,2011-07-06,3,0,7,20,0,3,1,1,0.72,0.697,0.74,0.2537,55,825,257,2570,312,3395
4392,2011-07-06,3,0,7,21,0,3,1,1,0.7,0.6667,0.79,0.194,66,990,175,1750,241,2740
4393,2011-07-06,3,0,7,22,0,3,1,1,0.7,0.6667,0.79,0.194,30,450,156,1560,186,2010
4394,2011-07-06,3,0,7,23,0,3,1,1,0.68,0.6364,0.83,0.2239,20,300,78,780,98,1080
4395,2011-07-07,3,0,7,0,0,4,1,1,0.66,0.5909,0.89,0.1343,6,90,29,290,35,380
4396,2011-07-07,3,0,7,1,0,4,1,1,0.66,0.5909,0.89,0.194,2,30,14,140,16,170
4397,2011-07-07,3,0,7,2,0,4,1,1,0.66,0.5909,0.89,0.194,1,15,7,70,8,85
4398,2011-07-07,3,0,7,3,0,4,1,1,0.64,0.5606,0.94,0.1045,2,30,2,20,4,50
4399,2011-07-07,3,0,7,4,0,4,1,1,0.64,0.5758,0.89,0.1045,0,0,4,40,4,40
4400,2011-07-07,3,0,7,5,0,4,1,1,0.64,0.5758,0.89,0.1045,2,30,30,300,32,330
4401,2011-07-07,3,0,7,6,0,4,1,2,0.64,0.5758,0.89,0.1343,11,165,107,1070,118,1235
4402,2011-07-07,3,0,7,7,0,4,1,2,0.66,0.5909,0.89,0.1045,13,195,279,2790,292,2985
4403,2011-07-07,3,0,7,8,0,4,1,2,0.7,0.6667,0.79,0.194,28,420,415,4150,443,4570
4404,2011-07-07,3,0,7,9,0,4,1,1,0.74,0.697,0.7,0.1642,25,375,154,1540,179,1915
4405,2011-07-07,3,0,7,10,0,4,1,1,0.78,0.7424,0.62,0.0,29,435,72,720,101,1155
4406,2011-07-07,3,0,7,11,0,4,1,1,0.82,0.7727,0.52,0.1343,30,450,112,1120,142,1570
4407,2011-07-07,3,0,7,12,0,4,1,1,0.84,0.7727,0.41,0.0,32,480,139,1390,171,1870
4408,2011-07-07,3,0,7,13,0,4,1,1,0.86,0.7879,0.41,0.0,48,720,107,1070,155,1790
4409,2011-07-07,3,0,7,14,0,4,1,1,0.86,0.7879,0.41,0.2537,39,585,121,1210,160,1795
4410,2011-07-07,3,0,7,15,0,4,1,1,0.86,0.7879,0.41,0.2537,47,705,119,1190,166,1895
4411,2011-07-07,3,0,7,16,0,4,1,1,0.86,0.7727,0.39,0.2239,47,705,218,2180,265,2885
4412,2011-07-07,3,0,7,17,0,4,1,1,0.86,0.7576,0.36,0.2537,80,1200,489,4890,569,6090
4413,2011-07-07,3,0,7,18,0,4,1,1,0.84,0.7576,0.44,0.2985,70,1050,492,4920,562,5970
4414,2011-07-07,3,0,7,19,0,4,1,1,0.82,0.7727,0.52,0.2836,79,1185,286,2860,365,4045
4415,2011-07-07,3,0,7,20,0,4,1,1,0.76,0.7121,0.58,0.3582,61,915,224,2240,285,3155
4416,2011-07-07,3,0,7,21,0,4,1,1,0.74,0.6818,0.62,0.1642,39,585,170,1700,209,2285
4417,2011-07-07,3,0,7,22,0,4,1,1,0.74,0.6818,0.62,0.1642,32,480,150,1500,182,1980
4418,2011-07-07,3,0,7,23,0,4,1,1,0.72,0.6818,0.66,0.0,31,465,98,980,129,1445
4419,2011-07-08,3,0,7,0,0,5,1,1,0.74,0.697,0.66,0.1045,6,90,41,410,47,500
4420,2011-07-08,3,0,7,1,0,5,1,1,0.72,0.697,0.79,0.0,9,135,25,250,34,385
4421,2011-07-08,3,0,7,2,0,5,1,2,0.7,0.6667,0.74,0.1642,10,150,12,120,22,270
4422,2011-07-08,3,0,7,3,0,5,1,1,0.68,0.6364,0.79,0.1045,2,30,4,40,6,70
4423,2011-07-08,3,0,7,4,0,5,1,1,0.7,0.6667,0.79,0.2537,7,105,4,40,11,145
4424,2011-07-08,3,0,7,5,0,5,1,1,0.68,0.6364,0.79,0.2537,3,45,24,240,27,285
4425,2011-07-08,3,0,7,6,0,5,1,1,0.7,0.6667,0.74,0.1045,11,165,91,910,102,1075
4426,2011-07-08,3,0,7,7,0,5,1,2,0.7,0.6667,0.79,0.194,30,450,302,3020,332,3470
4427,2011-07-08,3,0,7,8,0,5,1,2,0.72,0.697,0.74,0.2537,36,540,421,4210,457,4750
4428,2011-07-08,3,0,7,9,0,5,1,2,0.76,0.7273,0.7,0.2985,30,450,211,2110,241,2560
4429,2011-07-08,3,0,7,10,0,5,1,2,0.74,0.697,0.7,0.3582,30,450,108,1080,138,1530
4430,2011-07-08,3,0,7,11,0,5,1,2,0.74,0.7121,0.74,0.2537,61,915,104,1040,165,1955
4431,2011-07-08,3,0,7,12,0,5,1,2,0.76,0.7273,0.7,0.2836,49,735,164,1640,213,2375
4432,2011-07-08,3,0,7,13,0,5,1,2,0.78,0.7576,0.66,0.2836,54,810,175,1750,229,2560
4433,2011-07-08,3,0,7,14,0,5,1,2,0.8,0.7879,0.63,0.3582,53,795,163,1630,216,2425
4434,2011-07-08,3,0,7,15,0,5,1,2,0.8,0.7879,0.63,0.3582,39,585,102,1020,141,1605
4435,2011-07-08,3,0,7,16,0,5,1,3,0.68,0.6364,0.83,0.4478,27,405,105,1050,132,1455
4436,2011-07-08,3,0,7,17,0,5,1,3,0.66,0.5909,0.89,0.4478,6,90,161,1610,167,1700
4437,2011-07-08,3,0,7,18,0,5,1,1,0.66,0.6061,0.83,0.0896,35,525,281,2810,316,3335
4438,2011-07-08,3,0,7,19,0,5,1,1,0.66,0.6061,0.83,0.0896,45,675,225,2250,270,2925
4439,2011-07-08,3,0,7,20,0,5,1,1,0.66,0.6061,0.83,0.1642,30,450,220,2200,250,2650
4440,2011-07-08,3,0,7,21,0,5,1,2,0.66,0.6061,0.83,0.2537,46,690,158,1580,204,2270
4441,2011-07-08,3,0,7,22,0,5,1,2,0.66,0.6061,0.78,0.194,33,495,136,1360,169,1855
4442,2011-07-08,3,0,7,23,0,5,1,2,0.66,0.6061,0.78,0.0896,40,600,111,1110,151,1710
4443,2011-07-09,3,0,7,0,0,6,0,2,0.66,0.6061,0.83,0.1343,31,465,90,900,121,1365
4444,2011-07-09,3,0,7,1,0,6,0,2,0.64,0.5758,0.89,0.1045,5,75,48,480,53,555
4445,2011-07-09,3,0,7,2,0,6,0,1,0.64,0.5758,0.89,0.1642,12,180,43,430,55,610
4446,2011-07-09,3,0,7,3,0,6,0,1,0.64,0.5758,0.89,0.1343,7,105,23,230,30,335
4447,2011-07-09,3,0,7,4,0,6,0,1,0.64,0.5758,0.83,0.2239,2,30,4,40,6,70
4448,2011-07-09,3,0,7,5,0,6,0,2,0.62,0.5606,0.88,0.1642,4,60,11,110,15,170
4449,2011-07-09,3,0,7,6,0,6,0,2,0.64,0.5758,0.83,0.194,11,165,27,270,38,435
4450,2011-07-09,3,0,7,7,0,6,0,1,0.66,0.6061,0.78,0.194,21,315,50,500,71,815
4451,2011-07-09,3,0,7,8,0,6,0,1,0.7,0.6515,0.7,0.2537,68,1020,114,1140,182,2160
4452,2011-07-09,3,0,7,9,0,6,0,1,0.74,0.6818,0.58,0.2836,77,1155,170,1700,247,2855
4453,2011-07-09,3,0,7,10,0,6,0,1,0.76,0.697,0.52,0.1642,87,1305,177,1770,264,3075
4454,2011-07-09,3,0,7,11,0,6,0,1,0.78,0.697,0.46,0.2985,101,1515,189,1890,290,3405
4455,2011-07-09,3,0,7,12,0,6,0,1,0.8,0.7273,0.46,0.2537,145,2175,221,2210,366,4385
4456,2011-07-09,3,0,7,13,0,6,0,1,0.82,0.7424,0.41,0.2239,167,2505,249,2490,416,4995
4457,2011-07-09,3,0,7,14,0,6,0,1,0.84,0.7424,0.36,0.1343,158,2370,215,2150,373,4520
4458,2011-07-09,3,0,7,15,0,6,0,1,0.84,0.7273,0.34,0.0896,182,2730,220,2200,402,4930
4459,2011-07-09,3,0,7,16,0,6,0,1,0.82,0.7273,0.38,0.0,171,2565,245,2450,416,5015
4460,2011-07-09,3,0,7,17,0,6,0,1,0.84,0.7273,0.32,0.0,160,2400,241,2410,401,4810
4461,2011-07-09,3,0,7,18,0,6,0,1,0.82,0.7273,0.36,0.1045,132,1980,246,2460,378,4440
4462,2011-07-09,3,0,7,19,0,6,0,1,0.76,0.697,0.55,0.1642,128,1920,178,1780,306,3700
4463,2011-07-09,3,0,7,20,0,6,0,1,0.76,0.7121,0.58,0.2239,129,1935,185,1850,314,3785
4464,2011-07-09,3,0,7,21,0,6,0,1,0.74,0.6818,0.58,0.1642,83,1245,155,1550,238,2795
4465,2011-07-09,3,0,7,22,0,6,0,1,0.72,0.6818,0.62,0.1642,60,900,154,1540,214,2440
4466,2011-07-09,3,0,7,23,0,6,0,1,0.72,0.6667,0.58,0.194,47,705,93,930,140,1635
4467,2011-07-10,3,0,7,0,0,0,0,1,0.7,0.6515,0.61,0.1642,42,630,112,1120,154,1750
4468,2011-07-10,3,0,7,1,0,0,0,1,0.7,0.6515,0.61,0.1343,19,285,94,940,113,1225
4469,2011-07-10,3,0,7,2,0,0,0,1,0.68,0.6364,0.69,0.0896,28,420,68,680,96,1100
4470,2011-07-10,3,0,7,3,0,0,0,1,0.66,0.6212,0.74,0.0896,6,90,19,190,25,280
4471,2011-07-10,3,0,7,4,0,0,0,1,0.66,0.6212,0.69,0.0896,0,0,5,50,5,50
4472,2011-07-10,3,0,7,5,0,0,0,1,0.66,0.6212,0.74,0.0,7,105,10,100,17,205
4473,2011-07-10,3,0,7,6,0,0,0,1,0.64,0.5909,0.78,0.0896,8,120,17,170,25,290
4474,2011-07-10,3,0,7,7,0,0,0,1,0.7,0.6515,0.7,0.0896,27,405,38,380,65,785
4475,2011-07-10,3,0,7,8,0,0,0,1,0.72,0.6818,0.66,0.0,27,405,65,650,92,1055
4476,2011-07-10,3,0,7,9,0,0,0,1,0.74,0.697,0.66,0.0896,62,930,107,1070,169,2000
4477,2011-07-10,3,0,7,10,0,0,0,1,0.76,0.697,0.55,0.1343,95,1425,173,1730,268,3155
4478,2011-07-10,3,0,7,11,0,0,0,1,0.78,0.7273,0.55,0.194,110,1650,177,1770,287,3420
4479,2011-07-10,3,0,7,12,0,0,0,1,0.82,0.7576,0.46,0.2836,133,1995,244,2440,377,4435
4480,2011-07-10,3,0,7,13,0,0,0,1,0.8,0.7273,0.46,0.2985,139,2085,228,2280,367,4365
4481,2011-07-10,3,0,7,14,0,0,0,1,0.82,0.7424,0.41,0.3284,122,1830,227,2270,349,4100
4482,2011-07-10,3,0,7,15,0,0,0,1,0.84,0.7424,0.39,0.2836,142,2130,219,2190,361,4320
4483,2011-07-10,3,0,7,16,0,0,0,1,0.84,0.7576,0.41,0.2836,128,1920,244,2440,372,4360
4484,2011-07-10,3,0,7,17,0,0,0,1,0.84,0.7424,0.36,0.2239,146,2190,217,2170,363,4360
4485,2011-07-10,3,0,7,18,0,0,0,1,0.82,0.7424,0.43,0.2836,141,2115,222,2220,363,4335
4486,2011-07-10,3,0,7,19,0,0,0,1,0.8,0.7424,0.49,0.3284,120,1800,183,1830,303,3630
4487,2011-07-10,3,0,7,20,0,0,0,1,0.76,0.697,0.55,0.194,101,1515,167,1670,268,3185
4488,2011-07-10,3,0,7,21,0,0,0,1,0.74,0.6818,0.62,0.2537,65,975,162,1620,227,2595
4489,2011-07-10,3,0,7,22,0,0,0,1,0.74,0.697,0.66,0.2239,56,840,87,870,143,1710
4490,2011-07-10,3,0,7,23,0,0,0,1,0.72,0.6818,0.66,0.2537,19,285,53,530,72,815
4491,2011-07-11,3,0,7,0,0,1,1,1,0.7,0.6515,0.65,0.194,10,150,25,250,35,400
4492,2011-07-11,3,0,7,1,0,1,1,1,0.7,0.6515,0.61,0.2836,5,75,5,50,10,125
4493,2011-07-11,3,0,7,2,0,1,1,1,0.7,0.6515,0.61,0.2239,8,120,4,40,12,160
4494,2011-07-11,3,0,7,3,0,1,1,1,0.68,0.6364,0.65,0.1642,2,30,8,80,10,110
4495,2011-07-11,3,0,7,4,0,1,1,1,0.66,0.6212,0.74,0.2239,0,0,4,40,4,40
4496,2011-07-11,3,0,7,5,0,1,1,1,0.66,0.6212,0.74,0.1343,5,75,21,210,26,285
4497,2011-07-11,3,0,7,6,0,1,1,1,0.68,0.6364,0.74,0.194,19,285,102,1020,121,1305
4498,2011-07-11,3,0,7,7,0,1,1,1,0.7,0.6667,0.74,0.2537,28,420,289,2890,317,3310
4499,2011-07-11,3,0,7,8,0,1,1,1,0.74,0.697,0.66,0.2836,35,525,385,3850,420,4375
4500,2011-07-11,3,0,7,9,0,1,1,1,0.78,0.7424,0.59,0.2985,41,615,167,1670,208,2285
4501,2011-07-11,3,0,7,10,0,1,1,1,0.8,0.7576,0.55,0.3582,44,660,73,730,117,1390
4502,2011-07-11,3,0,7,11,0,1,1,1,0.82,0.7879,0.56,0.2985,39,585,89,890,128,1475
4503,2011-07-11,3,0,7,12,0,1,1,1,0.84,0.803,0.53,0.2836,40,600,108,1080,148,1680
4504,2011-07-11,3,0,7,13,0,1,1,1,0.86,0.8182,0.5,0.2537,22,330,119,1190,141,1520
4505,2011-07-11,3,0,7,14,0,1,1,1,0.86,0.8333,0.53,0.2836,40,600,94,940,134,1540
4506,2011-07-11,3,0,7,15,0,1,1,1,0.86,0.8485,0.56,0.4179,38,570,108,1080,146,1650
4507,2011-07-11,3,0,7,16,0,1,1,1,0.86,0.8485,0.56,0.3881,57,855,182,1820,239,2675
4508,2011-07-11,3,0,7,17,0,1,1,1,0.86,0.8485,0.56,0.4179,59,885,455,4550,514,5435
4509,2011-07-11,3,0,7,18,0,1,1,1,0.86,0.8333,0.53,0.3881,57,855,415,4150,472,5005
4510,2011-07-11,3,0,7,19,0,1,1,1,0.84,0.8333,0.59,0.3284,80,1200,293,2930,373,4130
4511,2011-07-11,3,0,7,20,0,1,1,1,0.72,0.697,0.74,0.4179,42,630,194,1940,236,2570
4512,2011-07-11,3,0,7,21,0,1,1,1,0.7,0.6667,0.79,0.4179,21,315,109,1090,130,1405
4513,2011-07-11,3,0,7,22,0,1,1,1,0.72,0.697,0.74,0.1343,20,300,70,700,90,1000
4514,2011-07-11,3,0,7,23,0,1,1,1,0.7,0.6667,0.79,0.1343,11,165,44,440,55,605
4515,2011-07-12,3,0,7,0,0,2,1,1,0.7,0.6667,0.79,0.1343,3,45,19,190,22,235
4516,2011-07-12,3,0,7,1,0,2,1,1,0.7,0.6667,0.79,0.0896,6,90,8,80,14,170
4517,2011-07-12,3,0,7,2,0,2,1,1,0.7,0.6667,0.79,0.1045,2,30,7,70,9,100
4518,2011-07-12,3,0,7,3,0,2,1,2,0.7,0.6667,0.79,0.0,2,30,6,60,8,90
4519,2011-07-12,3,0,7,4,0,2,1,1,0.7,0.6667,0.79,0.1642,0,0,6,60,6,60
4520,2011-07-12,3,0,7,5,0,2,1,1,0.7,0.6667,0.79,0.0896,4,60,21,210,25,270
4521,2011-07-12,3,0,7,6,0,2,1,1,0.74,0.6818,0.58,0.2239,13,195,102,1020,115,1215
4522,2011-07-12,3,0,7,7,0,2,1,1,0.76,0.697,0.55,0.194,29,435,301,3010,330,3445
4523,2011-07-12,3,0,7,8,0,2,1,1,0.76,0.7121,0.58,0.2239,35,525,382,3820,417,4345
4524,2011-07-12,3,0,7,9,0,2,1,1,0.78,0.7273,0.55,0.4925,27,405,149,1490,176,1895
4525,2011-07-12,3,0,7,10,0,2,1,1,0.82,0.7727,0.52,0.1642,38,570,85,850,123,1420
4526,2011-07-12,3,0,7,11,0,2,1,1,0.82,0.7727,0.52,0.1642,39,585,86,860,125,1445
4527,2011-07-12,3,0,7,12,0,2,1,1,0.86,0.7879,0.44,0.2985,38,570,125,1250,163,1820
4528,2011-07-12,3,0,7,13,0,2,1,1,0.86,0.803,0.47,0.2239,32,480,104,1040,136,1520
4529,2011-07-12,3,0,7,14,0,2,1,1,0.9,0.8485,0.42,0.2985,33,495,91,910,124,1405
4530,2011-07-12,3,0,7,15,0,2,1,1,0.9,0.8485,0.42,0.3582,37,555,111,1110,148,1665
4531,2011-07-12,3,0,7,16,0,2,1,1,0.86,0.7879,0.44,0.2836,25,375,177,1770,202,2145
4532,2011-07-12,3,0,7,17,0,2,1,1,0.88,0.8182,0.44,0.2836,48,720,380,3800,428,4520
4533,2011-07-12,3,0,7,18,0,2,1,1,0.86,0.803,0.47,0.2985,39,585,472,4720,511,5305
4534,2011-07-12,3,0,7,19,0,2,1,1,0.84,0.7576,0.44,0.2836,42,630,295,2950,337,3580
4535,2011-07-12,3,0,7,20,0,2,1,1,0.82,0.7424,0.43,0.194,57,855,251,2510,308,3365
4536,2011-07-12,3,0,7,21,0,2,1,1,0.82,0.7424,0.43,0.1045,49,735,209,2090,258,2825
4537,2011-07-12,3,0,7,22,0,2,1,1,0.8,0.7273,0.46,0.1343,44,660,150,1500,194,2160
4538,2011-07-12,3,0,7,23,0,2,1,1,0.78,0.7121,0.52,0.0,20,300,59,590,79,890
4539,2011-07-13,3,0,7,0,0,3,1,1,0.76,0.7121,0.62,0.0,9,135,37,370,46,505
4540,2011-07-13,3,0,7,1,0,3,1,1,0.76,0.697,0.55,0.0,1,15,11,110,12,125
4541,2011-07-13,3,0,7,2,0,3,1,1,0.76,0.697,0.55,0.0,2,30,3,30,5,60
4542,2011-07-13,3,0,7,3,0,3,1,1,0.74,0.6818,0.58,0.194,0,0,4,40,4,40
4543,2011-07-13,3,0,7,4,0,3,1,1,0.74,0.6818,0.58,0.2537,0,0,5,50,5,50
4544,2011-07-13,3,0,7,5,0,3,1,1,0.74,0.6818,0.58,0.194,4,60,22,220,26,280
4545,2011-07-13,3,0,7,6,0,3,1,1,0.74,0.6818,0.58,0.1642,18,270,103,1030,121,1300
4546,2011-07-13,3,0,7,7,0,3,1,1,0.76,0.697,0.55,0.2537,32,480,281,2810,313,3290
4547,2011-07-13,3,0,7,8,0,3,1,1,0.8,0.7424,0.49,0.2537,31,465,418,4180,449,4645
4548,2011-07-13,3,0,7,9,0,3,1,1,0.82,0.7424,0.41,0.194,23,345,163,1630,186,1975
4549,2011-07-13,3,0,7,10,0,3,1,1,0.82,0.7576,0.46,0.194,33,495,80,800,113,1295
4550,2011-07-13,3,0,7,11,0,3,1,1,0.84,0.7424,0.39,0.1642,55,825,110,1100,165,1925
4551,2011-07-13,3,0,7,12,0,3,1,1,0.84,0.7576,0.41,0.2836,40,600,134,1340,174,1940
4552,2011-07-13,3,0,7,13,0,3,1,3,0.82,0.7576,0.46,0.1343,39,585,119,1190,158,1775
4553,2011-07-13,3,0,7,14,0,3,1,3,0.82,0.7576,0.46,0.1343,27,405,89,890,116,1295
4554,2011-07-13,3,0,7,15,0,3,1,3,0.64,0.5606,0.94,0.1343,13,195,33,330,46,525
4555,2011-07-13,3,0,7,16,0,3,1,2,0.66,0.5909,0.89,0.0,23,345,118,1180,141,1525
4556,2011-07-13,3,0,7,17,0,3,1,1,0.7,0.6667,0.79,0.0,70,1050,418,4180,488,5230
4557,2011-07-13,3,0,7,18,0,3,1,1,0.72,0.697,0.79,0.1343,51,765,412,4120,463,4885
4558,2011-07-13,3,0,7,19,0,3,1,1,0.7,0.6667,0.79,0.1045,79,1185,340,3400,419,4585
4559,2011-07-13,3,0,7,20,0,3,1,1,0.7,0.6667,0.84,0.1642,61,915,281,2810,342,3725
4560,2011-07-13,3,0,7,21,0,3,1,1,0.7,0.6667,0.79,0.1045,56,840,194,1940,250,2780
4561,2011-07-13,3,0,7,22,0,3,1,1,0.68,0.6364,0.83,0.194,48,720,136,1360,184,2080
4562,2011-07-13,3,0,7,23,0,3,1,1,0.66,0.6061,0.83,0.2537,33,495,83,830,116,1325
4563,2011-07-14,3,0,7,0,0,4,1,1,0.66,0.6212,0.69,0.2985,14,210,32,320,46,530
4564,2011-07-14,3,0,7,1,0,4,1,1,0.66,0.6212,0.61,0.2537,4,60,21,210,25,270
4565,2011-07-14,3,0,7,2,0,4,1,1,0.64,0.6212,0.57,0.2985,3,45,7,70,10,115
4566,2011-07-14,3,0,7,3,0,4,1,1,0.62,0.6212,0.57,0.2985,1,15,5,50,6,65
4567,2011-07-14,3,0,7,4,0,4,1,1,0.62,0.6212,0.53,0.2537,0,0,6,60,6,60
4568,2011-07-14,3,0,7,5,0,4,1,1,0.6,0.6212,0.56,0.2239,6,90,22,220,28,310
4569,2011-07-14,3,0,7,6,0,4,1,1,0.6,0.6061,0.6,0.2239,14,210,116,1160,130,1370
4570,2011-07-14,3,0,7,7,0,4,1,1,0.62,0.6212,0.53,0.2537,23,345,311,3110,334,3455
4571,2011-07-14,3,0,7,8,0,4,1,1,0.64,0.6212,0.5,0.3582,53,795,433,4330,486,5125
4572,2011-07-14,3,0,7,9,0,4,1,1,0.68,0.6364,0.47,0.2836,29,435,195,1950,224,2385
4573,2011-07-14,3,0,7,10,0,4,1,1,0.7,0.6364,0.42,0.2537,32,480,95,950,127,1430
4574,2011-07-14,3,0,7,11,0,4,1,1,0.72,0.6515,0.37,0.2239,38,570,110,1100,148,1670
4575,2011-07-14,3,0,7,12,0,4,1,1,0.74,0.6515,0.35,0.2537,51,765,172,1720,223,2485
4576,2011-07-14,3,0,7,13,0,4,1,1,0.76,0.6667,0.33,0.3284,39,585,138,1380,177,1965
4577,2011-07-14,3,0,7,14,0,4,1,1,0.74,0.6515,0.35,0.2836,49,735,129,1290,178,2025
4578,2011-07-14,3,0,7,15,0,4,1,1,0.76,0.6667,0.33,0.2985,42,630,138,1380,180,2010
4579,2011-07-14,3,0,7,16,0,4,1,1,0.76,0.6667,0.33,0.1343,43,645,231,2310,274,2955
4580,2011-07-14,3,0,7,17,0,4,1,1,0.74,0.6515,0.37,0.1343,78,1170,517,5170,595,6340
4581,2011-07-14,3,0,7,18,0,4,1,1,0.72,0.6515,0.42,0.194,94,1410,484,4840,578,6250
4582,2011-07-14,3,0,7,19,0,4,1,1,0.72,0.6515,0.39,0.2239,67,1005,333,3330,400,4335
4583,2011-07-14,3,0,7,20,0,4,1,1,0.7,0.6364,0.42,0.2239,81,1215,267,2670,348,3885
4584,2011-07-14,3,0,7,21,0,4,1,1,0.66,0.6212,0.5,0.1343,58,870,203,2030,261,2900
4585,2011-07-14,3,0,7,22,0,4,1,1,0.64,0.6212,0.57,0.0896,42,630,134,1340,176,1970
4586,2011-07-14,3,0,7,23,0,4,1,1,0.64,0.6061,0.65,0.2537,27,405,97,970,124,1375
4587,2011-07-15,3,0,7,0,0,5,1,1,0.62,0.5909,0.73,0.2239,23,345,57,570,80,915
4588,2011-07-15,3,0,7,1,0,5,1,1,0.62,0.5909,0.73,0.194,7,105,13,130,20,235
4589,2011-07-15,3,0,7,2,0,5,1,1,0.6,0.5758,0.78,0.1642,16,240,22,220,38,460
4590,2011-07-15,3,0,7,3,0,5,1,1,0.6,0.5909,0.73,0.194,1,15,6,60,7,75
4591,2011-07-15,3,0,7,4,0,5,1,1,0.6,0.5909,0.73,0.1642,2,30,8,80,10,110
4592,2011-07-15,3,0,7,5,0,5,1,1,0.6,0.5909,0.73,0.1343,7,105,16,160,23,265
4593,2011-07-15,3,0,7,6,0,5,1,2,0.6,0.5909,0.73,0.1045,12,180,108,1080,120,1260
4594,2011-07-15,3,0,7,7,0,5,1,1,0.64,0.6061,0.65,0.1045,17,255,257,2570,274,2825
4595,2011-07-15,3,0,7,8,0,5,1,1,0.64,0.6061,0.65,0.2537,50,750,514,5140,564,5890
4596,2011-07-15,3,0,7,9,0,5,1,1,0.68,0.6364,0.54,0.194,31,465,176,1760,207,2225
4597,2011-07-15,3,0,7,10,0,5,1,2,0.66,0.6212,0.61,0.1642,59,885,107,1070,166,1955
4598,2011-07-15,3,0,7,11,0,5,1,1,0.7,0.6515,0.54,0.1343,73,1095,137,1370,210,2465
4599,2011-07-15,3,0,7,12,0,5,1,1,0.7,0.6515,0.48,0.194,61,915,177,1770,238,2685
4600,2011-07-15,3,0,7,13,0,5,1,1,0.7,0.6515,0.54,0.194,85,1275,162,1620,247,2895
4601,2011-07-15,3,0,7,14,0,5,1,1,0.7,0.6515,0.51,0.194,105,1575,160,1600,265,3175
4602,2011-07-15,3,0,7,15,0,5,1,1,0.72,0.6515,0.45,0.1642,74,1110,163,1630,237,2740
4603,2011-07-15,3,0,7,16,0,5,1,1,0.72,0.6667,0.51,0.194,96,1440,265,2650,361,4090
4604,2011-07-15,3,0,7,17,0,5,1,1,0.74,0.6667,0.42,0.2537,104,1560,483,4830,587,6390
4605,2011-07-15,3,0,7,18,0,5,1,1,0.72,0.6515,0.45,0.2239,102,1530,394,3940,496,5470
4606,2011-07-15,3,0,7,19,0,5,1,1,0.7,0.6364,0.45,0.2239,114,1710,280,2800,394,4510
4607,2011-07-15,3,0,7,20,0,5,1,1,0.7,0.6515,0.51,0.2239,92,1380,251,2510,343,3890
4608,2011-07-15,3,0,7,21,0,5,1,1,0.66,0.6212,0.54,0.1045,75,1125,186,1860,261,2985
4609,2011-07-15,3,0,7,22,0,5,1,1,0.66,0.6212,0.57,0.2239,71,1065,152,1520,223,2585
4610,2011-07-15,3,0,7,23,0,5,1,1,0.64,0.6212,0.61,0.1642,41,615,126,1260,167,1875
4611,2011-07-16,3,0,7,0,0,6,0,1,0.62,0.6061,0.65,0.194,42,630,68,680,110,1310
4612,2011-07-16,3,0,7,1,0,6,0,1,0.6,0.5909,0.69,0.1045,24,360,51,510,75,870
4613,2011-07-16,3,0,7,2,0,6,0,1,0.6,0.5909,0.73,0.1343,10,150,48,480,58,630
4614,2011-07-16,3,0,7,3,0,6,0,1,0.6,0.5758,0.78,0.1343,6,90,20,200,26,290
4615,2011-07-16,3,0,7,4,0,6,0,1,0.6,0.5909,0.73,0.0896,9,135,7,70,16,205
4616,2011-07-16,3,0,7,5,0,6,0,1,0.58,0.5455,0.78,0.0896,4,60,6,60,10,120
4617,2011-07-16,3,0,7,6,0,6,0,1,0.6,0.5758,0.78,0.1642,16,240,21,210,37,450
4618,2011-07-16,3,0,7,7,0,6,0,1,0.62,0.5909,0.73,0.1343,14,210,38,380,52,590
4619,2011-07-16,3,0,7,8,0,6,0,1,0.66,0.6212,0.65,0.1642,37,555,90,900,127,1455
4620,2011-07-16,3,0,7,9,0,6,0,1,0.7,0.6515,0.54,0.2239,72,1080,150,1500,222,2580
4621,2011-07-16,3,0,7,10,0,6,0,1,0.72,0.6667,0.54,0.194,114,1710,208,2080,322,3790
4622,2011-07-16,3,0,7,11,0,6,0,1,0.74,0.6667,0.48,0.2239,171,2565,225,2250,396,4815
4623,2011-07-16,3,0,7,12,0,6,0,1,0.76,0.6818,0.43,0.2836,187,2805,276,2760,463,5565
4624,2011-07-16,3,0,7,13,0,6,0,1,0.76,0.6818,0.45,0.2985,221,3315,276,2760,497,6075
4625,2011-07-16,3,0,7,14,0,6,0,1,0.74,0.6667,0.45,0.2985,201,3015,232,2320,433,5335
4626,2011-07-16,3,0,7,15,0,6,0,1,0.76,0.6818,0.45,0.3284,205,3075,223,2230,428,5305
4627,2011-07-16,3,0,7,16,0,6,0,1,0.76,0.6818,0.45,0.2836,183,2745,242,2420,425,5165
4628,2011-07-16,3,0,7,17,0,6,0,1,0.76,0.6818,0.45,0.2239,234,3510,241,2410,475,5920
4629,2011-07-16,3,0,7,18,0,6,0,1,0.76,0.6818,0.45,0.2836,185,2775,243,2430,428,5205
4630,2011-07-16,3,0,7,19,0,6,0,1,0.74,0.6818,0.48,0.194,164,2460,242,2420,406,4880
4631,2011-07-16,3,0,7,20,0,6,0,1,0.72,0.6667,0.51,0.2239,108,1620,188,1880,296,3500
4632,2011-07-16,3,0,7,21,0,6,0,1,0.7,0.6515,0.58,0.2239,85,1275,167,1670,252,2945
4633,2011-07-16,3,0,7,22,0,6,0,1,0.7,0.6515,0.65,0.2836,65,975,136,1360,201,2335
4634,2011-07-16,3,0,7,23,0,6,0,1,0.68,0.6364,0.61,0.2239,61,915,107,1070,168,1985
4635,2011-07-17,3,0,7,0,0,0,0,1,0.66,0.6212,0.65,0.2239,34,510,91,910,125,1420
4636,2011-07-17,3,0,7,1,0,0,0,1,0.64,0.6061,0.69,0.194,16,240,86,860,102,1100
4637,2011-07-17,3,0,7,2,0,0,0,1,0.64,0.6061,0.69,0.2239,28,420,66,660,94,1080
4638,2011-07-17,3,0,7,3,0,0,0,1,0.64,0.6061,0.69,0.2239,21,315,26,260,47,575
4639,2011-07-17,3,0,7,4,0,0,0,1,0.62,0.5909,0.73,0.1642,4,60,6,60,10,120
4640,2011-07-17,3,0,7,5,0,0,0,1,0.64,0.6061,0.69,0.2239,4,60,8,80,12,140
4641,2011-07-17,3,0,7,6,0,0,0,1,0.62,0.5909,0.73,0.1642,10,150,11,110,21,260
4642,2011-07-17,3,0,7,7,0,0,0,1,0.64,0.6061,0.73,0.1642,20,300,30,300,50,600
4643,2011-07-17,3,0,7,8,0,0,0,1,0.68,0.6364,0.65,0.2239,45,675,73,730,118,1405
4644,2011-07-17,3,0,7,9,0,0,0,1,0.72,0.6667,0.58,0.2239,74,1110,110,1100,184,2210
4645,2011-07-17,3,0,7,10,0,0,0,1,0.74,0.6818,0.6,0.2239,127,1905,177,1770,304,3675
4646,2011-07-17,3,0,7,11,0,0,0,1,0.76,0.697,0.55,0.2836,147,2205,244,2440,391,4645
4647,2011-07-17,3,0,7,12,0,0,0,1,0.76,0.697,0.55,0.2836,177,2655,243,2430,420,5085
4648,2011-07-17,3,0,7,13,0,0,0,1,0.8,0.7424,0.49,0.2985,200,3000,272,2720,472,5720
4649,2011-07-17,3,0,7,14,0,0,0,1,0.8,0.7424,0.49,0.3582,168,2520,262,2620,430,5140
4650,2011-07-17,3,0,7,15,0,0,0,1,0.82,0.7424,0.43,0.2985,129,1935,195,1950,324,3885
4651,2011-07-17,3,0,7,16,0,0,0,1,0.8,0.7273,0.46,0.2985,129,1935,188,1880,317,3815
4652,2011-07-17,3,0,7,17,0,0,0,1,0.8,0.7424,0.49,0.3881,133,1995,236,2360,369,4355
4653,2011-07-17,3,0,7,18,0,0,0,1,0.8,0.7273,0.46,0.2985,147,2205,243,2430,390,4635
4654,2011-07-17,3,0,7,19,0,0,0,1,0.76,0.697,0.55,0.2836,145,2175,234,2340,379,4515
4655,2011-07-17,3,0,7,20,0,0,0,1,0.76,0.7121,0.58,0.2537,85,1275,177,1770,262,3045
4656,2011-07-17,3,0,7,21,0,0,0,1,0.74,0.6818,0.62,0.2239,59,885,148,1480,207,2365
4657,2011-07-17,3,0,7,22,0,0,0,1,0.72,0.6818,0.66,0.2239,65,975,116,1160,181,2135
4658,2011-07-17,3,0,7,23,0,0,0,1,0.7,0.6667,0.74,0.1343,39,585,54,540,93,1125
4659,2011-07-18,3,0,7,0,0,1,1,1,0.7,0.6667,0.74,0.1343,21,315,30,300,51,615
4660,2011-07-18,3,0,7,1,0,1,1,1,0.7,0.6667,0.74,0.2239,17,255,8,80,25,335
4661,2011-07-18,3,0,7,2,0,1,1,1,0.66,0.6061,0.83,0.2239,2,30,8,80,10,110
4662,2011-07-18,3,0,7,3,0,1,1,1,0.66,0.6061,0.78,0.194,3,45,4,40,7,85
4663,2011-07-18,3,0,7,4,0,1,1,1,0.64,0.5909,0.78,0.1642,1,15,3,30,4,45
4664,2011-07-18,3,0,7,5,0,1,1,1,0.64,0.5909,0.78,0.1045,2,30,15,150,17,180
4665,2011-07-18,3,0,7,6,0,1,1,1,0.64,0.5758,0.83,0.1045,10,150,95,950,105,1100
4666,2011-07-18,3,0,7,7,0,1,1,1,0.68,0.6364,0.74,0.2239,22,330,255,2550,277,2880
4667,2011-07-18,3,0,7,8,0,1,1,1,0.7,0.6515,0.7,0.194,18,270,329,3290,347,3560
4668,2011-07-18,3,0,7,9,0,1,1,1,0.74,0.697,0.67,0.2239,33,495,170,1700,203,2195
4669,2011-07-18,3,0,7,10,0,1,1,1,0.76,0.7121,0.62,0.194,52,780,78,780,130,1560
4670,2011-07-18,3,0,7,11,0,1,1,1,0.8,0.7576,0.55,0.0896,42,630,99,990,141,1620
4671,2011-07-18,3,0,7,12,0,1,1,1,0.8,0.7727,0.59,0.194,39,585,126,1260,165,1845
4672,2011-07-18,3,0,7,13,0,1,1,1,0.82,0.7879,0.56,0.2537,27,405,125,1250,152,1655
4673,2011-07-18,3,0,7,14,0,1,1,1,0.82,0.7879,0.56,0.3284,32,480,106,1060,138,1540
4674,2011-07-18,3,0,7,15,0,1,1,1,0.84,0.803,0.53,0.3284,53,795,111,1110,164,1905
4675,2011-07-18,3,0,7,16,0,1,1,1,0.84,0.803,0.53,0.2836,45,675,220,2200,265,2875
4676,2011-07-18,3,0,7,17,0,1,1,1,0.84,0.7879,0.49,0.3284,72,1080,473,4730,545,5810
4677,2011-07-18,3,0,7,18,0,1,1,1,0.82,0.7727,0.49,0.3582,80,1200,478,4780,558,5980
4678,2011-07-18,3,0,7,19,0,1,1,1,0.8,0.7576,0.55,0.2239,63,945,335,3350,398,4295
4679,2011-07-18,3,0,7,20,0,1,1,1,0.78,0.7424,0.59,0.2239,91,1365,232,2320,323,3685
4680,2011-07-18,3,0,7,21,0,1,1,1,0.74,0.697,0.66,0.194,48,720,154,1540,202,2260
4681,2011-07-18,3,0,7,22,0,1,1,1,0.76,0.7273,0.66,0.2239,36,540,104,1040,140,1580
4682,2011-07-18,3,0,7,23,0,1,1,1,0.74,0.697,0.66,0.1642,32,480,59,590,91,1070
4683,2011-07-19,3,0,7,0,0,2,1,1,0.74,0.697,0.66,0.1045,25,375,26,260,51,635
4684,2011-07-19,3,0,7,1,0,2,1,2,0.74,0.697,0.66,0.1343,7,105,6,60,13,165
4685,2011-07-19,3,0,7,2,0,2,1,1,0.72,0.6818,0.7,0.1642,9,135,4,40,13,175
4686,2011-07-19,3,0,7,3,0,2,1,1,0.72,0.6818,0.7,0.1642,2,30,1,10,3,40
4687,2011-07-19,3,0,7,4,0,2,1,1,0.72,0.6818,0.7,0.1343,1,15,4,40,5,55
4688,2011-07-19,3,0,7,5,0,2,1,2,0.7,0.6667,0.74,0.1045,0,0,19,190,19,190
4689,2011-07-19,3,0,7,6,0,2,1,2,0.72,0.697,0.74,0.1045,8,120,126,1260,134,1380
4690,2011-07-19,3,0,7,7,0,2,1,2,0.74,0.697,0.7,0.1642,28,420,287,2870,315,3290
4691,2011-07-19,3,0,7,8,0,2,1,2,0.76,0.7273,0.7,0.1642,31,465,381,3810,412,4275
4692,2011-07-19,3,0,7,9,0,2,1,2,0.8,0.7879,0.63,0.1343,22,330,177,1770,199,2100
4693,2011-07-19,3,0,7,10,0,2,1,2,0.82,0.7879,0.56,0.1642,29,435,112,1120,141,1555
4694,2011-07-19,3,0,7,11,0,2,1,1,0.82,0.803,0.59,0.0,29,435,98,980,127,1415
4695,2011-07-19,3,0,7,12,0,2,1,1,0.84,0.8182,0.56,0.0896,26,390,127,1270,153,1660
4696,2011-07-19,3,0,7,13,0,2,1,1,0.86,0.8333,0.53,0.1045,33,495,139,1390,172,1885
4697,2011-07-19,3,0,7,14,0,2,1,1,0.86,0.8182,0.5,0.194,41,615,111,1110,152,1725
4698,2011-07-19,3,0,7,15,0,2,1,1,0.88,0.8182,0.44,0.194,48,720,110,1100,158,1820
4699,2011-07-19,3,0,7,16,0,2,1,1,0.9,0.8485,0.42,0.2985,61,915,216,2160,277,3075
4700,2011-07-19,3,0,7,17,0,2,1,1,0.8,0.803,0.66,0.0,68,1020,445,4450,513,5470
4701,2011-07-19,3,0,7,18,0,2,1,1,0.8,0.803,0.66,0.1343,80,1200,450,4500,530,5700
4702,2011-07-19,3,0,7,19,0,2,1,1,0.76,0.7424,0.75,0.194,54,810,334,3340,388,4150
4703,2011-07-19,3,0,7,20,0,2,1,1,0.74,0.7273,0.74,0.0896,48,720,229,2290,277,3010
4704,2011-07-19,3,0,7,21,0,2,1,1,0.74,0.7121,0.74,0.1343,47,705,194,1940,241,2645
4705,2011-07-19,3,0,7,22,0,2,1,1,0.74,0.7121,0.74,0.0,36,540,120,1200,156,1740
4706,2011-07-19,3,0,7,23,0,2,1,3,0.72,0.697,0.79,0.1642,19,285,73,730,92,1015
4707,2011-07-20,3,0,7,0,0,3,1,1,0.7,0.6667,0.84,0.1045,11,165,29,290,40,455
4708,2011-07-20,3,0,7,1,0,3,1,1,0.7,0.6667,0.84,0.0,4,60,7,70,11,130
4709,2011-07-20,3,0,7,2,0,3,1,1,0.7,0.6667,0.84,0.0,2,30,7,70,9,100
4710,2011-07-20,3,0,7,3,0,3,1,1,0.7,0.6667,0.84,0.1045,2,30,4,40,6,70
4711,2011-07-20,3,0,7,4,0,3,1,1,0.68,0.6364,0.83,0.0,0,0,4,40,4,40
4712,2011-07-20,3,0,7,5,0,3,1,1,0.68,0.6364,0.83,0.1045,4,60,19,190,23,250
4713,2011-07-20,3,0,7,6,0,3,1,2,0.68,0.6364,0.89,0.1045,5,75,111,1110,116,1185
4714,2011-07-20,3,0,7,7,0,3,1,2,0.7,0.6667,0.84,0.1045,27,405,276,2760,303,3165
4715,2011-07-20,3,0,7,8,0,3,1,1,0.74,0.7121,0.74,0.0,34,510,404,4040,438,4550
4716,2011-07-20,3,0,7,9,0,3,1,1,0.74,0.697,0.7,0.0896,28,420,181,1810,209,2230
4717,2011-07-20,3,0,7,10,0,3,1,1,0.76,0.7273,0.7,0.0,34,510,76,760,110,1270
4718,2011-07-20,3,0,7,11,0,3,1,1,0.8,0.7879,0.63,0.0896,26,390,116,1160,142,1550
4719,2011-07-20,3,0,7,12,0,3,1,1,0.82,0.803,0.59,0.0,28,420,121,1210,149,1630
4720,2011-07-20,3,0,7,13,0,3,1,1,0.84,0.8182,0.56,0.194,23,345,97,970,120,1315
4721,2011-07-20,3,0,7,14,0,3,1,1,0.86,0.8333,0.53,0.2239,44,660,83,830,127,1490
4722,2011-07-20,3,0,7,15,0,3,1,1,0.86,0.8182,0.5,0.1642,36,540,102,1020,138,1560
4723,2011-07-20,3,0,7,16,0,3,1,1,0.84,0.8182,0.56,0.0,30,450,204,2040,234,2490
4724,2011-07-20,3,0,7,17,0,3,1,1,0.84,0.8333,0.59,0.194,50,750,405,4050,455,4800
4725,2011-07-20,3,0,7,18,0,3,1,1,0.84,0.8333,0.59,0.2239,68,1020,429,4290,497,5310
4726,2011-07-20,3,0,7,19,0,3,1,1,0.82,0.8485,0.67,0.1642,59,885,323,3230,382,4115
4727,2011-07-20,3,0,7,20,0,3,1,1,0.8,0.8333,0.75,0.2239,45,675,264,2640,309,3315
4728,2011-07-20,3,0,7,21,0,3,1,1,0.8,0.803,0.66,0.1642,33,495,209,2090,242,2585
4729,2011-07-20,3,0,7,22,0,3,1,1,0.78,0.7727,0.7,0.2239,25,375,144,1440,169,1815
4730,2011-07-20,3,0,7,23,0,3,1,1,0.76,0.7424,0.75,0.2537,26,390,73,730,99,1120
4731,2011-07-21,3,0,7,0,0,4,1,2,0.76,0.7424,0.75,0.194,13,195,29,290,42,485
4732,2011-07-21,3,0,7,1,0,4,1,2,0.74,0.7273,0.84,0.2239,5,75,16,160,21,235
4733,2011-07-21,3,0,7,2,0,4,1,2,0.74,0.7273,0.84,0.2239,2,30,4,40,6,70
4734,2011-07-21,3,0,7,3,0,4,1,2,0.74,0.7121,0.79,0.1343,1,15,5,50,6,65
4735,2011-07-21,3,0,7,4,0,4,1,2,0.72,0.7121,0.84,0.1045,0,0,4,40,4,40
4736,2011-07-21,3,0,7,5,0,4,1,2,0.72,0.7121,0.84,0.1045,2,30,16,160,18,190
4737,2011-07-21,3,0,7,6,0,4,1,2,0.72,0.7121,0.84,0.1045,6,90,111,1110,117,1200
4738,2011-07-21,3,0,7,7,0,4,1,2,0.74,0.7273,0.84,0.1343,23,345,251,2510,274,2855
4739,2011-07-21,3,0,7,8,0,4,1,2,0.76,0.7576,0.79,0.1642,23,345,358,3580,381,3925
4740,2011-07-21,3,0,7,9,0,4,1,2,0.8,0.8182,0.75,0.2537,34,510,166,1660,200,2170
4741,2011-07-21,3,0,7,10,0,4,1,2,0.82,0.8636,0.71,0.2239,31,465,47,470,78,935
4742,2011-07-21,3,0,7,11,0,4,1,2,0.86,0.8939,0.63,0.2985,27,405,79,790,106,1195
4743,2011-07-21,3,0,7,12,0,4,1,1,0.88,0.8939,0.56,0.3284,29,435,106,1060,135,1495
4744,2011-07-21,3,0,7,13,0,4,1,1,0.88,0.8939,0.56,0.2985,21,315,81,810,102,1125
4745,2011-07-21,3,0,7,14,0,4,1,1,0.9,0.8939,0.5,0.3582,50,750,97,970,147,1720
4746,2011-07-21,3,0,7,15,0,4,1,1,0.9,0.9242,0.53,0.2537,40,600,93,930,133,1530
4747,2011-07-21,3,0,7,16,0,4,1,1,0.92,0.9242,0.48,0.2836,43,645,167,1670,210,2315
4748,2011-07-21,3,0,7,17,0,4,1,1,0.92,0.9091,0.45,0.2985,40,600,374,3740,414,4340
4749,2011-07-21,3,0,7,18,0,4,1,1,0.9,0.8939,0.5,0.2836,39,585,343,3430,382,4015
4750,2011-07-21,3,0,7,19,0,4,1,1,0.86,0.9242,0.67,0.2836,51,765,233,2330,284,3095
4751,2011-07-21,3,0,7,20,0,4,1,1,0.84,0.8939,0.71,0.2239,38,570,199,1990,237,2560
4752,2011-07-21,3,0,7,21,0,4,1,1,0.82,0.8939,0.75,0.2239,38,570,187,1870,225,2440
4753,2011-07-21,3,0,7,22,0,4,1,1,0.82,0.8636,0.71,0.1642,36,540,113,1130,149,1670
4754,2011-07-21,3,0,7,23,0,4,1,1,0.8,0.8182,0.71,0.1642,40,600,73,730,113,1330
4755,2011-07-22,3,0,7,0,0,5,1,1,0.82,0.8333,0.63,0.1343,9,135,51,510,60,645
4756,2011-07-22,3,0,7,1,0,5,1,1,0.8,0.7879,0.63,0.0,7,105,17,170,24,275
4757,2011-07-22,3,0,7,2,0,5,1,1,0.78,0.803,0.79,0.1343,0,0,14,140,14,140
4758,2011-07-22,3,0,7,3,0,5,1,1,0.78,0.7879,0.75,0.1045,1,15,6,60,7,75
4759,2011-07-22,3,0,7,4,0,5,1,1,0.76,0.7424,0.75,0.1045,8,120,5,50,13,170
4760,2011-07-22,3,0,7,5,0,5,1,1,0.74,0.7121,0.79,0.1045,2,30,17,170,19,200
4761,2011-07-22,3,0,7,6,0,5,1,1,0.76,0.7424,0.75,0.0896,13,195,83,830,96,1025
4762,2011-07-22,3,0,7,7,0,5,1,2,0.8,0.803,0.66,0.1045,20,300,232,2320,252,2620
4763,2011-07-22,3,0,7,8,0,5,1,2,0.84,0.8485,0.63,0.1642,30,450,292,2920,322,3370
4764,2011-07-22,3,0,7,9,0,5,1,1,0.86,0.8939,0.63,0.0896,31,465,177,1770,208,2235
4765,2011-07-22,3,0,7,10,0,5,1,1,0.9,0.9242,0.53,0.0896,32,480,83,830,115,1310
4766,2011-07-22,3,0,7,11,0,5,1,1,0.9,0.8939,0.5,0.1045,23,345,86,860,109,1205
4767,2011-07-22,3,0,7,12,0,5,1,1,0.94,0.9545,0.48,0.1642,20,300,95,950,115,1250
4768,2011-07-22,3,0,7,13,0,5,1,1,0.94,0.9848,0.51,0.1642,25,375,98,980,123,1355
4769,2011-07-22,3,0,7,14,0,5,1,1,0.96,1.0,0.48,0.2985,24,360,77,770,101,1130
4770,2011-07-22,3,0,7,15,0,5,1,1,0.94,0.9848,0.51,0.2985,32,480,101,1010,133,1490
4771,2011-07-22,3,0,7,16,0,5,1,3,0.9,0.8333,0.39,0.2985,29,435,153,1530,182,1965
4772,2011-07-22,3,0,7,17,0,5,1,1,0.88,0.8485,0.47,0.1045,35,525,271,2710,306,3235
4773,2011-07-22,3,0,7,18,0,5,1,1,0.9,0.8182,0.37,0.1642,34,510,250,2500,284,3010
4774,2011-07-22,3,0,7,19,0,5,1,2,0.86,0.7879,0.41,0.1045,40,600,210,2100,250,2700
4775,2011-07-22,3,0,7,20,0,5,1,1,0.84,0.8182,0.56,0.0,46,690,166,1660,212,2350
4776,2011-07-22,3,0,7,21,0,5,1,1,0.82,0.803,0.59,0.0896,38,570,152,1520,190,2090
4777,2011-07-22,3,0,7,22,0,5,1,2,0.84,0.7879,0.49,0.0896,44,660,105,1050,149,1710
4778,2011-07-22,3,0,7,23,0,5,1,1,0.8,0.7879,0.63,0.194,19,285,84,840,103,1125
4779,2011-07-23,3,0,7,0,0,6,0,1,0.82,0.7879,0.56,0.0,16,240,85,850,101,1090
4780,2011-07-23,3,0,7,1,0,6,0,1,0.82,0.7727,0.52,0.1045,13,195,57,570,70,765
4781,2011-07-23,3,0,7,2,0,6,0,1,0.82,0.7727,0.52,0.0,13,195,48,480,61,675
4782,2011-07-23,3,0,7,3,0,6,0,1,0.78,0.7576,0.66,0.0896,6,90,16,160,22,250
4783,2011-07-23,3,0,7,4,0,6,0,1,0.76,0.7273,0.66,0.1045,5,75,4,40,9,115
4784,2011-07-23,3,0,7,5,0,6,0,1,0.76,0.7121,0.62,0.1343,1,15,6,60,7,75
4785,2011-07-23,3,0,7,6,0,6,0,1,0.8,0.7424,0.52,0.1343,6,90,19,190,25,280
4786,2011-07-23,3,0,7,7,0,6,0,1,0.8,0.7424,0.52,0.1045,7,105,38,380,45,485
4787,2011-07-23,3,0,7,8,0,6,0,1,0.84,0.7879,0.49,0.2537,24,360,85,850,109,1210
4788,2011-07-23,3,0,7,9,0,6,0,1,0.84,0.7879,0.49,0.1642,30,450,102,1020,132,1470
4789,2011-07-23,3,0,7,10,0,6,0,1,0.86,0.7879,0.41,0.2239,61,915,137,1370,198,2285
4790,2011-07-23,3,0,7,11,0,6,0,1,0.9,0.8182,0.37,0.194,62,930,154,1540,216,2470
4791,2011-07-23,3,0,7,12,0,6,0,1,0.92,0.8636,0.37,0.1045,71,1065,164,1640,235,2705
4792,2011-07-23,3,0,7,13,0,6,0,1,0.94,0.8788,0.38,0.1642,78,1170,167,1670,245,2840
4793,2011-07-23,3,0,7,14,0,6,0,1,0.92,0.8939,0.42,0.0,84,1260,152,1520,236,2780
4794,2011-07-23,3,0,7,15,0,6,0,1,0.94,0.8788,0.38,0.0,78,1170,137,1370,215,2540
4795,2011-07-23,3,0,7,16,0,6,0,1,0.94,0.8788,0.38,0.1343,70,1050,151,1510,221,2560
4796,2011-07-23,3,0,7,17,0,6,0,1,0.94,0.8788,0.38,0.1343,70,1050,127,1270,197,2320
4797,2011-07-23,3,0,7,18,0,6,0,1,0.92,0.8788,0.4,0.2239,62,930,134,1340,196,2270
4798,2011-07-23,3,0,7,19,0,6,0,2,0.82,0.803,0.59,0.1343,80,1200,137,1370,217,2570
4799,2011-07-23,3,0,7,20,0,6,0,1,0.82,0.803,0.59,0.2239,47,705,98,980,145,1685
4800,2011-07-23,3,0,7,21,0,6,0,1,0.82,0.803,0.59,0.2239,39,585,115,1150,154,1735
4801,2011-07-23,3,0,7,22,0,6,0,1,0.8,0.7727,0.59,0.194,37,555,88,880,125,1435
4802,2011-07-23,3,0,7,23,0,6,0,1,0.8,0.7727,0.59,0.1045,27,405,77,770,104,1175
4803,2011-07-24,3,0,7,0,0,0,0,1,0.8,0.7727,0.59,0.1045,42,630,77,770,119,1400
4804,2011-07-24,3,0,7,1,0,0,0,1,0.78,0.7576,0.66,0.1045,33,495,63,630,96,1125
4805,2011-07-24,3,0,7,2,0,0,0,1,0.8,0.7879,0.63,0.0896,12,180,48,480,60,660
4806,2011-07-24,3,0,7,3,0,0,0,1,0.8,0.7879,0.63,0.0896,17,255,20,200,37,455
4807,2011-07-24,3,0,7,4,0,0,0,1,0.78,0.7576,0.66,0.1045,1,15,5,50,6,65
4808,2011-07-24,3,0,7,5,0,0,0,1,0.78,0.7576,0.66,0.0896,5,75,3,30,8,105
4809,2011-07-24,3,0,7,6,0,0,0,2,0.8,0.7879,0.63,0.0896,9,135,13,130,22,265
4810,2011-07-24,3,0,7,7,0,0,0,1,0.8,0.7727,0.59,0.1343,6,90,29,290,35,380
4811,2011-07-24,3,0,7,8,0,0,0,1,0.82,0.7879,0.56,0.2836,22,330,82,820,104,1150
4812,2011-07-24,3,0,7,9,0,0,0,1,0.82,0.7879,0.56,0.3881,42,630,112,1120,154,1750
4813,2011-07-24,3,0,7,10,0,0,0,1,0.86,0.8182,0.5,0.3284,61,915,165,1650,226,2565
4814,2011-07-24,3,0,7,11,0,0,0,1,0.84,0.803,0.53,0.2537,74,1110,169,1690,243,2800
4815,2011-07-24,3,0,7,12,0,0,0,1,0.9,0.8636,0.45,0.1642,85,1275,161,1610,246,2885
4816,2011-07-24,3,0,7,13,0,0,0,1,0.86,0.803,0.47,0.2239,90,1350,162,1620,252,2970
4817,2011-07-24,3,0,7,14,0,0,0,1,0.86,0.8182,0.5,0.2836,79,1185,204,2040,283,3225
4818,2011-07-24,3,0,7,15,0,0,0,1,0.9,0.8485,0.42,0.2537,68,1020,170,1700,238,2720
4819,2011-07-24,3,0,7,16,0,0,0,1,0.9,0.8485,0.42,0.2537,62,930,187,1870,249,2800
4820,2011-07-24,3,0,7,17,0,0,0,1,0.9,0.8333,0.39,0.1045,75,1125,174,1740,249,2865
4821,2011-07-24,3,0,7,18,0,0,0,1,0.88,0.8182,0.42,0.1642,67,1005,176,1760,243,2765
4822,2011-07-24,3,0,7,19,0,0,0,1,0.86,0.803,0.47,0.1642,70,1050,170,1700,240,2750
4823,2011-07-24,3,0,7,20,0,0,0,1,0.84,0.7879,0.49,0.1642,52,780,143,1430,195,2210
4824,2011-07-24,3,0,7,21,0,0,0,1,0.8,0.7879,0.63,0.1343,42,630,111,1110,153,1740
4825,2011-07-24,3,0,7,22,0,0,0,1,0.78,0.7576,0.66,0.0,23,345,75,750,98,1095
4826,2011-07-24,3,0,7,23,0,0,0,2,0.76,0.7273,0.7,0.0896,13,195,37,370,50,565
4827,2011-07-25,3,0,7,0,0,1,1,2,0.76,0.7273,0.7,0.0,17,255,17,170,34,425
4828,2011-07-25,3,0,7,1,0,1,1,2,0.76,0.7424,0.75,0.0896,4,60,8,80,12,140
4829,2011-07-25,3,0,7,2,0,1,1,2,0.74,0.7121,0.79,0.0896,3,45,3,30,6,75
4830,2011-07-25,3,0,7,3,0,1,1,1,0.74,0.7121,0.79,0.0,2,30,2,20,4,50
4831,2011-07-25,3,0,7,4,0,1,1,1,0.72,0.7121,0.84,0.0896,0,0,6,60,6,60
4832,2011-07-25,3,0,7,5,0,1,1,1,0.72,0.7121,0.84,0.0896,2,30,22,220,24,250
4833,2011-07-25,3,0,7,6,0,1,1,2,0.72,0.7121,0.84,0.0896,7,105,100,1000,107,1105
4834,2011-07-25,3,0,7,7,0,1,1,2,0.74,0.7121,0.79,0.0,20,300,257,2570,277,2870
4835,2011-07-25,3,0,7,8,0,1,1,2,0.76,0.7424,0.75,0.0,34,510,353,3530,387,4040
4836,2011-07-25,3,0,7,9,0,1,1,1,0.8,0.803,0.66,0.0,11,165,124,1240,135,1405
4837,2011-07-25,3,0,7,10,0,1,1,1,0.82,0.803,0.59,0.0,30,450,54,540,84,990
4838,2011-07-25,3,0,7,11,0,1,1,2,0.84,0.8333,0.59,0.194,24,360,83,830,107,1190
4839,2011-07-25,3,0,7,12,0,1,1,2,0.84,0.8333,0.59,0.194,17,255,50,500,67,755
4840,2011-07-25,3,0,7,13,0,1,1,2,0.74,0.7121,0.74,0.1343,14,210,64,640,78,850
4841,2011-07-25,3,0,7,14,0,1,1,2,0.72,0.697,0.79,0.194,28,420,62,620,90,1040
4842,2011-07-25,3,0,7,15,0,1,1,1,0.7,0.6667,0.84,0.3881,16,240,96,960,112,1200
4843,2011-07-25,3,0,7,16,0,1,1,1,0.7,0.6667,0.84,0.2239,37,555,161,1610,198,2165
4844,2011-07-25,3,0,7,17,0,1,1,1,0.72,0.697,0.74,0.0,48,720,437,4370,485,5090
4845,2011-07-25,3,0,7,18,0,1,1,1,0.74,0.7121,0.74,0.0896,60,900,473,4730,533,5630
4846,2011-07-25,3,0,7,19,0,1,1,1,0.74,0.697,0.7,0.0896,62,930,324,3240,386,4170
4847,2011-07-25,3,0,7,20,0,1,1,1,0.72,0.697,0.74,0.1343,55,825,247,2470,302,3295
4848,2011-07-25,3,0,7,21,0,1,1,1,0.7,0.6667,0.84,0.0,41,615,153,1530,194,2145
4849,2011-07-25,3,0,7,22,0,1,1,1,0.7,0.6667,0.84,0.0,13,195,112,1120,125,1315
4850,2011-07-25,3,0,7,23,0,1,1,1,0.7,0.6667,0.84,0.0896,23,345,64,640,87,985
4851,2011-07-26,3,0,7,0,0,2,1,1,0.7,0.6667,0.79,0.1045,8,120,20,200,28,320
4852,2011-07-26,3,0,7,1,0,2,1,1,0.7,0.6667,0.79,0.1045,6,90,6,60,12,150
4853,2011-07-26,3,0,7,2,0,2,1,1,0.68,0.6364,0.89,0.1045,1,15,6,60,7,75
4854,2011-07-26,3,0,7,3,0,2,1,1,0.68,0.6364,0.89,0.1343,2,30,2,20,4,50
4855,2011-07-26,3,0,7,4,0,2,1,1,0.68,0.6364,0.88,0.1642,0,0,6,60,6,60
4856,2011-07-26,3,0,7,5,0,2,1,1,0.66,0.5909,0.89,0.0896,3,45,24,240,27,285
4857,2011-07-26,3,0,7,6,0,2,1,1,0.68,0.6364,0.83,0.2239,2,30,108,1080,110,1110
4858,2011-07-26,3,0,7,7,0,2,1,1,0.72,0.6818,0.66,0.2836,30,450,288,2880,318,3330
4859,2011-07-26,3,0,7,8,0,2,1,1,0.74,0.6818,0.55,0.194,32,480,392,3920,424,4400
4860,2011-07-26,3,0,7,9,0,2,1,1,0.76,0.6818,0.4,0.2239,25,375,162,1620,187,1995
4861,2011-07-26,3,0,7,10,0,2,1,1,0.8,0.697,0.31,0.2239,42,630,96,960,138,1590
4862,2011-07-26,3,0,7,11,0,2,1,1,0.82,0.7121,0.3,0.0,49,735,102,1020,151,1755
4863,2011-07-26,3,0,7,12,0,2,1,1,0.84,0.7273,0.28,0.0,25,375,122,1220,147,1595
4864,2011-07-26,3,0,7,13,0,2,1,1,0.84,0.7273,0.32,0.2985,43,645,139,1390,182,2035
4865,2011-07-26,3,0,7,14,0,2,1,1,0.86,0.7424,0.3,0.2836,46,690,101,1010,147,1700
4866,2011-07-26,3,0,7,15,0,2,1,1,0.88,0.7576,0.28,0.3284,49,735,114,1140,163,1875
4867,2011-07-26,3,0,7,16,0,2,1,1,0.86,0.7576,0.36,0.2836,41,615,213,2130,254,2745
4868,2011-07-26,3,0,7,17,0,2,1,1,0.86,0.7576,0.36,0.3582,72,1080,465,4650,537,5730
4869,2011-07-26,3,0,7,18,0,2,1,1,0.84,0.7424,0.39,0.3881,68,1020,478,4780,546,5800
4870,2011-07-26,3,0,7,19,0,2,1,1,0.82,0.7424,0.43,0.2985,69,1035,329,3290,398,4325
4871,2011-07-26,3,0,7,20,0,2,1,1,0.8,0.7273,0.46,0.2537,47,705,243,2430,290,3135
4872,2011-07-26,3,0,7,21,0,2,1,1,0.78,0.7121,0.49,0.2239,45,675,222,2220,267,2895
4873,2011-07-26,3,0,7,22,0,2,1,1,0.76,0.697,0.55,0.1343,27,405,131,1310,158,1715
4874,2011-07-26,3,0,7,23,0,2,1,1,0.76,0.7121,0.58,0.1045,18,270,71,710,89,980
4875,2011-07-27,3,0,7,0,0,3,1,2,0.78,0.7121,0.52,0.1642,19,285,26,260,45,545
4876,2011-07-27,3,0,7,1,0,3,1,1,0.78,0.7121,0.49,0.194,1,15,9,90,10,105
4877,2011-07-27,3,0,7,2,0,3,1,1,0.76,0.697,0.52,0.2985,1,15,5,50,6,65
4878,2011-07-27,3,0,7,3,0,3,1,1,0.72,0.6667,0.58,0.1642,0,0,4,40,4,40
4879,2011-07-27,3,0,7,4,0,3,1,1,0.72,0.6667,0.51,0.194,1,15,3,30,4,45
4880,2011-07-27,3,0,7,5,0,3,1,1,0.7,0.6515,0.54,0.2836,0,0,18,180,18,180
4881,2011-07-27,3,0,7,6,0,3,1,1,0.7,0.6515,0.54,0.2239,4,60,119,1190,123,1250
4882,2011-07-27,3,0,7,7,0,3,1,1,0.72,0.6667,0.48,0.2537,34,510,313,3130,347,3640
4883,2011-07-27,3,0,7,8,0,3,1,1,0.74,0.6667,0.42,0.2537,28,420,405,4050,433,4470
4884,2011-07-27,3,0,7,9,0,3,1,1,0.76,0.6667,0.35,0.2537,27,405,189,1890,216,2295
4885,2011-07-27,3,0,7,10,0,3,1,1,0.78,0.6818,0.33,0.0,32,480,82,820,114,1300
4886,2011-07-27,3,0,7,11,0,3,1,1,0.8,0.697,0.31,0.0,42,630,94,940,136,1570
4887,2011-07-27,3,0,7,12,0,3,1,1,0.82,0.7121,0.3,0.2836,37,555,132,1320,169,1875
4888,2011-07-27,3,0,7,13,0,3,1,1,0.84,0.7273,0.3,0.3582,29,435,151,1510,180,1945
4889,2011-07-27,3,0,7,14,0,3,1,1,0.84,0.7273,0.28,0.2239,20,300,107,1070,127,1370
4890,2011-07-27,3,0,7,15,0,3,1,1,0.86,0.7424,0.26,0.2537,37,555,103,1030,140,1585
4891,2011-07-27,3,0,7,16,0,3,1,1,0.86,0.7273,0.25,0.1642,40,600,228,2280,268,2880
4892,2011-07-27,3,0,7,17,0,3,1,1,0.84,0.7121,0.26,0.2239,81,1215,491,4910,572,6125
4893,2011-07-27,3,0,7,18,0,3,1,1,0.82,0.7121,0.28,0.1045,78,1170,463,4630,541,5800
4894,2011-07-27,3,0,7,19,0,3,1,1,0.8,0.697,0.29,0.0896,87,1305,288,2880,375,4185
4895,2011-07-27,3,0,7,20,0,3,1,1,0.76,0.6818,0.45,0.2239,55,825,239,2390,294,3215
4896,2011-07-27,3,0,7,21,0,3,1,1,0.74,0.6667,0.48,0.1045,49,735,196,1960,245,2695
4897,2011-07-27,3,0,7,22,0,3,1,1,0.72,0.6667,0.48,0.0,37,555,143,1430,180,1985
4898,2011-07-27,3,0,7,23,0,3,1,1,0.74,0.6667,0.45,0.0896,16,240,93,930,109,1170
4899,2011-07-28,3,0,7,0,0,4,1,1,0.7,0.6515,0.51,0.1343,14,210,31,310,45,520
4900,2011-07-28,3,0,7,1,0,4,1,1,0.72,0.6667,0.51,0.0,3,45,26,260,29,305
4901,2011-07-28,3,0,7,2,0,4,1,1,0.72,0.6667,0.54,0.1045,2,30,5,50,7,80
4902,2011-07-28,3,0,7,3,0,4,1,1,0.72,0.6667,0.54,0.0,0,0,5,50,5,50
4903,2011-07-28,3,0,7,4,0,4,1,1,0.7,0.6515,0.61,0.1045,0,0,6,60,6,60
4904,2011-07-28,3,0,7,5,0,4,1,1,0.7,0.6515,0.65,0.1045,1,15,26,260,27,275
4905,2011-07-28,3,0,7,6,0,4,1,1,0.7,0.6515,0.7,0.0896,6,90,110,1100,116,1190
4906,2011-07-28,3,0,7,7,0,4,1,1,0.72,0.6818,0.7,0.1642,27,405,278,2780,305,3185
4907,2011-07-28,3,0,7,8,0,4,1,1,0.74,0.697,0.66,0.1642,47,705,409,4090,456,4795
4908,2011-07-28,3,0,7,9,0,4,1,1,0.78,0.7424,0.59,0.194,21,315,189,1890,210,2205
4909,2011-07-28,3,0,7,10,0,4,1,1,0.8,0.7576,0.55,0.2836,30,450,86,860,116,1310
4910,2011-07-28,3,0,7,11,0,4,1,1,0.84,0.8182,0.56,0.2836,41,615,113,1130,154,1745
4911,2011-07-28,3,0,7,12,0,4,1,1,0.84,0.803,0.53,0.2537,35,525,151,1510,186,2035
4912,2011-07-28,3,0,7,13,0,4,1,1,0.86,0.803,0.47,0.2537,26,390,126,1260,152,1650
4913,2011-07-28,3,0,7,14,0,4,1,2,0.84,0.7879,0.49,0.2537,27,405,111,1110,138,1515
4914,2011-07-28,3,0,7,15,0,4,1,1,0.86,0.8182,0.5,0.194,22,330,124,1240,146,1570
4915,2011-07-28,3,0,7,16,0,4,1,1,0.86,0.803,0.47,0.1642,42,630,214,2140,256,2770
4916,2011-07-28,3,0,7,17,0,4,1,1,0.84,0.803,0.53,0.194,45,675,423,4230,468,4905
4917,2011-07-28,3,0,7,18,0,4,1,1,0.84,0.8182,0.56,0.2239,55,825,428,4280,483,5105
4918,2011-07-28,3,0,7,19,0,4,1,1,0.82,0.803,0.59,0.194,37,555,285,2850,322,3405
4919,2011-07-28,3,0,7,20,0,4,1,1,0.8,0.7879,0.63,0.194,41,615,229,2290,270,2905
4920,2011-07-28,3,0,7,21,0,4,1,1,0.78,0.7576,0.66,0.2836,31,465,165,1650,196,2115
4921,2011-07-28,3,0,7,22,0,4,1,1,0.76,0.7273,0.7,0.2537,25,375,149,1490,174,1865
4922,2011-07-28,3,0,7,23,0,4,1,1,0.76,0.7424,0.75,0.194,28,420,95,950,123,1370
4923,2011-07-29,3,0,7,0,0,5,1,1,0.74,0.7121,0.79,0.1642,12,180,45,450,57,630
4924,2011-07-29,3,0,7,1,0,5,1,1,0.74,0.7121,0.79,0.1343,12,180,22,220,34,400
4925,2011-07-29,3,0,7,2,0,5,1,1,0.74,0.7121,0.79,0.0,3,45,10,100,13,145
4926,2011-07-29,3,0,7,3,0,5,1,1,0.74,0.7121,0.79,0.0,2,30,9,90,11,120
4927,2011-07-29,3,0,7,4,0,5,1,1,0.72,0.7121,0.84,0.1343,2,30,4,40,6,70
4928,2011-07-29,3,0,7,5,0,5,1,1,0.72,0.7121,0.84,0.0,4,60,23,230,27,290
4929,2011-07-29,3,0,7,6,0,5,1,2,0.72,0.7121,0.84,0.0,7,105,83,830,90,935
4930,2011-07-29,3,0,7,7,0,5,1,2,0.74,0.7121,0.79,0.0896,26,390,228,2280,254,2670
4931,2011-07-29,3,0,7,8,0,5,1,2,0.76,0.7727,0.77,0.0,30,450,354,3540,384,3990
4932,2011-07-29,3,0,7,9,0,5,1,1,0.86,0.803,0.47,0.2537,28,420,151,1510,179,1930
4933,2011-07-29,3,0,7,10,0,5,1,1,0.9,0.8485,0.42,0.2836,37,555,69,690,106,1245
4934,2011-07-29,3,0,7,11,0,5,1,1,0.92,0.8788,0.4,0.2985,43,645,118,1180,161,1825
4935,2011-07-29,3,0,7,12,0,5,1,1,0.96,0.8636,0.31,0.2836,40,600,95,950,135,1550
4936,2011-07-29,3,0,7,13,0,5,1,1,0.94,0.8333,0.31,0.0,42,630,114,1140,156,1770
4937,2011-07-29,3,0,7,14,0,5,1,1,0.96,0.8636,0.3,0.2239,34,510,114,1140,148,1650
4938,2011-07-29,3,0,7,15,0,5,1,1,0.96,0.8636,0.3,0.2537,40,600,129,1290,169,1890
4939,2011-07-29,3,0,7,16,0,5,1,1,0.96,0.8636,0.3,0.3881,35,525,198,1980,233,2505
4940,2011-07-29,3,0,7,17,0,5,1,1,0.96,0.8636,0.3,0.2985,47,705,374,3740,421,4445
4941,2011-07-29,3,0,7,18,0,5,1,1,0.92,0.8636,0.37,0.3284,49,735,313,3130,362,3865
4942,2011-07-29,3,0,7,19,0,5,1,1,0.9,0.8485,0.42,0.2239,22,330,219,2190,241,2520
4943,2011-07-29,3,0,7,20,0,5,1,1,0.86,0.7879,0.41,0.3284,53,795,153,1530,206,2325
4944,2011-07-29,3,0,7,21,0,5,1,1,0.82,0.7576,0.46,0.1642,29,435,134,1340,163,1775
4945,2011-07-29,3,0,7,22,0,5,1,1,0.8,0.7424,0.49,0.2239,47,705,127,1270,174,1975
4946,2011-07-29,3,0,7,23,0,5,1,1,0.78,0.7121,0.52,0.1045,26,390,90,900,116,1290
4947,2011-07-30,3,0,7,0,0,6,0,1,0.76,0.697,0.55,0.194,60,900,73,730,133,1630
4948,2011-07-30,3,0,7,1,0,6,0,1,0.76,0.697,0.55,0.0896,15,225,75,750,90,975
4949,2011-07-30,3,0,7,2,0,6,0,1,0.76,0.697,0.55,0.1045,11,165,31,310,42,475
4950,2011-07-30,3,0,7,3,0,6,0,1,0.74,0.6818,0.62,0.1642,18,270,25,250,43,520
4951,2011-07-30,3,0,7,4,0,6,0,1,0.72,0.6818,0.66,0.1642,4,60,6,60,10,120
4952,2011-07-30,3,0,7,5,0,6,0,1,0.72,0.6818,0.7,0.2836,4,60,9,90,13,150
4953,2011-07-30,3,0,7,6,0,6,0,1,0.72,0.6818,0.7,0.2985,6,90,18,180,24,270
4954,2011-07-30,3,0,7,7,0,6,0,1,0.76,0.7273,0.66,0.194,3,45,39,390,42,435
4955,2011-07-30,3,0,7,8,0,6,0,1,0.78,0.7424,0.59,0.2239,27,405,87,870,114,1275
4956,2011-07-30,3,0,7,9,0,6,0,1,0.82,0.7576,0.46,0.2985,49,735,125,1250,174,1985
4957,2011-07-30,3,0,7,10,0,6,0,1,0.82,0.7424,0.41,0.2985,79,1185,182,1820,261,3005
4958,2011-07-30,3,0,7,11,0,6,0,1,0.84,0.7424,0.36,0.194,111,1665,206,2060,317,3725
4959,2011-07-30,3,0,7,12,0,6,0,1,0.84,0.7273,0.32,0.1642,111,1665,230,2300,341,3965
4960,2011-07-30,3,0,7,13,0,6,0,1,0.88,0.7576,0.29,0.0,125,1875,183,1830,308,3705
4961,2011-07-30,3,0,7,14,0,6,0,1,0.9,0.7879,0.29,0.0,112,1680,193,1930,305,3610
4962,2011-07-30,3,0,7,15,0,6,0,1,0.9,0.803,0.31,0.1343,113,1695,189,1890,302,3585
4963,2011-07-30,3,0,7,16,0,6,0,1,0.9,0.7879,0.27,0.2239,126,1890,176,1760,302,3650
4964,2011-07-30,3,0,7,17,0,6,0,1,0.9,0.7879,0.29,0.1045,93,1395,209,2090,302,3485
4965,2011-07-30,3,0,7,18,0,6,0,1,0.88,0.7576,0.28,0.194,92,1380,207,2070,299,3450
4966,2011-07-30,3,0,7,19,0,6,0,1,0.74,0.6515,0.33,0.2239,101,1515,155,1550,256,3065
4967,2011-07-30,3,0,7,20,0,6,0,1,0.82,0.7424,0.43,0.1343,74,1110,132,1320,206,2430
4968,2011-07-30,3,0,7,21,0,6,0,1,0.8,0.7424,0.49,0.1642,82,1230,123,1230,205,2460
4969,2011-07-30,3,0,7,22,0,6,0,1,0.78,0.7121,0.52,0.1045,80,1200,129,1290,209,2490
4970,2011-07-30,3,0,7,23,0,6,0,1,0.76,0.697,0.55,0.0896,63,945,114,1140,177,2085
4971,2011-07-31,3,0,7,0,0,0,0,1,0.76,0.697,0.55,0.0896,33,495,80,800,113,1295
4972,2011-07-31,3,0,7,1,0,0,0,1,0.74,0.6818,0.62,0.0896,8,120,71,710,79,830
4973,2011-07-31,3,0,7,2,0,0,0,1,0.74,0.697,0.66,0.0896,19,285,48,480,67,765
4974,2011-07-31,3,0,7,3,0,0,0,1,0.74,0.697,0.66,0.0,24,360,26,260,50,620
4975,2011-07-31,3,0,7,4,0,0,0,1,0.72,0.6818,0.7,0.0,6,90,7,70,13,160
4976,2011-07-31,3,0,7,5,0,0,0,1,0.72,0.6818,0.69,0.0,4,60,4,40,8,100
4977,2011-07-31,3,0,7,6,0,0,0,1,0.74,0.697,0.7,0.0,5,75,8,80,13,155
4978,2011-07-31,3,0,7,7,0,0,0,1,0.74,0.6818,0.58,0.1343,19,285,26,260,45,545
4979,2011-07-31,3,0,7,8,0,0,0,1,0.76,0.697,0.55,0.2239,54,810,88,880,142,1690
4980,2011-07-31,3,0,7,9,0,0,0,1,0.8,0.7424,0.49,0.0,55,825,128,1280,183,2105
4981,2011-07-31,3,0,7,10,0,0,0,1,0.84,0.7424,0.36,0.1642,91,1365,163,1630,254,2995
4982,2011-07-31,3,0,7,11,0,0,0,1,0.86,0.7424,0.28,0.1642,112,1680,163,1630,275,3310
4983,2011-07-31,3,0,7,12,0,0,0,1,0.9,0.7727,0.25,0.194,146,2190,192,1920,338,4110
4984,2011-07-31,3,0,7,13,0,0,0,1,0.9,0.7727,0.24,0.1343,142,2130,152,1520,294,3650
4985,2011-07-31,3,0,7,14,0,0,0,1,0.9,0.7727,0.24,0.1642,130,1950,196,1960,326,3910
4986,2011-07-31,3,0,7,15,0,0,0,1,0.92,0.7727,0.18,0.2985,109,1635,184,1840,293,3475
4987,2011-07-31,3,0,7,16,0,0,0,1,0.92,0.7727,0.17,0.2836,98,1470,208,2080,306,3550
4988,2011-07-31,3,0,7,17,0,0,0,1,0.92,0.7727,0.16,0.1642,114,1710,206,2060,320,3770
4989,2011-07-31,3,0,7,18,0,0,0,1,0.86,0.7879,0.41,0.2836,91,1365,213,2130,304,3495
4990,2011-07-31,3,0,7,19,0,0,0,1,0.8,0.7576,0.55,0.3284,87,1305,187,1870,274,3175
4991,2011-07-31,3,0,7,20,0,0,0,1,0.8,0.7576,0.55,0.3284,70,1050,205,2050,275,3100
4992,2011-07-31,3,0,7,21,0,0,0,1,0.78,0.7424,0.59,0.2985,68,1020,96,960,164,1980
4993,2011-07-31,3,0,7,22,0,0,0,1,0.74,0.697,0.7,0.2985,25,375,71,710,96,1085
4994,2011-07-31,3,0,7,23,0,0,0,1,0.74,0.697,0.66,0.2239,14,210,56,560,70,770
4995,2011-08-01,3,0,8,0,0,1,1,1,0.72,0.6818,0.7,0.2239,7,105,22,220,29,325
4996,2011-08-01,3,0,8,1,0,1,1,1,0.72,0.697,0.74,0.194,5,75,12,120,17,195
4997,2011-08-01,3,0,8,2,0,1,1,1,0.7,0.6667,0.74,0.1045,4,60,7,70,11,130
4998,2011-08-01,3,0,8,3,0,1,1,1,0.7,0.6667,0.79,0.1642,0,0,4,40,4,40
4999,2011-08-01,3,0,8,4,0,1,1,1,0.66,0.6061,0.83,0.1343,2,30,2,20,4,50
5000,2011-08-01,3,0,8,5,0,1,1,1,0.66,0.6061,0.83,0.1045,2,30,24,240,26,270
5001,2011-08-01,3,0,8,6,0,1,1,1,0.66,0.6061,0.83,0.0896,3,45,97,970,100,1015
5002,2011-08-01,3,0,8,7,0,1,1,1,0.74,0.6818,0.62,0.0,24,360,258,2580,282,2940
5003,2011-08-01,3,0,8,8,0,1,1,1,0.8,0.7273,0.43,0.194,35,525,347,3470,382,3995
5004,2011-08-01,3,0,8,9,0,1,1,1,0.82,0.7424,0.41,0.0,27,405,139,1390,166,1795
5005,2011-08-01,3,0,8,10,0,1,1,1,0.86,0.7576,0.36,0.1642,27,405,70,700,97,1105
5006,2011-08-01,3,0,8,11,0,1,1,1,0.88,0.7727,0.32,0.1642,53,795,66,660,119,1455
5007,2011-08-01,3,0,8,12,0,1,1,1,0.9,0.803,0.33,0.2537,53,795,115,1150,168,1945
5008,2011-08-01,3,0,8,13,0,1,1,1,0.9,0.803,0.31,0.2985,38,570,112,1120,150,1690
5009,2011-08-01,3,0,8,14,0,1,1,1,0.92,0.8182,0.29,0.194,37,555,86,860,123,1415
5010,2011-08-01,3,0,8,15,0,1,1,1,0.9,0.7879,0.27,0.0,52,780,77,770,129,1550
5011,2011-08-01,3,0,8,16,0,1,1,1,0.9,0.7879,0.27,0.0,34,510,197,1970,231,2480
5012,2011-08-01,3,0,8,17,0,1,1,1,0.76,0.6818,0.45,0.2985,69,1035,445,4450,514,5485
5013,2011-08-01,3,0,8,18,0,1,1,1,0.78,0.697,0.43,0.194,68,1020,475,4750,543,5770
5014,2011-08-01,3,0,8,19,0,1,1,1,0.74,0.6667,0.51,0.2239,63,945,350,3500,413,4445
5015,2011-08-01,3,0,8,20,0,1,1,1,0.72,0.6818,0.62,0.2239,49,735,256,2560,305,3295
5016,2011-08-01,3,0,8,21,0,1,1,1,0.7,0.6515,0.7,0.2537,42,630,178,1780,220,2410
5017,2011-08-01,3,0,8,22,0,1,1,1,0.7,0.6515,0.7,0.0896,21,315,116,1160,137,1475
5018,2011-08-01,3,0,8,23,0,1,1,1,0.68,0.6364,0.74,0.194,14,210,82,820,96,1030
5019,2011-08-02,3,0,8,0,0,2,1,1,0.66,0.6212,0.74,0.0,11,165,18,180,29,345
5020,2011-08-02,3,0,8,1,0,2,1,1,0.66,0.6212,0.74,0.1045,4,60,8,80,12,140
5021,2011-08-02,3,0,8,2,0,2,1,1,0.68,0.6364,0.69,0.0,2,30,6,60,8,90
5022,2011-08-02,3,0,8,3,0,2,1,1,0.66,0.6212,0.74,0.194,0,0,5,50,5,50
5023,2011-08-02,3,0,8,4,0,2,1,1,0.66,0.6212,0.74,0.1045,0,0,10,100,10,100
5024,2011-08-02,3,0,8,5,0,2,1,1,0.66,0.6212,0.74,0.1343,4,60,17,170,21,230
5025,2011-08-02,3,0,8,6,0,2,1,1,0.68,0.6364,0.69,0.1045,12,180,105,1050,117,1230
5026,2011-08-02,3,0,8,7,0,2,1,1,0.72,0.6667,0.61,0.2836,15,225,320,3200,335,3425
5027,2011-08-02,3,0,8,8,0,2,1,1,0.74,0.6818,0.58,0.2836,37,555,398,3980,435,4535
5028,2011-08-02,3,0,8,9,0,2,1,1,0.78,0.697,0.46,0.2985,31,465,182,1820,213,2285
5029,2011-08-02,3,0,8,10,0,2,1,1,0.82,0.7273,0.36,0.2985,50,750,90,900,140,1650
5030,2011-08-02,3,0,8,11,0,2,1,1,0.84,0.7273,0.32,0.4179,32,480,96,960,128,1440
5031,2011-08-02,3,0,8,12,0,2,1,1,0.86,0.7424,0.3,0.2836,45,675,112,1120,157,1795
5032,2011-08-02,3,0,8,13,0,2,1,1,0.86,0.7424,0.3,0.2239,50,750,153,1530,203,2280
5033,2011-08-02,3,0,8,14,0,2,1,1,0.9,0.7727,0.25,0.2836,45,675,114,1140,159,1815
5034,2011-08-02,3,0,8,15,0,2,1,1,0.9,0.7727,0.25,0.2836,48,720,120,1200,168,1920
5035,2011-08-02,3,0,8,16,0,2,1,1,0.9,0.7727,0.25,0.2836,58,870,216,2160,274,3030
5036,2011-08-02,3,0,8,17,0,2,1,2,0.9,0.7879,0.27,0.1343,63,945,493,4930,556,5875
5037,2011-08-02,3,0,8,18,0,2,1,2,0.86,0.7576,0.34,0.194,65,975,491,4910,556,5885
5038,2011-08-02,3,0,8,19,0,2,1,2,0.86,0.7576,0.36,0.2239,85,1275,369,3690,454,4965
5039,2011-08-02,3,0,8,20,0,2,1,2,0.82,0.7576,0.46,0.2537,40,600,248,2480,288,3080
5040,2011-08-02,3,0,8,21,0,2,1,1,0.8,0.7424,0.52,0.2239,53,795,201,2010,254,2805
5041,2011-08-02,3,0,8,22,0,2,1,2,0.78,0.7424,0.59,0.1642,22,330,169,1690,191,2020
5042,2011-08-02,3,0,8,23,0,2,1,2,0.8,0.7424,0.49,0.1642,29,435,103,1030,132,1465
5043,2011-08-03,3,0,8,0,0,3,1,2,0.8,0.7424,0.49,0.1642,11,165,32,320,43,485
5044,2011-08-03,3,0,8,1,0,3,1,2,0.78,0.7121,0.52,0.1642,7,105,9,90,16,195
5045,2011-08-03,3,0,8,2,0,3,1,2,0.78,0.7121,0.49,0.1642,2,30,9,90,11,120
5046,2011-08-03,3,0,8,3,0,3,1,2,0.76,0.697,0.55,0.0896,0,0,4,40,4,40
5047,2011-08-03,3,0,8,4,0,3,1,2,0.76,0.697,0.52,0.1642,0,0,7,70,7,70
5048,2011-08-03,3,0,8,5,0,3,1,2,0.76,0.697,0.55,0.0896,2,30,22,220,24,250
5049,2011-08-03,3,0,8,6,0,3,1,3,0.72,0.6818,0.66,0.4925,9,135,101,1010,110,1145
5050,2011-08-03,3,0,8,7,0,3,1,2,0.74,0.6667,0.51,0.2239,19,285,252,2520,271,2805
5051,2011-08-03,3,0,8,8,0,3,1,2,0.74,0.6667,0.51,0.1642,29,435,408,4080,437,4515
5052,2011-08-03,3,0,8,9,0,3,1,2,0.74,0.6818,0.55,0.194,23,345,172,1720,195,2065
5053,2011-08-03,3,0,8,10,0,3,1,3,0.74,0.6818,0.58,0.0896,9,135,59,590,68,725
5054,2011-08-03,3,0,8,11,0,3,1,2,0.74,0.6818,0.58,0.1045,29,435,93,930,122,1365
5055,2011-08-03,3,0,8,12,0,3,1,3,0.76,0.697,0.55,0.1343,19,285,142,1420,161,1705
5056,2011-08-03,3,0,8,13,0,3,1,2,0.76,0.7121,0.58,0.2239,37,555,107,1070,144,1625
5057,2011-08-03,3,0,8,14,0,3,1,2,0.76,0.7121,0.58,0.2239,43,645,104,1040,147,1685
5058,2011-08-03,3,0,8,15,0,3,1,2,0.7,0.6667,0.79,0.1343,31,465,87,870,118,1335
5059,2011-08-03,3,0,8,16,0,3,1,3,0.68,0.6364,0.79,0.0,21,315,129,1290,150,1605
5060,2011-08-03,3,0,8,17,0,3,1,2,0.7,0.6667,0.79,0.0,47,705,378,3780,425,4485
5061,2011-08-03,3,0,8,18,0,3,1,3,0.7,0.6667,0.84,0.0,49,735,443,4430,492,5165
5062,2011-08-03,3,0,8,19,0,3,1,3,0.7,0.6667,0.84,0.0,51,765,270,2700,321,3465
5063,2011-08-03,3,0,8,20,0,3,1,3,0.7,0.6667,0.84,0.1045,7,105,80,800,87,905
5064,2011-08-03,3,0,8,21,0,3,1,2,0.68,0.6364,0.89,0.1343,7,105,81,810,88,915
5065,2011-08-03,3,0,8,22,0,3,1,3,0.68,0.6364,0.89,0.1045,11,165,66,660,77,825
5066,2011-08-03,3,0,8,23,0,3,1,2,0.68,0.6364,0.89,0.0896,4,60,52,520,56,580
5067,2011-08-04,3,0,8,0,0,4,1,2,0.68,0.6364,0.89,0.0896,2,30,15,150,17,180
5068,2011-08-04,3,0,8,1,0,4,1,2,0.66,0.5909,0.94,0.0896,3,45,14,140,17,185
5069,2011-08-04,3,0,8,2,0,4,1,2,0.66,0.5909,0.94,0.0896,2,30,5,50,7,80
5070,2011-08-04,3,0,8,3,0,4,1,3,0.66,0.5909,0.94,0.0896,0,0,3,30,3,30
5071,2011-08-04,3,0,8,4,0,4,1,2,0.68,0.6364,0.89,0.0,0,0,7,70,7,70
5072,2011-08-04,3,0,8,5,0,4,1,2,0.68,0.6364,0.89,0.0,3,45,17,170,20,215
5073,2011-08-04,3,0,8,6,0,4,1,2,0.68,0.6364,0.89,0.2985,7,105,90,900,97,1005
5074,2011-08-04,3,0,8,7,0,4,1,2,0.68,0.6364,0.89,0.2985,11,165,271,2710,282,2875
5075,2011-08-04,3,0,8,8,0,4,1,2,0.7,0.6515,0.82,0.3582,29,435,369,3690,398,4125
5076,2011-08-04,3,0,8,9,0,4,1,1,0.72,0.697,0.74,0.3284,25,375,162,1620,187,1995
5077,2011-08-04,3,0,8,10,0,4,1,1,0.72,0.6667,0.71,0.2985,24,360,89,890,113,1250
5078,2011-08-04,3,0,8,11,0,4,1,2,0.74,0.697,0.66,0.2239,37,555,112,1120,149,1675
5079,2011-08-04,3,0,8,12,0,4,1,2,0.76,0.7121,0.62,0.2239,53,795,152,1520,205,2315
5080,2011-08-04,3,0,8,13,0,4,1,1,0.76,0.7121,0.58,0.0,63,945,142,1420,205,2365
5081,2011-08-04,3,0,8,14,0,4,1,1,0.8,0.7576,0.55,0.1642,53,795,114,1140,167,1935
5082,2011-08-04,3,0,8,15,0,4,1,1,0.8,0.7576,0.55,0.2537,50,750,115,1150,165,1900
5083,2011-08-04,3,0,8,16,0,4,1,1,0.76,0.7121,0.62,0.3284,70,1050,220,2200,290,3250
5084,2011-08-04,3,0,8,17,0,4,1,1,0.76,0.7121,0.62,0.3284,91,1365,464,4640,555,6005
5085,2011-08-04,3,0,8,18,0,4,1,1,0.7,0.6667,0.74,0.2985,88,1320,435,4350,523,5670
5086,2011-08-04,3,0,8,19,0,4,1,1,0.7,0.6667,0.74,0.2836,65,975,301,3010,366,3985
5087,2011-08-04,3,0,8,20,0,4,1,2,0.7,0.6667,0.74,0.194,41,615,245,2450,286,3065
5088,2011-08-04,3,0,8,21,0,4,1,2,0.7,0.6667,0.74,0.194,25,375,186,1860,211,2235
5089,2011-08-04,3,0,8,22,0,4,1,1,0.68,0.6364,0.74,0.194,33,495,141,1410,174,1905
5090,2011-08-04,3,0,8,23,0,4,1,1,0.66,0.6212,0.74,0.1045,24,360,108,1080,132,1440
5091,2011-08-05,3,0,8,0,0,5,1,1,0.66,0.6212,0.74,0.1045,13,195,41,410,54,605
5092,2011-08-05,3,0,8,1,0,5,1,1,0.64,0.5909,0.78,0.0896,3,45,16,160,19,205
5093,2011-08-05,3,0,8,2,0,5,1,1,0.66,0.6212,0.69,0.0,5,75,14,140,19,215
5094,2011-08-05,3,0,8,3,0,5,1,1,0.64,0.5909,0.78,0.0896,0,0,6,60,6,60
5095,2011-08-05,3,0,8,4,0,5,1,1,0.64,0.5909,0.78,0.1343,1,15,6,60,7,75
5096,2011-08-05,3,0,8,5,0,5,1,1,0.64,0.5909,0.78,0.0896,0,0,16,160,16,160
5097,2011-08-05,3,0,8,6,0,5,1,1,0.64,0.5909,0.78,0.1343,7,105,94,940,101,1045
5098,2011-08-05,3,0,8,7,0,5,1,1,0.66,0.6061,0.78,0.1343,23,345,247,2470,270,2815
5099,2011-08-05,3,0,8,8,0,5,1,1,0.7,0.6515,0.65,0.2239,39,585,415,4150,454,4735
5100,2011-08-05,3,0,8,9,0,5,1,1,0.72,0.6667,0.58,0.1045,43,645,183,1830,226,2475
5101,2011-08-05,3,0,8,10,0,5,1,1,0.74,0.6818,0.55,0.1343,50,750,113,1130,163,1880
5102,2011-08-05,3,0,8,11,0,5,1,2,0.76,0.697,0.52,0.2537,44,660,103,1030,147,1690
5103,2011-08-05,3,0,8,12,0,5,1,1,0.76,0.697,0.52,0.2537,57,855,159,1590,216,2445
5104,2011-08-05,3,0,8,13,0,5,1,1,0.78,0.7121,0.52,0.2537,40,600,164,1640,204,2240
5105,2011-08-05,3,0,8,14,0,5,1,2,0.78,0.7121,0.52,0.2537,81,1215,164,1640,245,2855
5106,2011-08-05,3,0,8,15,0,5,1,1,0.76,0.697,0.55,0.2537,50,750,160,1600,210,2350
5107,2011-08-05,3,0,8,16,0,5,1,1,0.8,0.7424,0.49,0.2537,76,1140,254,2540,330,3680
5108,2011-08-05,3,0,8,17,0,5,1,1,0.78,0.7121,0.49,0.2985,84,1260,466,4660,550,5920
5109,2011-08-05,3,0,8,18,0,5,1,1,0.76,0.697,0.52,0.2537,105,1575,361,3610,466,5185
5110,2011-08-05,3,0,8,19,0,5,1,1,0.74,0.6818,0.55,0.2537,90,1350,282,2820,372,4170
5111,2011-08-05,3,0,8,20,0,5,1,1,0.72,0.6667,0.58,0.2239,70,1050,221,2210,291,3260
5112,2011-08-05,3,0,8,21,0,5,1,1,0.7,0.6515,0.65,0.194,54,810,119,1190,173,2000
5113,2011-08-05,3,0,8,22,0,5,1,1,0.7,0.6515,0.65,0.2239,51,765,137,1370,188,2135
5114,2011-08-05,3,0,8,23,0,5,1,1,0.68,0.6364,0.69,0.2239,37,555,102,1020,139,1575
5115,2011-08-06,3,0,8,0,0,6,0,1,0.66,0.6061,0.78,0.194,29,435,104,1040,133,1475
5116,2011-08-06,3,0,8,1,0,6,0,1,0.66,0.6061,0.78,0.1642,17,255,50,500,67,755
5117,2011-08-06,3,0,8,2,0,6,0,1,0.66,0.6061,0.78,0.2239,14,210,39,390,53,600
5118,2011-08-06,3,0,8,3,0,6,0,2,0.66,0.6061,0.78,0.1642,14,210,28,280,42,490
5119,2011-08-06,3,0,8,4,0,6,0,2,0.66,0.6061,0.83,0.1642,5,75,5,50,10,125
5120,2011-08-06,3,0,8,5,0,6,0,1,0.64,0.5758,0.89,0.0896,2,30,4,40,6,70
5121,2011-08-06,3,0,8,6,0,6,0,1,0.64,0.5758,0.89,0.1045,5,75,22,220,27,295
5122,2011-08-06,3,0,8,7,0,6,0,1,0.68,0.6364,0.83,0.1642,14,210,49,490,63,700
5123,2011-08-06,3,0,8,8,0,6,0,1,0.68,0.6364,0.83,0.1642,27,405,94,940,121,1345
5124,2011-08-06,3,0,8,9,0,6,0,1,0.74,0.697,0.7,0.2239,60,900,155,1550,215,2450
5125,2011-08-06,3,0,8,10,0,6,0,2,0.74,0.697,0.7,0.2836,91,1365,199,1990,290,3355
5126,2011-08-06,3,0,8,11,0,6,0,1,0.78,0.7424,0.62,0.2239,138,2070,211,2110,349,4180
5127,2011-08-06,3,0,8,12,0,6,0,1,0.8,0.7576,0.55,0.2239,130,1950,252,2520,382,4470
5128,2011-08-06,3,0,8,13,0,6,0,2,0.8,0.7727,0.59,0.3284,176,2640,265,2650,441,5290
5129,2011-08-06,3,0,8,14,0,6,0,1,0.82,0.7727,0.52,0.2537,176,2640,204,2040,380,4680
5130,2011-08-06,3,0,8,15,0,6,0,2,0.84,0.803,0.53,0.2537,130,1950,232,2320,362,4270
5131,2011-08-06,3,0,8,16,0,6,0,3,0.74,0.7121,0.79,0.1642,155,2325,188,1880,343,4205
5132,2011-08-06,3,0,8,17,0,6,0,3,0.74,0.7121,0.79,0.1642,61,915,88,880,149,1795
5133,2011-08-06,3,0,8,18,0,6,0,2,0.72,0.697,0.79,0.4478,81,1215,130,1300,211,2515
5134,2011-08-06,3,0,8,19,0,6,0,3,0.72,0.7121,0.84,0.2537,57,855,114,1140,171,1995
5135,2011-08-06,3,0,8,20,0,6,0,3,0.72,0.697,0.79,0.2836,58,870,79,790,137,1660
5136,2011-08-06,3,0,8,21,0,6,0,2,0.7,0.6667,0.84,0.3284,28,420,86,860,114,1280
5137,2011-08-06,3,0,8,22,0,6,0,2,0.7,0.6667,0.84,0.3284,24,360,96,960,120,1320
5138,2011-08-06,3,0,8,23,0,6,0,3,0.7,0.6667,0.84,0.2836,29,435,79,790,108,1225
5139,2011-08-07,3,0,8,0,0,0,0,2,0.7,0.6667,0.84,0.2836,14,210,66,660,80,870
5140,2011-08-07,3,0,8,1,0,0,0,2,0.7,0.6667,0.84,0.2537,10,150,63,630,73,780
5141,2011-08-07,3,0,8,2,0,0,0,2,0.7,0.6667,0.84,0.2239,18,270,48,480,66,750
5142,2011-08-07,3,0,8,3,0,0,0,2,0.7,0.6667,0.84,0.1343,9,135,23,230,32,365
5143,2011-08-07,3,0,8,4,0,0,0,1,0.7,0.6667,0.84,0.1343,1,15,5,50,6,65
5144,2011-08-07,3,0,8,5,0,0,0,1,0.7,0.6667,0.89,0.194,1,15,4,40,5,55
5145,2011-08-07,3,0,8,6,0,0,0,1,0.7,0.6667,0.89,0.1642,3,45,10,100,13,145
5146,2011-08-07,3,0,8,7,0,0,0,1,0.7,0.6667,0.84,0.194,11,165,28,280,39,445
5147,2011-08-07,3,0,8,8,0,0,0,1,0.72,0.697,0.79,0.194,23,345,66,660,89,1005
5148,2011-08-07,3,0,8,9,0,0,0,1,0.76,0.7424,0.75,0.1045,82,1230,102,1020,184,2250
5149,2011-08-07,3,0,8,10,0,0,0,1,0.8,0.803,0.66,0.1343,88,1320,178,1780,266,3100
5150,2011-08-07,3,0,8,11,0,0,0,1,0.82,0.8333,0.63,0.0,113,1695,156,1560,269,3255
5151,2011-08-07,3,0,8,12,0,0,0,1,0.9,0.8485,0.42,0.2985,161,2415,209,2090,370,4505
5152,2011-08-07,3,0,8,13,0,0,0,1,0.9,0.8485,0.42,0.2985,118,1770,206,2060,324,3830
5153,2011-08-07,3,0,8,14,0,0,0,1,0.86,0.803,0.47,0.194,130,1950,192,1920,322,3870
5154,2011-08-07,3,0,8,15,0,0,0,3,0.72,0.697,0.74,0.2985,118,1770,208,2080,326,3850
5155,2011-08-07,3,0,8,16,0,0,0,3,0.72,0.697,0.74,0.2985,74,1110,119,1190,193,2300
5156,2011-08-07,3,0,8,17,0,0,0,3,0.74,0.7121,0.74,0.6418,63,945,131,1310,194,2255
5157,2011-08-07,3,0,8,18,0,0,0,1,0.72,0.697,0.74,0.0896,74,1110,155,1550,229,2660
5158,2011-08-07,3,0,8,19,0,0,0,1,0.72,0.697,0.79,0.1642,68,1020,160,1600,228,2620
5159,2011-08-07,3,0,8,20,0,0,0,1,0.72,0.7121,0.84,0.1343,50,750,133,1330,183,2080
5160,2011-08-07,3,0,8,21,0,0,0,1,0.72,0.7121,0.84,0.1045,36,540,100,1000,136,1540
5161,2011-08-07,3,0,8,22,0,0,0,1,0.7,0.6667,0.89,0.194,21,315,82,820,103,1135
5162,2011-08-07,3,0,8,23,0,0,0,1,0.7,0.6667,0.79,0.1045,12,180,43,430,55,610
5163,2011-08-08,3,0,8,0,0,1,1,1,0.7,0.6667,0.79,0.1045,13,195,17,170,30,365
5164,2011-08-08,3,0,8,1,0,1,1,1,0.68,0.6364,0.83,0.1343,4,60,8,80,12,140
5165,2011-08-08,3,0,8,2,0,1,1,1,0.66,0.5909,0.89,0.0,4,60,3,30,7,90
5166,2011-08-08,3,0,8,3,0,1,1,1,0.66,0.5909,0.89,0.0,1,15,0,0,1,15
5167,2011-08-08,3,0,8,4,0,1,1,1,0.66,0.5909,0.89,0.1045,2,30,8,80,10,110
5168,2011-08-08,3,0,8,5,0,1,1,1,0.7,0.6667,0.79,0.0896,1,15,14,140,15,155
5169,2011-08-08,3,0,8,6,0,1,1,1,0.7,0.6515,0.65,0.2836,8,120,87,870,95,990
5170,2011-08-08,3,0,8,7,0,1,1,1,0.72,0.6818,0.62,0.2985,18,270,249,2490,267,2760
5171,2011-08-08,3,0,8,8,0,1,1,1,0.74,0.6818,0.58,0.3284,29,435,320,3200,349,3635
5172,2011-08-08,3,0,8,9,0,1,1,1,0.76,0.697,0.55,0.3881,37,555,146,1460,183,2015
5173,2011-08-08,3,0,8,10,0,1,1,1,0.8,0.7424,0.52,0.3881,62,930,62,620,124,1550
5174,2011-08-08,3,0,8,11,0,1,1,1,0.82,0.7424,0.48,0.3582,90,1350,89,890,179,2240
5175,2011-08-08,3,0,8,12,0,1,1,1,0.82,0.7576,0.46,0.2537,48,720,134,1340,182,2060
5176,2011-08-08,3,0,8,13,0,1,1,1,0.84,0.7576,0.44,0.2985,43,645,108,1080,151,1725
5177,2011-08-08,3,0,8,14,0,1,1,1,0.82,0.7424,0.43,0.2985,41,615,109,1090,150,1705
5178,2011-08-08,3,0,8,15,0,1,1,1,0.84,0.7576,0.41,0.2985,40,600,86,860,126,1460
5179,2011-08-08,3,0,8,16,0,1,1,1,0.86,0.7727,0.39,0.2836,64,960,218,2180,282,3140
5180,2011-08-08,3,0,8,17,0,1,1,1,0.86,0.7727,0.39,0.1642,67,1005,460,4600,527,5605
5181,2011-08-08,3,0,8,18,0,1,1,1,0.84,0.7576,0.41,0.1343,64,960,465,4650,529,5610
5182,2011-08-08,3,0,8,19,0,1,1,1,0.82,0.7424,0.43,0.1045,64,960,352,3520,416,4480
5183,2011-08-08,3,0,8,20,0,1,1,1,0.8,0.7576,0.55,0.0,71,1065,215,2150,286,3215
5184,2011-08-08,3,0,8,21,0,1,1,1,0.76,0.7121,0.58,0.0896,30,450,156,1560,186,2010
5185,2011-08-08,3,0,8,22,0,1,1,1,0.76,0.7121,0.58,0.1045,26,390,121,1210,147,1600
5186,2011-08-08,3,0,8,23,0,1,1,1,0.74,0.697,0.66,0.1045,19,285,53,530,72,815
5187,2011-08-09,3,0,8,0,0,2,1,1,0.72,0.697,0.79,0.1343,10,150,25,250,35,400
5188,2011-08-09,3,0,8,1,0,2,1,1,0.72,0.6818,0.66,0.0,5,75,9,90,14,165
5189,2011-08-09,3,0,8,2,0,2,1,1,0.72,0.6818,0.7,0.0,9,135,3,30,12,165
5190,2011-08-09,3,0,8,3,0,2,1,1,0.72,0.6818,0.62,0.0,0,0,3,30,3,30
5191,2011-08-09,3,0,8,4,0,2,1,1,0.7,0.6667,0.74,0.0,1,15,6,60,7,75
5192,2011-08-09,3,0,8,5,0,2,1,1,0.7,0.6515,0.65,0.0896,5,75,25,250,30,325
5193,2011-08-09,3,0,8,6,0,2,1,1,0.72,0.6667,0.64,0.0,6,90,95,950,101,1040
5194,2011-08-09,3,0,8,7,0,2,1,1,0.72,0.697,0.74,0.1045,30,450,313,3130,343,3580
5195,2011-08-09,3,0,8,8,0,2,1,1,0.74,0.697,0.66,0.0,40,600,352,3520,392,4120
5196,2011-08-09,3,0,8,9,0,2,1,2,0.78,0.7424,0.62,0.1343,34,510,141,1410,175,1920
5197,2011-08-09,3,0,8,10,0,2,1,2,0.8,0.7727,0.59,0.2239,55,825,89,890,144,1715
5198,2011-08-09,3,0,8,11,0,2,1,1,0.8,0.7727,0.59,0.2239,61,915,88,880,149,1795
5199,2011-08-09,3,0,8,12,0,2,1,1,0.82,0.7879,0.56,0.194,60,900,125,1250,185,2150
5200,2011-08-09,3,0,8,13,0,2,1,1,0.84,0.7879,0.49,0.1642,48,720,127,1270,175,1990
5201,2011-08-09,3,0,8,14,0,2,1,1,0.86,0.7879,0.44,0.2836,53,795,95,950,148,1745
5202,2011-08-09,3,0,8,15,0,2,1,1,0.86,0.7727,0.39,0.2836,58,870,106,1060,164,1930
5203,2011-08-09,3,0,8,16,0,2,1,1,0.86,0.7727,0.39,0.2985,57,855,228,2280,285,3135
5204,2011-08-09,3,0,8,17,0,2,1,1,0.8,0.7576,0.55,0.1642,79,1185,453,4530,532,5715
5205,2011-08-09,3,0,8,18,0,2,1,1,0.8,0.7576,0.55,0.194,97,1455,488,4880,585,6335
5206,2011-08-09,3,0,8,19,0,2,1,1,0.8,0.7424,0.49,0.1045,69,1035,302,3020,371,4055
5207,2011-08-09,3,0,8,20,0,2,1,1,0.8,0.7273,0.43,0.194,34,510,258,2580,292,3090
5208,2011-08-09,3,0,8,21,0,2,1,1,0.78,0.697,0.46,0.2537,46,690,184,1840,230,2530
5209,2011-08-09,3,0,8,22,0,2,1,1,0.78,0.697,0.46,0.2985,28,420,127,1270,155,1690
5210,2011-08-09,3,0,8,23,0,2,1,1,0.76,0.6818,0.48,0.2836,22,330,53,530,75,860
5211,2011-08-10,3,0,8,0,0,3,1,1,0.74,0.6667,0.51,0.2239,19,285,18,180,37,465
5212,2011-08-10,3,0,8,1,0,3,1,1,0.72,0.6667,0.54,0.194,7,105,10,100,17,205
5213,2011-08-10,3,0,8,2,0,3,1,1,0.72,0.6667,0.54,0.1642,1,15,10,100,11,115
5214,2011-08-10,3,0,8,3,0,3,1,1,0.7,0.6515,0.58,0.1642,1,15,3,30,4,45
5215,2011-08-10,3,0,8,4,0,3,1,1,0.7,0.6515,0.54,0.1343,1,15,4,40,5,55
5216,2011-08-10,3,0,8,5,0,3,1,1,0.68,0.6364,0.61,0.0896,2,30,30,300,32,330
5217,2011-08-10,3,0,8,6,0,3,1,1,0.68,0.6364,0.61,0.0,9,135,110,1100,119,1235
5218,2011-08-10,3,0,8,7,0,3,1,1,0.7,0.6515,0.58,0.0896,16,240,289,2890,305,3130
5219,2011-08-10,3,0,8,8,0,3,1,1,0.74,0.6667,0.51,0.194,38,570,361,3610,399,4180
5220,2011-08-10,3,0,8,9,0,3,1,1,0.76,0.6818,0.48,0.2239,32,480,148,1480,180,1960
5221,2011-08-10,3,0,8,10,0,3,1,1,0.8,0.7273,0.43,0.2239,41,615,72,720,113,1335
5222,2011-08-10,3,0,8,11,0,3,1,1,0.8,0.7121,0.41,0.3881,54,810,95,950,149,1760
5223,2011-08-10,3,0,8,12,0,3,1,1,0.82,0.7273,0.38,0.2985,74,1110,166,1660,240,2770
5224,2011-08-10,3,0,8,13,0,3,1,1,0.82,0.7273,0.38,0.2836,41,615,150,1500,191,2115
5225,2011-08-10,3,0,8,14,0,3,1,1,0.84,0.7273,0.34,0.3284,62,930,116,1160,178,2090
5226,2011-08-10,3,0,8,15,0,3,1,1,0.86,0.7424,0.3,0.3284,53,795,141,1410,194,2205
5227,2011-08-10,3,0,8,16,0,3,1,1,0.86,0.7424,0.26,0.2985,76,1140,206,2060,282,3200
5228,2011-08-10,3,0,8,17,0,3,1,1,0.84,0.7121,0.26,0.2985,71,1065,513,5130,584,6195
5229,2011-08-10,3,0,8,18,0,3,1,1,0.82,0.7121,0.28,0.2985,70,1050,489,4890,559,5940
5230,2011-08-10,3,0,8,19,0,3,1,1,0.8,0.697,0.26,0.2537,79,1185,334,3340,413,4525
5231,2011-08-10,3,0,8,20,0,3,1,1,0.76,0.6667,0.31,0.1343,59,885,253,2530,312,3415
5232,2011-08-10,3,0,8,21,0,3,1,1,0.76,0.6667,0.33,0.1045,47,705,162,1620,209,2325
5233,2011-08-10,3,0,8,22,0,3,1,1,0.74,0.6515,0.37,0.0,17,255,122,1220,139,1475
5234,2011-08-10,3,0,8,23,0,3,1,1,0.74,0.6515,0.37,0.0896,14,210,94,940,108,1150
5235,2011-08-11,3,0,8,0,0,4,1,1,0.7,0.6364,0.45,0.1045,6,90,40,400,46,490
5236,2011-08-11,3,0,8,1,0,4,1,1,0.7,0.6364,0.45,0.1343,9,135,17,170,26,305
5237,2011-08-11,3,0,8,2,0,4,1,1,0.66,0.6212,0.54,0.1343,3,45,8,80,11,125
5238,2011-08-11,3,0,8,3,0,4,1,1,0.64,0.6212,0.57,0.1343,2,30,7,70,9,100
5239,2011-08-11,3,0,8,4,0,4,1,1,0.64,0.6212,0.57,0.1642,1,15,4,40,5,55
5240,2011-08-11,3,0,8,5,0,4,1,1,0.64,0.6212,0.61,0.194,2,30,23,230,25,260
5241,2011-08-11,3,0,8,6,0,4,1,1,0.62,0.6061,0.65,0.1642,5,75,101,1010,106,1085
5242,2011-08-11,3,0,8,7,0,4,1,1,0.66,0.6212,0.54,0.1343,15,225,292,2920,307,3145
5243,2011-08-11,3,0,8,8,0,4,1,1,0.7,0.6364,0.45,0.1642,29,435,361,3610,390,4045
5244,2011-08-11,3,0,8,9,0,4,1,1,0.72,0.6515,0.39,0.2239,31,465,166,1660,197,2125
5245,2011-08-11,3,0,8,10,0,4,1,1,0.74,0.6515,0.37,0.2537,36,540,96,960,132,1500
5246,2011-08-11,3,0,8,11,0,4,1,1,0.76,0.6667,0.35,0.2537,59,885,128,1280,187,2165
5247,2011-08-11,3,0,8,12,0,4,1,1,0.78,0.6818,0.31,0.2537,50,750,164,1640,214,2390
5248,2011-08-11,3,0,8,13,0,4,1,1,0.76,0.6667,0.31,0.2239,51,765,166,1660,217,2425
5249,2011-08-11,3,0,8,14,0,4,1,1,0.8,0.697,0.29,0.0,39,585,103,1030,142,1615
5250,2011-08-11,3,0,8,15,0,4,1,1,0.8,0.697,0.29,0.2985,52,780,126,1260,178,2040
5251,2011-08-11,3,0,8,16,0,4,1,1,0.8,0.697,0.27,0.194,57,855,241,2410,298,3265
5252,2011-08-11,3,0,8,17,0,4,1,1,0.8,0.697,0.29,0.2537,96,1440,486,4860,582,6300
5253,2011-08-11,3,0,8,18,0,4,1,1,0.78,0.6818,0.29,0.0896,74,1110,497,4970,571,6080
5254,2011-08-11,3,0,8,19,0,4,1,1,0.74,0.6515,0.35,0.194,48,720,323,3230,371,3950
5255,2011-08-11,3,0,8,20,0,4,1,1,0.72,0.6515,0.37,0.1343,56,840,232,2320,288,3160
5256,2011-08-11,3,0,8,21,0,4,1,1,0.7,0.6515,0.48,0.0896,35,525,171,1710,206,2235
5257,2011-08-11,3,0,8,22,0,4,1,1,0.7,0.6515,0.48,0.0,34,510,123,1230,157,1740
5258,2011-08-11,3,0,8,23,0,4,1,1,0.66,0.6212,0.5,0.1642,22,330,105,1050,127,1380
5259,2011-08-12,3,0,8,0,0,5,1,1,0.64,0.6212,0.53,0.1642,12,180,53,530,65,710
5260,2011-08-12,3,0,8,1,0,5,1,1,0.64,0.6212,0.53,0.1343,4,60,19,190,23,250
5261,2011-08-12,3,0,8,2,0,5,1,1,0.62,0.6212,0.57,0.194,0,0,15,150,15,150
5262,2011-08-12,3,0,8,3,0,5,1,1,0.62,0.6212,0.53,0.1642,0,0,9,90,9,90
5263,2011-08-12,3,0,8,4,0,5,1,1,0.62,0.6212,0.53,0.1343,0,0,5,50,5,50
5264,2011-08-12,3,0,8,5,0,5,1,1,0.6,0.6212,0.56,0.1343,2,30,24,240,26,270
5265,2011-08-12,3,0,8,6,0,5,1,1,0.62,0.6212,0.5,0.1343,3,45,73,730,76,775
5266,2011-08-12,3,0,8,7,0,5,1,1,0.64,0.6212,0.44,0.1642,17,255,247,2470,264,2725
5267,2011-08-12,3,0,8,8,0,5,1,1,0.68,0.6364,0.39,0.2239,29,435,397,3970,426,4405
5268,2011-08-12,3,0,8,9,0,5,1,1,0.72,0.6515,0.34,0.1343,27,405,178,1780,205,2185
5269,2011-08-12,3,0,8,10,0,5,1,1,0.74,0.6515,0.33,0.1045,44,660,86,860,130,1520
5270,2011-08-12,3,0,8,11,0,5,1,1,0.76,0.6667,0.29,0.0,48,720,108,1080,156,1800
5271,2011-08-12,3,0,8,12,0,5,1,1,0.8,0.697,0.27,0.0,55,825,167,1670,222,2495
5272,2011-08-12,3,0,8,13,0,5,1,1,0.78,0.6818,0.29,0.0896,74,1110,179,1790,253,2900
5273,2011-08-12,3,0,8,14,0,5,1,1,0.8,0.697,0.29,0.194,51,765,135,1350,186,2115
5274,2011-08-12,3,0,8,15,0,5,1,1,0.8,0.697,0.29,0.1642,59,885,190,1900,249,2785
5275,2011-08-12,3,0,8,16,0,5,1,1,0.82,0.7121,0.28,0.0,68,1020,266,2660,334,3680
5276,2011-08-12,3,0,8,17,0,5,1,1,0.82,0.7121,0.26,0.0,93,1395,423,4230,516,5625
5277,2011-08-12,3,0,8,18,0,5,1,1,0.76,0.6818,0.4,0.2985,89,1335,376,3760,465,5095
5278,2011-08-12,3,0,8,19,0,5,1,1,0.74,0.6667,0.42,0.2239,101,1515,284,2840,385,4355
5279,2011-08-12,3,0,8,20,0,5,1,1,0.72,0.6515,0.42,0.2239,77,1155,210,2100,287,3255
5280,2011-08-12,3,0,8,21,0,5,1,1,0.7,0.6515,0.48,0.1343,73,1095,153,1530,226,2625
5281,2011-08-12,3,0,8,22,0,5,1,1,0.68,0.6364,0.51,0.0,74,1110,157,1570,231,2680
5282,2011-08-12,3,0,8,23,0,5,1,1,0.68,0.6364,0.51,0.0,51,765,100,1000,151,1765
5283,2011-08-13,3,0,8,0,0,6,0,1,0.68,0.6364,0.51,0.1045,15,225,69,690,84,915
5284,2011-08-13,3,0,8,1,0,6,0,2,0.68,0.6364,0.57,0.0896,13,195,64,640,77,835
5285,2011-08-13,3,0,8,2,0,6,0,1,0.68,0.6364,0.57,0.0,16,240,58,580,74,820
5286,2011-08-13,3,0,8,3,0,6,0,1,0.66,0.6212,0.65,0.1343,9,135,18,180,27,315
5287,2011-08-13,3,0,8,4,0,6,0,2,0.64,0.6061,0.73,0.1343,5,75,5,50,10,125
5288,2011-08-13,3,0,8,5,0,6,0,1,0.64,0.6061,0.73,0.1045,3,45,15,150,18,195
5289,2011-08-13,3,0,8,6,0,6,0,1,0.64,0.6061,0.73,0.0896,3,45,19,190,22,235
5290,2011-08-13,3,0,8,7,0,6,0,2,0.66,0.6212,0.74,0.194,10,150,34,340,44,490
5291,2011-08-13,3,0,8,8,0,6,0,2,0.7,0.6515,0.65,0.1642,28,420,90,900,118,1320
5292,2011-08-13,3,0,8,9,0,6,0,2,0.7,0.6667,0.74,0.1642,70,1050,138,1380,208,2430
5293,2011-08-13,3,0,8,10,0,6,0,2,0.72,0.697,0.74,0.2239,97,1455,163,1630,260,3085
5294,2011-08-13,3,0,8,11,0,6,0,2,0.74,0.697,0.7,0.194,122,1830,192,1920,314,3750
5295,2011-08-13,3,0,8,12,0,6,0,2,0.66,0.5909,0.89,0.1642,175,2625,246,2460,421,5085
5296,2011-08-13,3,0,8,13,0,6,0,2,0.74,0.7121,0.74,0.3284,61,915,92,920,153,1835
5297,2011-08-13,3,0,8,14,0,6,0,1,0.74,0.697,0.7,0.2537,113,1695,146,1460,259,3155
5298,2011-08-13,3,0,8,15,0,6,0,3,0.68,0.6364,0.79,0.3582,150,2250,208,2080,358,4330
5299,2011-08-13,3,0,8,16,0,6,0,2,0.7,0.6667,0.74,0.2836,148,2220,133,1330,281,3550
5300,2011-08-13,3,0,8,17,0,6,0,2,0.72,0.697,0.74,0.2537,97,1455,172,1720,269,3175
5301,2011-08-13,3,0,8,18,0,6,0,1,0.7,0.6667,0.74,0.2239,123,1845,169,1690,292,3535
5302,2011-08-13,3,0,8,19,0,6,0,2,0.68,0.6364,0.79,0.2836,67,1005,170,1700,237,2705
5303,2011-08-13,3,0,8,20,0,6,0,2,0.68,0.6364,0.83,0.2239,78,1170,105,1050,183,2220
5304,2011-08-13,3,0,8,21,0,6,0,2,0.68,0.6364,0.83,0.3881,40,600,127,1270,167,1870
5305,2011-08-13,3,0,8,22,0,6,0,2,0.68,0.6364,0.83,0.3881,36,540,118,1180,154,1720
5306,2011-08-13,3,0,8,23,0,6,0,2,0.66,0.6061,0.83,0.3284,25,375,95,950,120,1325
5307,2011-08-14,3,0,8,0,0,0,0,3,0.66,0.6061,0.83,0.2985,19,285,71,710,90,995
5308,2011-08-14,3,0,8,1,0,0,0,3,0.64,0.5758,0.89,0.2239,16,240,57,570,73,810
5309,2011-08-14,3,0,8,2,0,0,0,3,0.64,0.5758,0.89,0.2239,13,195,49,490,62,685
5310,2011-08-14,3,0,8,3,0,0,0,2,0.64,0.5606,0.94,0.2537,5,75,22,220,27,295
5311,2011-08-14,3,0,8,4,0,0,0,3,0.64,0.5606,0.94,0.194,1,15,2,20,3,35
5312,2011-08-14,3,0,8,5,0,0,0,2,0.64,0.5606,0.94,0.1642,1,15,9,90,10,105
5313,2011-08-14,3,0,8,6,0,0,0,2,0.64,0.5606,0.94,0.1045,2,30,4,40,6,70
5314,2011-08-14,3,0,8,7,0,0,0,2,0.66,0.5909,0.89,0.194,4,60,20,200,24,260
5315,2011-08-14,3,0,8,8,0,0,0,2,0.66,0.5909,0.89,0.2836,20,300,21,210,41,510
5316,2011-08-14,3,0,8,9,0,0,0,3,0.66,0.5909,0.89,0.2836,27,405,76,760,103,1165
5317,2011-08-14,3,0,8,10,0,0,0,1,0.7,0.6667,0.79,0.2239,67,1005,116,1160,183,2165
5318,2011-08-14,3,0,8,11,0,0,0,1,0.7,0.6667,0.79,0.194,81,1215,117,1170,198,2385
5319,2011-08-14,3,0,8,12,0,0,0,2,0.7,0.6667,0.79,0.2239,98,1470,183,1830,281,3300
5320,2011-08-14,3,0,8,13,0,0,0,1,0.72,0.697,0.74,0.2537,144,2160,233,2330,377,4490
5321,2011-08-14,3,0,8,14,0,0,0,1,0.74,0.697,0.7,0.194,126,1890,244,2440,370,4330
5322,2011-08-14,3,0,8,15,0,0,0,1,0.74,0.697,0.66,0.194,128,1920,203,2030,331,3950
5323,2011-08-14,3,0,8,16,0,0,0,1,0.74,0.697,0.66,0.1642,116,1740,176,1760,292,3500
5324,2011-08-14,3,0,8,17,0,0,0,1,0.76,0.7121,0.62,0.1343,133,1995,196,1960,329,3955
5325,2011-08-14,3,0,8,18,0,0,0,1,0.74,0.697,0.66,0.1642,125,1875,222,2220,347,4095
5326,2011-08-14,3,0,8,19,0,0,0,1,0.72,0.697,0.74,0.2239,75,1125,184,1840,259,2965
5327,2011-08-14,3,0,8,20,0,0,0,1,0.7,0.6667,0.84,0.1642,67,1005,126,1260,193,2265
5328,2011-08-14,3,0,8,21,0,0,0,3,0.6,0.5455,0.88,0.4925,51,765,104,1040,155,1805
5329,2011-08-14,3,0,8,22,0,0,0,3,0.6,0.5455,0.88,0.4925,14,210,25,250,39,460
5330,2011-08-14,3,0,8,23,0,0,0,3,0.6,0.5606,0.83,0.0,5,75,22,220,27,295
5331,2011-08-15,3,0,8,0,0,1,1,3,0.6,0.5455,0.88,0.0896,7,105,18,180,25,285
5332,2011-08-15,3,0,8,1,0,1,1,2,0.6,0.5455,0.88,0.1343,1,15,9,90,10,105
5333,2011-08-15,3,0,8,2,0,1,1,2,0.6,0.5606,0.83,0.0,0,0,3,30,3,30
5334,2011-08-15,3,0,8,3,0,1,1,1,0.6,0.5606,0.83,0.194,1,15,6,60,7,75
5335,2011-08-15,3,0,8,4,0,1,1,1,0.6,0.5606,0.83,0.1343,1,15,4,40,5,55
5336,2011-08-15,3,0,8,5,0,1,1,2,0.6,0.5455,0.88,0.194,3,45,14,140,17,185
5337,2011-08-15,3,0,8,6,0,1,1,1,0.6,0.5455,0.88,0.2537,3,45,87,870,90,915
5338,2011-08-15,3,0,8,7,0,1,1,1,0.6,0.5455,0.88,0.2537,10,150,248,2480,258,2630
5339,2011-08-15,3,0,8,8,0,1,1,1,0.64,0.5909,0.78,0.3284,29,435,326,3260,355,3695
5340,2011-08-15,3,0,8,9,0,1,1,1,0.64,0.5909,0.78,0.3284,52,780,170,1700,222,2480
5341,2011-08-15,3,0,8,10,0,1,1,1,0.68,0.6364,0.69,0.2836,54,810,87,870,141,1680
5342,2011-08-15,3,0,8,11,0,1,1,2,0.72,0.6818,0.62,0.2537,41,615,112,1120,153,1735
5343,2011-08-15,3,0,8,12,0,1,1,1,0.74,0.6818,0.58,0.2836,62,930,116,1160,178,2090
5344,2011-08-15,3,0,8,13,0,1,1,1,0.78,0.7121,0.52,0.2836,53,795,140,1400,193,2195
5345,2011-08-15,3,0,8,14,0,1,1,1,0.74,0.6818,0.55,0.0896,56,840,95,950,151,1790
5346,2011-08-15,3,0,8,15,0,1,1,3,0.74,0.6818,0.55,0.2985,49,735,133,1330,182,2065
5347,2011-08-15,3,0,8,16,0,1,1,1,0.74,0.6818,0.55,0.3284,58,870,225,2250,283,3120
5348,2011-08-15,3,0,8,17,0,1,1,1,0.74,0.6667,0.51,0.2836,59,885,471,4710,530,5595
5349,2011-08-15,3,0,8,18,0,1,1,1,0.7,0.6515,0.65,0.194,70,1050,413,4130,483,5180
5350,2011-08-15,3,0,8,19,0,1,1,1,0.7,0.6515,0.65,0.0,54,810,343,3430,397,4240
5351,2011-08-15,3,0,8,20,0,1,1,1,0.66,0.6212,0.74,0.1343,45,675,240,2400,285,3075
5352,2011-08-15,3,0,8,21,0,1,1,1,0.66,0.6212,0.65,0.194,34,510,150,1500,184,2010
5353,2011-08-15,3,0,8,22,0,1,1,1,0.66,0.6212,0.69,0.2537,22,330,76,760,98,1090
5354,2011-08-15,3,0,8,23,0,1,1,1,0.64,0.6061,0.69,0.2239,11,165,77,770,88,935
5355,2011-08-16,3,0,8,0,0,2,1,1,0.64,0.6061,0.69,0.1045,8,120,23,230,31,350
5356,2011-08-16,3,0,8,1,0,2,1,1,0.64,0.6061,0.69,0.1642,4,60,12,120,16,180
5357,2011-08-16,3,0,8,2,0,2,1,1,0.62,0.5909,0.73,0.2239,1,15,3,30,4,45
5358,2011-08-16,3,0,8,3,0,2,1,1,0.62,0.5909,0.73,0.2239,1,15,5,50,6,65
5359,2011-08-16,3,0,8,4,0,2,1,1,0.64,0.6061,0.69,0.2985,0,0,5,50,5,50
5360,2011-08-16,3,0,8,5,0,2,1,1,0.62,0.5909,0.73,0.2836,1,15,29,290,30,305
5361,2011-08-16,3,0,8,6,0,2,1,1,0.62,0.5909,0.73,0.3284,4,60,115,1150,119,1210
5362,2011-08-16,3,0,8,7,0,2,1,1,0.64,0.6061,0.69,0.2537,18,270,328,3280,346,3550
5363,2011-08-16,3,0,8,8,0,2,1,1,0.7,0.6515,0.58,0.4478,24,360,417,4170,441,4530
5364,2011-08-16,3,0,8,9,0,2,1,1,0.68,0.6364,0.61,0.2836,27,405,171,1710,198,2115
5365,2011-08-16,3,0,8,10,0,2,1,1,0.7,0.6515,0.58,0.3881,28,420,83,830,111,1250
5366,2011-08-16,3,0,8,11,0,2,1,1,0.74,0.6667,0.51,0.2239,40,600,110,1100,150,1700
5367,2011-08-16,3,0,8,12,0,2,1,1,0.76,0.6818,0.48,0.3284,42,630,120,1200,162,1830
5368,2011-08-16,3,0,8,13,0,2,1,1,0.76,0.6818,0.48,0.2985,45,675,147,1470,192,2145
5369,2011-08-16,3,0,8,14,0,2,1,1,0.76,0.6818,0.45,0.4179,65,975,117,1170,182,2145
5370,2011-08-16,3,0,8,15,0,2,1,1,0.8,0.7121,0.41,0.2985,36,540,123,1230,159,1770
5371,2011-08-16,3,0,8,16,0,2,1,1,0.8,0.7121,0.41,0.2239,55,825,248,2480,303,3305
5372,2011-08-16,3,0,8,17,0,2,1,1,0.76,0.6818,0.45,0.3284,75,1125,525,5250,600,6375
5373,2011-08-16,3,0,8,18,0,2,1,1,0.76,0.6818,0.45,0.2239,54,810,516,5160,570,5970
5374,2011-08-16,3,0,8,19,0,2,1,1,0.74,0.6667,0.48,0.194,56,840,320,3200,376,4040
5375,2011-08-16,3,0,8,20,0,2,1,1,0.74,0.6667,0.51,0.0,48,720,232,2320,280,3040
5376,2011-08-16,3,0,8,21,0,2,1,1,0.72,0.6667,0.54,0.0,38,570,177,1770,215,2340
5377,2011-08-16,3,0,8,22,0,2,1,1,0.7,0.6515,0.61,0.0,31,465,121,1210,152,1675
5378,2011-08-16,3,0,8,23,0,2,1,1,0.66,0.6212,0.65,0.1343,20,300,57,570,77,870
5379,2011-08-17,3,0,8,0,0,3,1,1,0.66,0.6212,0.69,0.0896,8,120,16,160,24,280
5380,2011-08-17,3,0,8,1,0,3,1,1,0.64,0.6061,0.73,0.1642,2,30,12,120,14,150
5381,2011-08-17,3,0,8,2,0,3,1,1,0.66,0.6212,0.69,0.0,0,0,6,60,6,60
5382,2011-08-17,3,0,8,3,0,3,1,1,0.64,0.5909,0.78,0.0,1,15,4,40,5,55
5383,2011-08-17,3,0,8,4,0,3,1,1,0.64,0.6061,0.73,0.0,0,0,5,50,5,50
5384,2011-08-17,3,0,8,5,0,3,1,1,0.64,0.6061,0.73,0.0,0,0,28,280,28,280
5385,2011-08-17,3,0,8,6,0,3,1,1,0.62,0.5909,0.78,0.0,4,60,101,1010,105,1070
5386,2011-08-17,3,0,8,7,0,3,1,1,0.66,0.6212,0.65,0.0896,12,180,296,2960,308,3140
5387,2011-08-17,3,0,8,8,0,3,1,1,0.7,0.6515,0.54,0.1642,35,525,452,4520,487,5045
5388,2011-08-17,3,0,8,9,0,3,1,1,0.74,0.6667,0.48,0.0896,31,465,178,1780,209,2245
5389,2011-08-17,3,0,8,10,0,3,1,1,0.76,0.6818,0.43,0.0896,27,405,91,910,118,1315
5390,2011-08-17,3,0,8,11,0,3,1,1,0.78,0.697,0.43,0.1045,20,300,108,1080,128,1380
5391,2011-08-17,3,0,8,12,0,3,1,1,0.8,0.7273,0.43,0.2836,26,390,163,1630,189,2020
5392,2011-08-17,3,0,8,13,0,3,1,1,0.8,0.7121,0.41,0.194,38,570,138,1380,176,1950
5393,2011-08-17,3,0,8,14,0,3,1,1,0.82,0.7273,0.36,0.1642,54,810,138,1380,192,2190
5394,2011-08-17,3,0,8,15,0,3,1,1,0.8,0.7273,0.43,0.1343,42,630,117,1170,159,1800
5395,2011-08-17,3,0,8,16,0,3,1,1,0.82,0.7424,0.43,0.2239,62,930,238,2380,300,3310
5396,2011-08-17,3,0,8,17,0,3,1,1,0.8,0.7424,0.49,0.2239,46,690,506,5060,552,5750
5397,2011-08-17,3,0,8,18,0,3,1,1,0.76,0.697,0.55,0.2537,86,1290,470,4700,556,5990
5398,2011-08-17,3,0,8,19,0,3,1,1,0.76,0.697,0.55,0.2239,50,750,297,2970,347,3720
5399,2011-08-17,3,0,8,20,0,3,1,1,0.74,0.6818,0.58,0.2537,37,555,243,2430,280,2985
5400,2011-08-17,3,0,8,21,0,3,1,1,0.72,0.6818,0.62,0.2239,38,570,192,1920,230,2490
5401,2011-08-17,3,0,8,22,0,3,1,1,0.7,0.6515,0.65,0.194,29,435,142,1420,171,1855
5402,2011-08-17,3,0,8,23,0,3,1,1,0.7,0.6515,0.65,0.2836,20,300,85,850,105,1150
5403,2011-08-18,3,0,8,0,0,4,1,1,0.68,0.6364,0.65,0.1343,18,270,38,380,56,650
5404,2011-08-18,3,0,8,1,0,4,1,2,0.66,0.6212,0.65,0.1642,13,195,11,110,24,305
5405,2011-08-18,3,0,8,2,0,4,1,1,0.66,0.6212,0.65,0.2239,2,30,4,40,6,70
5406,2011-08-18,3,0,8,3,0,4,1,1,0.66,0.6212,0.69,0.2836,0,0,6,60,6,60
5407,2011-08-18,3,0,8,4,0,4,1,1,0.64,0.6061,0.73,0.2239,0,0,9,90,9,90
5408,2011-08-18,3,0,8,5,0,4,1,1,0.64,0.5909,0.78,0.2836,0,0,27,270,27,270
5409,2011-08-18,3,0,8,6,0,4,1,2,0.64,0.5909,0.78,0.2537,6,90,97,970,103,1060
5410,2011-08-18,3,0,8,7,0,4,1,1,0.64,0.5909,0.78,0.2985,19,285,289,2890,308,3175
5411,2011-08-18,3,0,8,8,0,4,1,1,0.66,0.6212,0.74,0.2836,27,405,393,3930,420,4335
5412,2011-08-18,3,0,8,9,0,4,1,1,0.72,0.6818,0.66,0.2537,42,630,186,1860,228,2490
5413,2011-08-18,3,0,8,10,0,4,1,1,0.74,0.697,0.66,0.2537,37,555,92,920,129,1475
5414,2011-08-18,3,0,8,11,0,4,1,1,0.76,0.7121,0.58,0.2537,44,660,97,970,141,1630
5415,2011-08-18,3,0,8,12,0,4,1,1,0.8,0.7424,0.52,0.2836,34,510,139,1390,173,1900
5416,2011-08-18,3,0,8,13,0,4,1,1,0.8,0.7424,0.52,0.3582,33,495,154,1540,187,2035
5417,2011-08-18,3,0,8,14,0,4,1,1,0.82,0.7576,0.46,0.3284,67,1005,115,1150,182,2155
5418,2011-08-18,3,0,8,15,0,4,1,1,0.8,0.7273,0.46,0.3582,56,840,118,1180,174,2020
5419,2011-08-18,3,0,8,16,0,4,1,1,0.8,0.7273,0.46,0.3582,49,735,196,1960,245,2695
5420,2011-08-18,3,0,8,17,0,4,1,3,0.8,0.7273,0.46,0.2985,44,660,365,3650,409,4310
5421,2011-08-18,3,0,8,18,0,4,1,3,0.76,0.697,0.55,0.2537,48,720,226,2260,274,2980
5422,2011-08-18,3,0,8,19,0,4,1,1,0.66,0.6061,0.83,0.1045,26,390,115,1150,141,1540
5423,2011-08-18,3,0,8,20,0,4,1,1,0.66,0.6061,0.83,0.1045,24,360,141,1410,165,1770
5424,2011-08-18,3,0,8,21,0,4,1,2,0.68,0.6364,0.79,0.0,12,180,137,1370,149,1550
5425,2011-08-18,3,0,8,22,0,4,1,2,0.7,0.6667,0.74,0.1045,18,270,117,1170,135,1440
5426,2011-08-18,3,0,8,23,0,4,1,2,0.7,0.6667,0.74,0.1343,20,300,94,940,114,1240
5427,2011-08-19,3,0,8,0,0,5,1,3,0.68,0.6364,0.69,0.194,9,135,53,530,62,665
5428,2011-08-19,3,0,8,1,0,5,1,3,0.64,0.5758,0.89,0.0,1,15,19,190,20,205
5429,2011-08-19,3,0,8,2,0,5,1,3,0.64,0.5758,0.83,0.0,0,0,8,80,8,80
5430,2011-08-19,3,0,8,3,0,5,1,1,0.64,0.5909,0.78,0.0,2,30,1,10,3,40
5431,2011-08-19,3,0,8,4,0,5,1,1,0.64,0.5758,0.83,0.0,1,15,7,70,8,85
5432,2011-08-19,3,0,8,5,0,5,1,1,0.64,0.5758,0.83,0.0,1,15,16,160,17,175
5433,2011-08-19,3,0,8,6,0,5,1,1,0.64,0.5758,0.83,0.0,2,30,91,910,93,940
5434,2011-08-19,3,0,8,7,0,5,1,2,0.66,0.6061,0.83,0.0896,12,180,251,2510,263,2690
5435,2011-08-19,3,0,8,8,0,5,1,2,0.66,0.6061,0.83,0.0,30,450,368,3680,398,4130
5436,2011-08-19,3,0,8,9,0,5,1,1,0.7,0.6515,0.65,0.1343,31,465,187,1870,218,2335
5437,2011-08-19,3,0,8,10,0,5,1,1,0.72,0.6818,0.62,0.0896,57,855,108,1080,165,1935
5438,2011-08-19,3,0,8,11,0,5,1,2,0.72,0.6818,0.66,0.0896,45,675,120,1200,165,1875
5439,2011-08-19,3,0,8,12,0,5,1,2,0.74,0.6818,0.62,0.0896,54,810,168,1680,222,2490
5440,2011-08-19,3,0,8,13,0,5,1,2,0.76,0.7121,0.62,0.194,63,945,169,1690,232,2635
5441,2011-08-19,3,0,8,14,0,5,1,1,0.78,0.7273,0.55,0.194,78,1170,142,1420,220,2590
5442,2011-08-19,3,0,8,15,0,5,1,1,0.8,0.7424,0.49,0.1045,66,990,156,1560,222,2550
5443,2011-08-19,3,0,8,16,0,5,1,1,0.8,0.7424,0.49,0.0,66,990,261,2610,327,3600
5444,2011-08-19,3,0,8,17,0,5,1,1,0.76,0.7121,0.58,0.5224,85,1275,442,4420,527,5695
5445,2011-08-19,3,0,8,18,0,5,1,1,0.76,0.7121,0.58,0.5224,88,1320,337,3370,425,4690
5446,2011-08-19,3,0,8,19,0,5,1,3,0.62,0.5909,0.73,0.4627,33,495,132,1320,165,1815
5447,2011-08-19,3,0,8,20,0,5,1,3,0.62,0.5758,0.83,0.2985,12,180,46,460,58,640
5448,2011-08-19,3,0,8,21,0,5,1,1,0.62,0.5758,0.83,0.1343,18,270,89,890,107,1160
5449,2011-08-19,3,0,8,22,0,5,1,1,0.6,0.5455,0.88,0.1343,25,375,97,970,122,1345
5450,2011-08-19,3,0,8,23,0,5,1,2,0.6,0.5455,0.88,0.0896,18,270,88,880,106,1150
5451,2011-08-20,3,0,8,0,0,6,0,1,0.6,0.5455,0.88,0.0,21,315,107,1070,128,1385
5452,2011-08-20,3,0,8,1,0,6,0,1,0.62,0.5758,0.83,0.0,12,180,35,350,47,530
5453,2011-08-20,3,0,8,2,0,6,0,1,0.62,0.5909,0.78,0.0,10,150,59,590,69,740
5454,2011-08-20,3,0,8,3,0,6,0,1,0.62,0.5909,0.78,0.0,9,135,42,420,51,555
5455,2011-08-20,3,0,8,4,0,6,0,2,0.6,0.5455,0.88,0.0,1,15,6,60,7,75
5456,2011-08-20,3,0,8,5,0,6,0,1,0.6,0.5606,0.83,0.0,0,0,8,80,8,80
5457,2011-08-20,3,0,8,6,0,6,0,2,0.6,0.5606,0.83,0.1343,6,90,18,180,24,270
5458,2011-08-20,3,0,8,7,0,6,0,1,0.62,0.5758,0.83,0.0,8,120,36,360,44,480
5459,2011-08-20,3,0,8,8,0,6,0,1,0.66,0.6212,0.69,0.0,27,405,106,1060,133,1465
5460,2011-08-20,3,0,8,9,0,6,0,1,0.7,0.6515,0.65,0.0,51,765,139,1390,190,2155
5461,2011-08-20,3,0,8,10,0,6,0,1,0.72,0.6818,0.62,0.1045,114,1710,192,1920,306,3630
5462,2011-08-20,3,0,8,11,0,6,0,1,0.72,0.6667,0.58,0.0,115,1725,223,2230,338,3955
5463,2011-08-20,3,0,8,12,0,6,0,1,0.74,0.6818,0.58,0.1343,156,2340,253,2530,409,4870
5464,2011-08-20,3,0,8,13,0,6,0,1,0.76,0.697,0.55,0.1343,158,2370,220,2200,378,4570
5465,2011-08-20,3,0,8,14,0,6,0,1,0.8,0.7424,0.49,0.194,147,2205,228,2280,375,4485
5466,2011-08-20,3,0,8,15,0,6,0,1,0.8,0.7273,0.43,0.194,175,2625,215,2150,390,4775
5467,2011-08-20,3,0,8,16,0,6,0,1,0.8,0.7273,0.46,0.194,151,2265,222,2220,373,4485
5468,2011-08-20,3,0,8,17,0,6,0,1,0.8,0.7424,0.49,0.194,180,2700,203,2030,383,4730
5469,2011-08-20,3,0,8,18,0,6,0,1,0.76,0.7121,0.58,0.2537,169,2535,225,2250,394,4785
5470,2011-08-20,3,0,8,19,0,6,0,1,0.74,0.6818,0.62,0.194,109,1635,182,1820,291,3455
5471,2011-08-20,3,0,8,20,0,6,0,1,0.74,0.6818,0.62,0.2239,78,1170,170,1700,248,2870
5472,2011-08-20,3,0,8,21,0,6,0,1,0.72,0.6818,0.7,0.2239,81,1215,144,1440,225,2655
5473,2011-08-20,3,0,8,22,0,6,0,2,0.7,0.6667,0.74,0.194,77,1155,146,1460,223,2615
5474,2011-08-20,3,0,8,23,0,6,0,1,0.7,0.6667,0.74,0.1343,59,885,98,980,157,1865
5475,2011-08-21,3,0,8,0,0,0,0,1,0.7,0.6667,0.74,0.194,6,90,68,680,74,770
5476,2011-08-21,3,0,8,1,0,0,0,1,0.68,0.6364,0.79,0.2239,17,255,69,690,86,945
5477,2011-08-21,3,0,8,2,0,0,0,1,0.68,0.6364,0.79,0.194,13,195,51,510,64,705
5478,2011-08-21,3,0,8,3,0,0,0,1,0.66,0.6061,0.83,0.2239,25,375,26,260,51,635
5479,2011-08-21,3,0,8,4,0,0,0,1,0.68,0.6364,0.83,0.2239,1,15,5,50,6,65
5480,2011-08-21,3,0,8,5,0,0,0,1,0.66,0.5909,0.89,0.2985,0,0,8,80,8,80
5481,2011-08-21,3,0,8,6,0,0,0,1,0.66,0.5909,0.89,0.2836,4,60,10,100,14,160
5482,2011-08-21,3,0,8,7,0,0,0,1,0.68,0.6364,0.83,0.2985,12,180,19,190,31,370
5483,2011-08-21,3,0,8,8,0,0,0,1,0.7,0.6667,0.79,0.2239,30,450,62,620,92,1070
5484,2011-08-21,3,0,8,9,0,0,0,1,0.72,0.697,0.74,0.2239,80,1200,151,1510,231,2710
5485,2011-08-21,3,0,8,10,0,0,0,1,0.74,0.7121,0.74,0.2537,97,1455,177,1770,274,3225
5486,2011-08-21,3,0,8,11,0,0,0,1,0.8,0.7879,0.63,0.2836,132,1980,181,1810,313,3790
5487,2011-08-21,3,0,8,12,0,0,0,1,0.82,0.803,0.59,0.2836,135,2025,239,2390,374,4415
5488,2011-08-21,3,0,8,13,0,0,0,1,0.8,0.7727,0.59,0.4179,94,1410,216,2160,310,3570
5489,2011-08-21,3,0,8,14,0,0,0,3,0.7,0.6667,0.79,0.3881,78,1170,157,1570,235,2740
5490,2011-08-21,3,0,8,15,0,0,0,1,0.7,0.6667,0.84,0.2836,17,255,51,510,68,765
5491,2011-08-21,3,0,8,16,0,0,0,1,0.72,0.697,0.79,0.1642,97,1455,161,1610,258,3065
5492,2011-08-21,3,0,8,17,0,0,0,1,0.72,0.697,0.79,0.1343,91,1365,179,1790,270,3155
5493,2011-08-21,3,0,8,18,0,0,0,1,0.72,0.697,0.79,0.2537,96,1440,215,2150,311,3590
5494,2011-08-21,3,0,8,19,0,0,0,1,0.72,0.6818,0.7,0.2537,81,1215,201,2010,282,3225
5495,2011-08-21,3,0,8,20,0,0,0,1,0.7,0.6667,0.79,0.2537,41,615,140,1400,181,2015
5496,2011-08-21,3,0,8,21,0,0,0,1,0.7,0.6667,0.79,0.2537,45,675,93,930,138,1605
5497,2011-08-21,3,0,8,22,0,0,0,2,0.7,0.6667,0.79,0.194,37,555,97,970,134,1525
5498,2011-08-21,3,0,8,23,0,0,0,1,0.7,0.6667,0.74,0.1642,20,300,48,480,68,780
5499,2011-08-22,3,0,8,0,0,1,1,1,0.68,0.6364,0.79,0.1642,18,270,22,220,40,490
5500,2011-08-22,3,0,8,1,0,1,1,1,0.68,0.6364,0.79,0.0896,8,120,13,130,21,250
5501,2011-08-22,3,0,8,2,0,1,1,2,0.7,0.6515,0.65,0.1045,2,30,6,60,8,90
5502,2011-08-22,3,0,8,3,0,1,1,3,0.7,0.6515,0.65,0.1343,0,0,5,50,5,50
5503,2011-08-22,3,0,8,4,0,1,1,1,0.68,0.6364,0.65,0.194,2,30,10,100,12,130
5504,2011-08-22,3,0,8,5,0,1,1,1,0.66,0.6212,0.65,0.3582,1,15,23,230,24,245
5505,2011-08-22,3,0,8,6,0,1,1,1,0.66,0.6212,0.61,0.2985,6,90,106,1060,112,1150
5506,2011-08-22,3,0,8,7,0,1,1,1,0.66,0.6212,0.61,0.3284,11,165,270,2700,281,2865
5507,2011-08-22,3,0,8,8,0,1,1,1,0.66,0.6212,0.61,0.3284,20,300,331,3310,351,3610
5508,2011-08-22,3,0,8,9,0,1,1,1,0.68,0.6364,0.54,0.2537,36,540,151,1510,187,2050
5509,2011-08-22,3,0,8,10,0,1,1,1,0.7,0.6515,0.48,0.2836,36,540,85,850,121,1390
5510,2011-08-22,3,0,8,11,0,1,1,1,0.72,0.6515,0.34,0.3284,46,690,85,850,131,1540
5511,2011-08-22,3,0,8,12,0,1,1,1,0.74,0.6515,0.35,0.3881,54,810,153,1530,207,2340
5512,2011-08-22,3,0,8,13,0,1,1,1,0.74,0.6515,0.3,0.4627,47,705,158,1580,205,2285
5513,2011-08-22,3,0,8,14,0,1,1,1,0.74,0.6515,0.3,0.3881,88,1320,137,1370,225,2690
5514,2011-08-22,3,0,8,15,0,1,1,1,0.74,0.6515,0.3,0.2985,72,1080,127,1270,199,2350
5515,2011-08-22,3,0,8,16,0,1,1,1,0.74,0.6515,0.3,0.3881,66,990,254,2540,320,3530
5516,2011-08-22,3,0,8,17,0,1,1,1,0.74,0.6515,0.27,0.3284,82,1230,509,5090,591,6320
5517,2011-08-22,3,0,8,18,0,1,1,1,0.72,0.6515,0.28,0.2985,72,1080,537,5370,609,6450
5518,2011-08-22,3,0,8,19,0,1,1,1,0.7,0.6364,0.3,0.2836,66,990,350,3500,416,4490
5519,2011-08-22,3,0,8,20,0,1,1,1,0.66,0.6212,0.34,0.194,21,315,247,2470,268,2785
5520,2011-08-22,3,0,8,21,0,1,1,1,0.64,0.6212,0.38,0.194,28,420,180,1800,208,2220
5521,2011-08-22,3,0,8,22,0,1,1,1,0.64,0.6212,0.38,0.2985,32,480,121,1210,153,1690
5522,2011-08-22,3,0,8,23,0,1,1,1,0.62,0.6212,0.41,0.2537,19,285,45,450,64,735
5523,2011-08-23,3,0,8,0,0,2,1,1,0.6,0.6212,0.43,0.194,13,195,22,220,35,415
5524,2011-08-23,3,0,8,1,0,2,1,1,0.58,0.5455,0.49,0.194,6,90,13,130,19,220
5525,2011-08-23,3,0,8,2,0,2,1,1,0.56,0.5303,0.52,0.194,2,30,4,40,6,70
5526,2011-08-23,3,0,8,3,0,2,1,1,0.56,0.5303,0.52,0.2836,2,30,4,40,6,70
5527,2011-08-23,3,0,8,4,0,2,1,1,0.54,0.5152,0.56,0.1642,0,0,5,50,5,50
5528,2011-08-23,3,0,8,5,0,2,1,1,0.54,0.5152,0.56,0.194,1,15,35,350,36,365
5529,2011-08-23,3,0,8,6,0,2,1,1,0.54,0.5152,0.6,0.194,3,45,111,1110,114,1155
5530,2011-08-23,3,0,8,7,0,2,1,1,0.6,0.6212,0.49,0.194,11,165,333,3330,344,3495
5531,2011-08-23,3,0,8,8,0,2,1,2,0.62,0.6212,0.5,0.0,43,645,461,4610,504,5255
5532,2011-08-23,3,0,8,9,0,2,1,2,0.66,0.6212,0.44,0.0,34,510,191,1910,225,2420
5533,2011-08-23,3,0,8,10,0,2,1,1,0.7,0.6364,0.37,0.0,56,840,92,920,148,1760
5534,2011-08-23,3,0,8,11,0,2,1,1,0.7,0.6364,0.34,0.1045,62,930,124,1240,186,2170
5535,2011-08-23,3,0,8,12,0,2,1,1,0.7,0.6364,0.39,0.0896,60,900,177,1770,237,2670
5536,2011-08-23,3,0,8,13,0,2,1,1,0.72,0.6515,0.3,0.1045,70,1050,164,1640,234,2690
5537,2011-08-23,3,0,8,14,0,2,1,1,0.72,0.6515,0.3,0.0896,149,2235,502,5020,651,7255
5538,2011-08-23,3,0,8,15,0,2,1,1,0.72,0.6515,0.34,0.2239,178,2670,423,4230,601,6900
5539,2011-08-23,3,0,8,16,0,2,1,1,0.72,0.6515,0.32,0.1343,133,1995,311,3110,444,5105
5540,2011-08-23,3,0,8,17,0,2,1,1,0.72,0.6515,0.34,0.2239,133,1995,339,3390,472,5385
5541,2011-08-23,3,0,8,18,0,2,1,1,0.72,0.6515,0.34,0.194,98,1470,421,4210,519,5680
5542,2011-08-23,3,0,8,19,0,2,1,1,0.66,0.6212,0.5,0.2239,70,1050,297,2970,367,4020
5543,2011-08-23,3,0,8,20,0,2,1,1,0.64,0.6212,0.53,0.2537,54,810,206,2060,260,2870
5544,2011-08-23,3,0,8,21,0,2,1,1,0.62,0.6212,0.57,0.0,38,570,173,1730,211,2300
5545,2011-08-23,3,0,8,22,0,2,1,1,0.62,0.6212,0.57,0.1343,46,690,145,1450,191,2140
5546,2011-08-23,3,0,8,23,0,2,1,1,0.62,0.6061,0.61,0.1343,19,285,61,610,80,895
5547,2011-08-24,3,0,8,0,0,3,1,1,0.62,0.6212,0.57,0.1343,9,135,29,290,38,425
5548,2011-08-24,3,0,8,1,0,3,1,1,0.6,0.6061,0.6,0.1045,7,105,17,170,24,275
5549,2011-08-24,3,0,8,2,0,3,1,1,0.58,0.5455,0.68,0.1343,2,30,4,40,6,70
5550,2011-08-24,3,0,8,3,0,3,1,1,0.58,0.5455,0.68,0.1343,0,0,1,10,1,10
5551,2011-08-24,3,0,8,4,0,3,1,1,0.56,0.5303,0.73,0.1045,0,0,7,70,7,70
5552,2011-08-24,3,0,8,5,0,3,1,1,0.56,0.5303,0.73,0.1045,1,15,26,260,27,275
5553,2011-08-24,3,0,8,6,0,3,1,1,0.56,0.5303,0.73,0.0,3,45,105,1050,108,1095
5554,2011-08-24,3,0,8,7,0,3,1,1,0.6,0.6061,0.64,0.0896,11,165,297,2970,308,3135
5555,2011-08-24,3,0,8,8,0,3,1,1,0.62,0.6061,0.69,0.1343,32,480,436,4360,468,4840
5556,2011-08-24,3,0,8,9,0,3,1,1,0.64,0.6061,0.69,0.2537,44,660,169,1690,213,2350
5557,2011-08-24,3,0,8,10,0,3,1,1,0.7,0.6515,0.58,0.2836,51,765,95,950,146,1715
5558,2011-08-24,3,0,8,11,0,3,1,1,0.72,0.6667,0.54,0.2985,57,855,128,1280,185,2135
5559,2011-08-24,3,0,8,12,0,3,1,1,0.74,0.6818,0.55,0.3284,60,900,175,1750,235,2650
5560,2011-08-24,3,0,8,13,0,3,1,1,0.76,0.6818,0.48,0.4179,56,840,180,1800,236,2640
5561,2011-08-24,3,0,8,14,0,3,1,1,0.76,0.6818,0.48,0.4179,77,1155,127,1270,204,2425
5562,2011-08-24,3,0,8,15,0,3,1,1,0.76,0.6818,0.48,0.4478,63,945,141,1410,204,2355
5563,2011-08-24,3,0,8,16,0,3,1,1,0.76,0.697,0.52,0.4179,49,735,222,2220,271,2955
5564,2011-08-24,3,0,8,17,0,3,1,1,0.76,0.697,0.52,0.3582,83,1245,484,4840,567,6085
5565,2011-08-24,3,0,8,18,0,3,1,1,0.74,0.6818,0.55,0.2985,102,1530,519,5190,621,6720
5566,2011-08-24,3,0,8,19,0,3,1,1,0.74,0.6818,0.55,0.2985,93,1395,347,3470,440,4865
5567,2011-08-24,3,0,8,20,0,3,1,1,0.72,0.6667,0.58,0.2985,45,675,289,2890,334,3565
5568,2011-08-24,3,0,8,21,0,3,1,1,0.7,0.6515,0.61,0.3582,47,705,189,1890,236,2595
5569,2011-08-24,3,0,8,22,0,3,1,1,0.7,0.6515,0.65,0.3582,41,615,140,1400,181,2015
5570,2011-08-24,3,0,8,23,0,3,1,1,0.68,0.6364,0.69,0.2985,16,240,54,540,70,780
5571,2011-08-25,3,0,8,0,0,4,1,1,0.68,0.6364,0.74,0.2985,11,165,41,410,52,575
5572,2011-08-25,3,0,8,1,0,4,1,1,0.68,0.6364,0.69,0.3881,4,60,11,110,15,170
5573,2011-08-25,3,0,8,2,0,4,1,1,0.68,0.6364,0.69,0.3881,3,45,2,20,5,65
5574,2011-08-25,3,0,8,3,0,4,1,1,0.66,0.6212,0.74,0.3284,2,30,2,20,4,50
5575,2011-08-25,3,0,8,4,0,4,1,1,0.66,0.6061,0.78,0.3881,1,15,6,60,7,75
5576,2011-08-25,3,0,8,5,0,4,1,1,0.66,0.6061,0.83,0.4179,1,15,25,250,26,265
5577,2011-08-25,3,0,8,6,0,4,1,1,0.66,0.6061,0.83,0.3284,1,15,101,1010,102,1025
5578,2011-08-25,3,0,8,7,0,4,1,2,0.68,0.6364,0.79,0.3284,17,255,296,2960,313,3215
5579,2011-08-25,3,0,8,8,0,4,1,2,0.7,0.6667,0.74,0.2985,23,345,461,4610,484,4955
5580,2011-08-25,3,0,8,9,0,4,1,2,0.72,0.6818,0.7,0.2985,21,315,141,1410,162,1725
5581,2011-08-25,3,0,8,10,0,4,1,2,0.74,0.697,0.66,0.2985,37,555,105,1050,142,1605
5582,2011-08-25,3,0,8,11,0,4,1,3,0.7,0.6667,0.79,0.0,39,585,112,1120,151,1705
5583,2011-08-25,3,0,8,12,0,4,1,3,0.7,0.6667,0.79,0.0,9,135,32,320,41,455
5584,2011-08-25,3,0,8,13,0,4,1,1,0.7,0.6667,0.79,0.1045,7,105,30,300,37,405
5585,2011-08-25,3,0,8,14,0,4,1,2,0.72,0.697,0.74,0.0,27,405,86,860,113,1265
5586,2011-08-25,3,0,8,15,0,4,1,2,0.74,0.697,0.7,0.0,28,420,104,1040,132,1460
5587,2011-08-25,3,0,8,16,0,4,1,1,0.72,0.7121,0.84,0.0,16,240,105,1050,121,1290
5588,2011-08-25,3,0,8,17,0,4,1,1,0.72,0.7121,0.84,0.0,28,420,284,2840,312,3260
5589,2011-08-25,3,0,8,18,0,4,1,2,0.72,0.7121,0.84,0.1343,31,465,377,3770,408,4235
5590,2011-08-25,3,0,8,19,0,4,1,2,0.66,0.6061,0.78,0.3284,31,465,241,2410,272,2875
5591,2011-08-25,3,0,8,20,0,4,1,1,0.64,0.5909,0.78,0.3582,33,495,192,1920,225,2415
5592,2011-08-25,3,0,8,21,0,4,1,1,0.64,0.5909,0.78,0.2836,29,435,158,1580,187,2015
5593,2011-08-25,3,0,8,22,0,4,1,1,0.62,0.5758,0.83,0.0,21,315,126,1260,147,1575
5594,2011-08-25,3,0,8,23,0,4,1,1,0.62,0.5758,0.83,0.0896,15,225,69,690,84,915
5595,2011-08-26,3,0,8,0,0,5,1,1,0.62,0.5758,0.83,0.1343,9,135,42,420,51,555
5596,2011-08-26,3,0,8,1,0,5,1,1,0.62,0.5758,0.83,0.0,10,150,13,130,23,280
5597,2011-08-26,3,0,8,2,0,5,1,1,0.62,0.5606,0.88,0.1343,4,60,16,160,20,220
5598,2011-08-26,3,0,8,3,0,5,1,1,0.6,0.5455,0.88,0.1045,3,45,8,80,11,125
5599,2011-08-26,3,0,8,4,0,5,1,1,0.62,0.5606,0.88,0.0,2,30,6,60,8,90
5600,2011-08-26,3,0,8,5,0,5,1,2,0.62,0.5606,0.88,0.0,3,45,23,230,26,275
5601,2011-08-26,3,0,8,6,0,5,1,1,0.62,0.5606,0.88,0.0,5,75,100,1000,105,1075
5602,2011-08-26,3,0,8,7,0,5,1,1,0.64,0.5758,0.83,0.0,3,45,263,2630,266,2675
5603,2011-08-26,3,0,8,8,0,5,1,1,0.66,0.6061,0.83,0.1045,17,255,387,3870,404,4125
5604,2011-08-26,3,0,8,9,0,5,1,1,0.7,0.6667,0.74,0.0,39,585,191,1910,230,2495
5605,2011-08-26,3,0,8,10,0,5,1,1,0.74,0.697,0.66,0.0896,34,510,89,890,123,1400
5606,2011-08-26,3,0,8,11,0,5,1,2,0.76,0.7121,0.62,0.0,63,945,151,1510,214,2455
5607,2011-08-26,3,0,8,12,0,5,1,2,0.76,0.7273,0.66,0.1045,70,1050,173,1730,243,2780
5608,2011-08-26,3,0,8,13,0,5,1,2,0.78,0.7424,0.59,0.1045,72,1080,165,1650,237,2730
5609,2011-08-26,3,0,8,14,0,5,1,1,0.8,0.7727,0.59,0.0,55,825,164,1640,219,2465
5610,2011-08-26,3,0,8,15,0,5,1,2,0.8,0.7727,0.59,0.194,53,795,196,1960,249,2755
5611,2011-08-26,3,0,8,16,0,5,1,1,0.78,0.7424,0.62,0.1045,50,750,293,2930,343,3680
5612,2011-08-26,3,0,8,17,0,5,1,1,0.74,0.7121,0.74,0.2537,56,840,433,4330,489,5170
5613,2011-08-26,3,0,8,18,0,5,1,2,0.74,0.7121,0.74,0.1343,40,600,370,3700,410,4300
5614,2011-08-26,3,0,8,19,0,5,1,1,0.72,0.697,0.79,0.1045,55,825,235,2350,290,3175
5615,2011-08-26,3,0,8,20,0,5,1,1,0.72,0.697,0.79,0.0896,39,585,183,1830,222,2415
5616,2011-08-26,3,0,8,21,0,5,1,1,0.72,0.697,0.79,0.1642,38,570,152,1520,190,2090
5617,2011-08-26,3,0,8,22,0,5,1,1,0.72,0.697,0.79,0.1045,26,390,126,1260,152,1650
5618,2011-08-26,3,0,8,23,0,5,1,1,0.7,0.6667,0.84,0.0896,22,330,114,1140,136,1470
5619,2011-08-27,3,0,8,0,0,6,0,1,0.7,0.6667,0.84,0.1045,33,495,112,1120,145,1615
5620,2011-08-27,3,0,8,1,0,6,0,1,0.7,0.6667,0.84,0.1642,13,195,51,510,64,705
5621,2011-08-27,3,0,8,2,0,6,0,1,0.7,0.6667,0.84,0.194,18,270,59,590,77,860
5622,2011-08-27,3,0,8,3,0,6,0,2,0.7,0.6667,0.84,0.2239,8,120,22,220,30,340
5623,2011-08-27,3,0,8,4,0,6,0,2,0.7,0.6667,0.84,0.2239,1,15,3,30,4,45
5624,2011-08-27,3,0,8,5,0,6,0,2,0.7,0.6667,0.84,0.2985,1,15,11,110,12,125
5625,2011-08-27,3,0,8,6,0,6,0,2,0.7,0.6667,0.84,0.2985,3,45,15,150,18,195
5626,2011-08-27,3,0,8,7,0,6,0,2,0.7,0.6667,0.84,0.3582,2,30,26,260,28,290
5627,2011-08-27,3,0,8,8,0,6,0,2,0.7,0.6667,0.84,0.2537,14,210,62,620,76,830
5628,2011-08-27,3,0,8,9,0,6,0,2,0.7,0.6667,0.84,0.4179,28,420,128,1280,156,1700
5629,2011-08-27,3,0,8,10,0,6,0,2,0.7,0.6667,0.79,0.4627,51,765,154,1540,205,2305
5630,2011-08-27,3,0,8,11,0,6,0,3,0.66,0.5909,0.89,0.4179,15,225,73,730,88,955
5631,2011-08-27,3,0,8,12,0,6,0,3,0.66,0.6061,0.83,0.4925,11,165,65,650,76,815
5632,2011-08-27,3,0,8,13,0,6,0,3,0.66,0.6061,0.83,0.3881,10,150,33,330,43,480
5633,2011-08-27,3,0,8,14,0,6,0,3,0.64,0.5758,0.89,0.5522,4,60,19,190,23,250
5634,2011-08-27,3,0,8,15,0,6,0,3,0.64,0.5758,0.89,0.5522,2,30,28,280,30,310
5635,2011-08-27,3,0,8,16,0,6,0,3,0.64,0.5758,0.89,0.5224,10,150,14,140,24,290
5636,2011-08-27,3,0,8,17,0,6,0,3,0.64,0.5758,0.89,0.8358,2,30,14,140,16,170
5637,2011-08-28,3,0,8,7,0,0,0,3,0.62,0.5758,0.83,0.3582,0,0,1,10,1,10
5638,2011-08-28,3,0,8,8,0,0,0,3,0.62,0.5758,0.83,0.4179,2,30,6,60,8,90
5639,2011-08-28,3,0,8,9,0,0,0,1,0.66,0.6212,0.74,0.4179,7,105,46,460,53,565
5640,2011-08-28,3,0,8,10,0,0,0,1,0.7,0.6515,0.61,0.6119,27,405,115,1150,142,1555
5641,2011-08-28,3,0,8,11,0,0,0,1,0.7,0.6515,0.58,0.3881,59,885,178,1780,237,2665
5642,2011-08-28,3,0,8,12,0,0,0,1,0.74,0.6667,0.51,0.3881,88,1320,218,2180,306,3500
5643,2011-08-28,3,0,8,13,0,0,0,1,0.76,0.6818,0.45,0.3582,129,1935,302,3020,431,4955
5644,2011-08-28,3,0,8,14,0,0,0,1,0.78,0.697,0.43,0.4179,157,2355,290,2900,447,5255
5645,2011-08-28,3,0,8,15,0,0,0,1,0.78,0.697,0.43,0.3582,155,2325,314,3140,469,5465
5646,2011-08-28,3,0,8,16,0,0,0,1,0.8,0.7121,0.36,0.3881,196,2940,295,2950,491,5890
5647,2011-08-28,3,0,8,17,0,0,0,1,0.76,0.6818,0.4,0.2985,145,2175,253,2530,398,4705
5648,2011-08-28,3,0,8,18,0,0,0,1,0.74,0.6667,0.42,0.2239,145,2175,257,2570,402,4745
5649,2011-08-28,3,0,8,19,0,0,0,1,0.72,0.6667,0.48,0.1045,140,2100,247,2470,387,4570
5650,2011-08-28,3,0,8,20,0,0,0,1,0.72,0.6515,0.45,0.1045,64,960,150,1500,214,2460
5651,2011-08-28,3,0,8,21,0,0,0,1,0.66,0.6212,0.61,0.1343,60,900,126,1260,186,2160
5652,2011-08-28,3,0,8,22,0,0,0,1,0.64,0.6061,0.69,0.1045,25,375,73,730,98,1105
5653,2011-08-28,3,0,8,23,0,0,0,1,0.62,0.5909,0.73,0.1045,16,240,48,480,64,720
5654,2011-08-29,3,0,8,0,0,1,1,1,0.62,0.5909,0.73,0.1045,13,195,21,210,34,405
5655,2011-08-29,3,0,8,1,0,1,1,1,0.6,0.5909,0.69,0.1045,5,75,15,150,20,225
5656,2011-08-29,3,0,8,2,0,1,1,1,0.6,0.5909,0.69,0.194,8,120,5,50,13,170
5657,2011-08-29,3,0,8,3,0,1,1,1,0.6,0.5909,0.69,0.1045,1,15,5,50,6,65
5658,2011-08-29,3,0,8,4,0,1,1,1,0.56,0.5303,0.68,0.1343,0,0,3,30,3,30
5659,2011-08-29,3,0,8,5,0,1,1,1,0.56,0.5303,0.73,0.1343,0,0,17,170,17,170
5660,2011-08-29,3,0,8,6,0,1,1,1,0.56,0.5303,0.73,0.1343,3,45,99,990,102,1035
5661,2011-08-29,3,0,8,7,0,1,1,1,0.6,0.6061,0.6,0.2239,11,165,273,2730,284,2895
5662,2011-08-29,3,0,8,8,0,1,1,1,0.62,0.6212,0.57,0.2537,20,300,384,3840,404,4140
5663,2011-08-29,3,0,8,9,0,1,1,1,0.62,0.6212,0.53,0.2537,22,330,166,1660,188,1990
5664,2011-08-29,3,0,8,10,0,1,1,1,0.66,0.6212,0.47,0.2239,42,630,73,730,115,1360
5665,2011-08-29,3,0,8,11,0,1,1,1,0.66,0.6212,0.47,0.1642,38,570,100,1000,138,1570
5666,2011-08-29,3,0,8,12,0,1,1,2,0.68,0.6364,0.44,0.1642,48,720,159,1590,207,2310
5667,2011-08-29,3,0,8,13,0,1,1,2,0.7,0.6364,0.39,0.0,48,720,170,1700,218,2420
5668,2011-08-29,3,0,8,14,0,1,1,1,0.7,0.6364,0.42,0.0,55,825,127,1270,182,2095
5669,2011-08-29,3,0,8,15,0,1,1,1,0.7,0.6364,0.42,0.1642,56,840,164,1640,220,2480
5670,2011-08-29,3,0,8,16,0,1,1,1,0.72,0.6515,0.42,0.1642,56,840,226,2260,282,3100
5671,2011-08-29,3,0,8,17,0,1,1,2,0.7,0.6364,0.47,0.2239,67,1005,524,5240,591,6245
5672,2011-08-29,3,0,8,18,0,1,1,1,0.66,0.6212,0.47,0.2537,60,900,487,4870,547,5770
5673,2011-08-29,3,0,8,19,0,1,1,1,0.66,0.6212,0.47,0.2537,50,750,317,3170,367,3920
5674,2011-08-29,3,0,8,20,0,1,1,1,0.64,0.6212,0.53,0.1642,50,750,227,2270,277,3020
5675,2011-08-29,3,0,8,21,0,1,1,1,0.64,0.6212,0.53,0.194,34,510,168,1680,202,2190
5676,2011-08-29,3,0,8,22,0,1,1,1,0.62,0.6212,0.57,0.1343,23,345,119,1190,142,1535
5677,2011-08-29,3,0,8,23,0,1,1,1,0.6,0.6061,0.6,0.0896,19,285,56,560,75,845
5678,2011-08-30,3,0,8,0,0,2,1,1,0.56,0.5303,0.73,0.1343,10,150,17,170,27,320
5679,2011-08-30,3,0,8,1,0,2,1,1,0.56,0.5303,0.68,0.1045,6,90,7,70,13,160
5680,2011-08-30,3,0,8,2,0,2,1,1,0.54,0.5152,0.73,0.1045,2,30,8,80,10,110
5681,2011-08-30,3,0,8,3,0,2,1,1,0.54,0.5152,0.73,0.194,2,30,2,20,4,50
5682,2011-08-30,3,0,8,4,0,2,1,1,0.52,0.5,0.77,0.1642,0,0,6,60,6,60
5683,2011-08-30,3,0,8,5,0,2,1,1,0.52,0.5,0.77,0.0896,1,15,27,270,28,285
5684,2011-08-30,3,0,8,6,0,2,1,1,0.54,0.5152,0.73,0.1045,4,60,115,1150,119,1210
5685,2011-08-30,3,0,8,7,0,2,1,1,0.56,0.5303,0.68,0.1343,19,285,338,3380,357,3665
5686,2011-08-30,3,0,8,8,0,2,1,1,0.62,0.6212,0.57,0.1343,34,510,459,4590,493,5100
5687,2011-08-30,3,0,8,9,0,2,1,1,0.66,0.6212,0.5,0.2239,38,570,180,1800,218,2370
5688,2011-08-30,3,0,8,10,0,2,1,1,0.7,0.6364,0.39,0.2239,28,420,109,1090,137,1510
5689,2011-08-30,3,0,8,11,0,2,1,1,0.72,0.6515,0.37,0.194,60,900,115,1150,175,2050
5690,2011-08-30,3,0,8,12,0,2,1,1,0.72,0.6515,0.37,0.0,65,975,172,1720,237,2695
5691,2011-08-30,3,0,8,13,0,2,1,1,0.74,0.6515,0.35,0.1045,59,885,170,1700,229,2585
5692,2011-08-30,3,0,8,14,0,2,1,1,0.74,0.6515,0.33,0.1642,58,870,151,1510,209,2380
5693,2011-08-30,3,0,8,15,0,2,1,1,0.74,0.6515,0.35,0.2239,34,510,162,1620,196,2130
5694,2011-08-30,3,0,8,16,0,2,1,1,0.74,0.6515,0.37,0.1642,42,630,295,2950,337,3580
5695,2011-08-30,3,0,8,17,0,2,1,1,0.72,0.6515,0.42,0.194,62,930,549,5490,611,6420
5696,2011-08-30,3,0,8,18,0,2,1,1,0.7,0.6364,0.45,0.1642,60,900,516,5160,576,6060
5697,2011-08-30,3,0,8,19,0,2,1,1,0.66,0.6212,0.5,0.0896,68,1020,397,3970,465,4990
5698,2011-08-30,3,0,8,20,0,2,1,1,0.66,0.6212,0.5,0.0,39,585,259,2590,298,3175
5699,2011-08-30,3,0,8,21,0,2,1,1,0.64,0.6061,0.65,0.0896,43,645,180,1800,223,2445
5700,2011-08-30,3,0,8,22,0,2,1,1,0.62,0.6061,0.61,0.0,22,330,121,1210,143,1540
5701,2011-08-30,3,0,8,23,0,2,1,1,0.62,0.6061,0.61,0.0,19,285,74,740,93,1025
5702,2011-08-31,3,0,8,0,0,3,1,1,0.6,0.5909,0.69,0.0,8,120,24,240,32,360
5703,2011-08-31,3,0,8,1,0,3,1,1,0.6,0.5909,0.69,0.0,2,30,13,130,15,160
5704,2011-08-31,3,0,8,2,0,3,1,1,0.56,0.5303,0.73,0.0,1,15,5,50,6,65
5705,2011-08-31,3,0,8,3,0,3,1,1,0.56,0.5303,0.78,0.0,2,30,4,40,6,70
5706,2011-08-31,3,0,8,4,0,3,1,1,0.56,0.5303,0.73,0.0,0,0,5,50,5,50
5707,2011-08-31,3,0,8,5,0,3,1,1,0.54,0.5152,0.83,0.0896,2,30,25,250,27,280
5708,2011-08-31,3,0,8,6,0,3,1,1,0.54,0.5152,0.77,0.0,4,60,107,1070,111,1130
5709,2011-08-31,3,0,8,7,0,3,1,1,0.6,0.5758,0.78,0.0,12,180,316,3160,328,3340
5710,2011-08-31,3,0,8,8,0,3,1,1,0.62,0.6061,0.69,0.0,27,405,440,4400,467,4805
5711,2011-08-31,3,0,8,9,0,3,1,1,0.64,0.6061,0.69,0.0896,27,405,217,2170,244,2575
5712,2011-08-31,3,0,8,10,0,3,1,1,0.7,0.6364,0.45,0.1045,33,495,105,1050,138,1545
5713,2011-08-31,3,0,8,11,0,3,1,1,0.72,0.6515,0.42,0.1343,28,420,143,1430,171,1850
5714,2011-08-31,3,0,8,12,0,3,1,1,0.74,0.6667,0.43,0.1343,68,1020,192,1920,260,2940
5715,2011-08-31,3,0,8,13,0,3,1,1,0.74,0.6515,0.37,0.1045,39,585,182,1820,221,2405
5716,2011-08-31,3,0,8,14,0,3,1,1,0.74,0.6515,0.4,0.1343,48,720,148,1480,196,2200
5717,2011-08-31,3,0,8,15,0,3,1,1,0.74,0.6515,0.4,0.1343,34,510,138,1380,172,1890
5718,2011-08-31,3,0,8,16,0,3,1,1,0.74,0.6667,0.42,0.1343,46,690,263,2630,309,3320
5719,2011-08-31,3,0,8,17,0,3,1,1,0.72,0.6515,0.45,0.1343,83,1245,525,5250,608,6495
5720,2011-08-31,3,0,8,18,0,3,1,1,0.7,0.6515,0.51,0.2239,70,1050,495,4950,565,6000
5721,2011-08-31,3,0,8,19,0,3,1,1,0.84,0.7727,0.47,0.2537,53,795,393,3930,446,4725
5722,2011-08-31,3,0,8,20,0,3,1,1,0.66,0.6212,0.57,0.1343,30,450,259,2590,289,3040
5723,2011-08-31,3,0,8,21,0,3,1,1,0.66,0.6212,0.61,0.0896,27,405,174,1740,201,2145
5724,2011-08-31,3,0,8,22,0,3,1,1,0.64,0.6061,0.69,0.0,20,300,137,1370,157,1670
5725,2011-08-31,3,0,8,23,0,3,1,1,0.6,0.5758,0.78,0.1045,24,360,60,600,84,960
5726,2011-09-01,3,0,9,0,0,4,1,1,0.6,0.5758,0.78,0.1045,18,270,33,330,51,600
5727,2011-09-01,3,0,9,1,0,4,1,1,0.6,0.5909,0.73,0.0896,7,105,14,140,21,245
5728,2011-09-01,3,0,9,2,0,4,1,1,0.58,0.5455,0.78,0.0896,14,210,11,110,25,320
5729,2011-09-01,3,0,9,3,0,4,1,1,0.58,0.5455,0.78,0.0896,7,105,7,70,14,175
5730,2011-09-01,3,0,9,4,0,4,1,1,0.56,0.5303,0.83,0.0896,0,0,7,70,7,70
5731,2011-09-01,3,0,9,5,0,4,1,1,0.56,0.5303,0.73,0.0896,1,15,22,220,23,235
5732,2011-09-01,3,0,9,6,0,4,1,1,0.6,0.5758,0.78,0.0,2,30,103,1030,105,1060
5733,2011-09-01,3,0,9,7,0,4,1,1,0.6,0.5758,0.78,0.0,7,105,335,3350,342,3455
5734,2011-09-01,3,0,9,8,0,4,1,1,0.62,0.5909,0.73,0.1343,31,465,467,4670,498,5135
5735,2011-09-01,3,0,9,9,0,4,1,1,0.64,0.6061,0.69,0.1045,29,435,178,1780,207,2215
5736,2011-09-01,3,0,9,10,0,4,1,1,0.68,0.6364,0.61,0.1343,46,690,92,920,138,1610
5737,2011-09-01,3,0,9,11,0,4,1,1,0.72,0.6667,0.51,0.1343,51,765,141,1410,192,2175
5738,2011-09-01,3,0,9,12,0,4,1,2,0.72,0.6667,0.51,0.1343,64,960,165,1650,229,2610
5739,2011-09-01,3,0,9,13,0,4,1,2,0.72,0.6667,0.48,0.0896,50,750,169,1690,219,2440
5740,2011-09-01,3,0,9,14,0,4,1,3,0.72,0.6667,0.54,0.2537,54,810,144,1440,198,2250
5741,2011-09-01,3,0,9,15,0,4,1,1,0.72,0.6667,0.51,0.1343,39,585,135,1350,174,1935
5742,2011-09-01,3,0,9,16,0,4,1,1,0.74,0.6667,0.51,0.194,55,825,253,2530,308,3355
5743,2011-09-01,3,0,9,17,0,4,1,1,0.72,0.6667,0.54,0.2537,61,915,567,5670,628,6585
5744,2011-09-01,3,0,9,18,0,4,1,1,0.72,0.6667,0.54,0.2239,69,1035,462,4620,531,5655
5745,2011-09-01,3,0,9,19,0,4,1,1,0.7,0.6515,0.58,0.1642,79,1185,364,3640,443,4825
5746,2011-09-01,3,0,9,20,0,4,1,1,0.66,0.6212,0.61,0.2239,33,495,247,2470,280,2965
5747,2011-09-01,3,0,9,21,0,4,1,2,0.66,0.6212,0.57,0.194,17,255,160,1600,177,1855
5748,2011-09-01,3,0,9,22,0,4,1,2,0.66,0.6212,0.57,0.2239,34,510,145,1450,179,1960
5749,2011-09-01,3,0,9,23,0,4,1,1,0.64,0.6061,0.65,0.2537,15,225,111,1110,126,1335
5750,2011-09-02,3,0,9,0,0,5,1,1,0.64,0.6061,0.65,0.194,6,90,58,580,64,670
5751,2011-09-02,3,0,9,1,0,5,1,3,0.62,0.5909,0.73,0.1045,4,60,28,280,32,340
5752,2011-09-02,3,0,9,2,0,5,1,3,0.62,0.5909,0.73,0.1045,9,135,11,110,20,245
5753,2011-09-02,3,0,9,3,0,5,1,2,0.6,0.5606,0.83,0.1642,4,60,4,40,8,100
5754,2011-09-02,3,0,9,4,0,5,1,1,0.6,0.5606,0.83,0.0896,2,30,2,20,4,50
5755,2011-09-02,3,0,9,5,0,5,1,2,0.6,0.5606,0.83,0.1343,0,0,20,200,20,200
5756,2011-09-02,3,0,9,6,0,5,1,1,0.6,0.5606,0.83,0.1343,3,45,73,730,76,775
5757,2011-09-02,3,0,9,7,0,5,1,1,0.6,0.5606,0.83,0.1045,6,90,253,2530,259,2620
5758,2011-09-02,3,0,9,8,0,5,1,1,0.62,0.5909,0.78,0.194,22,330,434,4340,456,4670
5759,2011-09-02,3,0,9,9,0,5,1,2,0.62,0.5758,0.83,0.1045,30,450,190,1900,220,2350
5760,2011-09-02,3,0,9,10,0,5,1,2,0.64,0.6061,0.76,0.1642,34,510,106,1060,140,1570
5761,2011-09-02,3,0,9,11,0,5,1,2,0.66,0.6212,0.74,0.1045,51,765,141,1410,192,2175
5762,2011-09-02,3,0,9,12,0,5,1,2,0.66,0.6212,0.69,0.2239,82,1230,178,1780,260,3010
5763,2011-09-02,3,0,9,13,0,5,1,2,0.68,0.6364,0.65,0.1343,72,1080,207,2070,279,3150
5764,2011-09-02,3,0,9,14,0,5,1,2,0.7,0.6515,0.61,0.1045,75,1125,208,2080,283,3205
5765,2011-09-02,3,0,9,15,0,5,1,2,0.7,0.6515,0.61,0.2537,69,1035,277,2770,346,3805
5766,2011-09-02,3,0,9,16,0,5,1,2,0.7,0.6515,0.61,0.1343,82,1230,299,2990,381,4220
5767,2011-09-02,3,0,9,17,0,5,1,2,0.68,0.6364,0.65,0.1642,78,1170,377,3770,455,4940
5768,2011-09-02,3,0,9,18,0,5,1,2,0.68,0.6364,0.65,0.194,50,750,305,3050,355,3800
5769,2011-09-02,3,0,9,19,0,5,1,1,0.66,0.6212,0.69,0.1343,67,1005,220,2200,287,3205
5770,2011-09-02,3,0,9,20,0,5,1,1,0.64,0.6061,0.73,0.0,38,570,158,1580,196,2150
5771,2011-09-02,3,0,9,21,0,5,1,2,0.64,0.6061,0.73,0.0896,28,420,121,1210,149,1630
5772,2011-09-02,3,0,9,22,0,5,1,2,0.64,0.6061,0.73,0.1642,33,495,114,1140,147,1635
5773,2011-09-02,3,0,9,23,0,5,1,2,0.64,0.6061,0.73,0.1642,30,450,68,680,98,1130
5774,2011-09-03,3,0,9,0,0,6,0,2,0.64,0.6061,0.73,0.1045,22,330,65,650,87,980
5775,2011-09-03,3,0,9,1,0,6,0,2,0.64,0.6061,0.69,0.2537,17,255,57,570,74,825
5776,2011-09-03,3,0,9,2,0,6,0,2,0.64,0.6061,0.69,0.2239,15,225,26,260,41,485
5777,2011-09-03,3,0,9,3,0,6,0,1,0.62,0.5909,0.73,0.1642,17,255,18,180,35,435
5778,2011-09-03,3,0,9,4,0,6,0,1,0.62,0.5909,0.73,0.1642,3,45,4,40,7,85
5779,2011-09-03,3,0,9,5,0,6,0,1,0.62,0.6061,0.69,0.194,3,45,9,90,12,135
5780,2011-09-03,3,0,9,6,0,6,0,1,0.62,0.5909,0.73,0.1642,4,60,19,190,23,250
5781,2011-09-03,3,0,9,7,0,6,0,1,0.62,0.5909,0.73,0.194,5,75,33,330,38,405
5782,2011-09-03,3,0,9,8,0,6,0,1,0.64,0.6061,0.69,0.1642,24,360,65,650,89,1010
5783,2011-09-03,3,0,9,9,0,6,0,2,0.66,0.6212,0.69,0.2537,83,1245,118,1180,201,2425
5784,2011-09-03,3,0,9,10,0,6,0,3,0.66,0.6212,0.65,0.2537,90,1350,168,1680,258,3030
5785,2011-09-03,3,0,9,11,0,6,0,3,0.66,0.6212,0.69,0.2836,66,990,128,1280,194,2270
5786,2011-09-03,3,0,9,12,0,6,0,1,0.7,0.6515,0.61,0.2239,97,1455,160,1600,257,3055
5787,2011-09-03,3,0,9,13,0,6,0,1,0.7,0.6515,0.65,0.2239,153,2295,200,2000,353,4295
5788,2011-09-03,3,0,9,14,0,6,0,2,0.72,0.6818,0.66,0.1642,204,3060,176,1760,380,4820
5789,2011-09-03,3,0,9,15,0,6,0,1,0.72,0.6818,0.7,0.1642,187,2805,201,2010,388,4815
5790,2011-09-03,3,0,9,16,0,6,0,1,0.72,0.6818,0.7,0.194,186,2790,188,1880,374,4670
5791,2011-09-03,3,0,9,17,0,6,0,1,0.72,0.6818,0.7,0.2239,170,2550,201,2010,371,4560
5792,2011-09-03,3,0,9,18,0,6,0,1,0.72,0.6818,0.7,0.1642,160,2400,179,1790,339,4190
5793,2011-09-03,3,0,9,19,0,6,0,1,0.7,0.6667,0.74,0.1343,147,2205,148,1480,295,3685
5794,2011-09-03,3,0,9,20,0,6,0,1,0.7,0.6667,0.79,0.1642,99,1485,120,1200,219,2685
5795,2011-09-03,3,0,9,21,0,6,0,1,0.68,0.6364,0.83,0.1343,71,1065,93,930,164,1995
5796,2011-09-03,3,0,9,22,0,6,0,1,0.68,0.6364,0.83,0.1045,66,990,96,960,162,1950
5797,2011-09-03,3,0,9,23,0,6,0,1,0.66,0.6212,0.85,0.1343,46,690,77,770,123,1460
5798,2011-09-04,3,0,9,0,0,0,0,1,0.66,0.5909,0.89,0.194,33,495,76,760,109,1255
5799,2011-09-04,3,0,9,1,0,0,0,1,0.66,0.6061,0.83,0.1343,37,555,38,380,75,935
5800,2011-09-04,3,0,9,2,0,0,0,1,0.66,0.6061,0.83,0.194,17,255,43,430,60,685
5801,2011-09-04,3,0,9,3,0,0,0,1,0.64,0.5758,0.89,0.194,20,300,23,230,43,530
5802,2011-09-04,3,0,9,4,0,0,0,1,0.64,0.5758,0.83,0.1642,0,0,4,40,4,40
5803,2011-09-04,3,0,9,5,0,0,0,1,0.64,0.5758,0.83,0.1343,1,15,5,50,6,65
5804,2011-09-04,3,0,9,6,0,0,0,1,0.64,0.5758,0.84,0.2239,0,0,3,30,3,30
5805,2011-09-04,3,0,9,7,0,0,0,1,0.66,0.6061,0.78,0.194,10,150,20,200,30,350
5806,2011-09-04,3,0,9,8,0,0,0,1,0.66,0.6061,0.78,0.1642,21,315,49,490,70,805
5807,2011-09-04,3,0,9,9,0,0,0,1,0.66,0.6061,0.78,0.1642,87,1305,102,1020,189,2325
5808,2011-09-04,3,0,9,10,0,0,0,1,0.7,0.6667,0.74,0.1343,150,2250,147,1470,297,3720
5809,2011-09-04,3,0,9,11,0,0,0,1,0.74,0.697,0.7,0.1642,174,2610,163,1630,337,4240
5810,2011-09-04,3,0,9,12,0,0,0,1,0.76,0.7273,0.66,0.1642,214,3210,221,2210,435,5420
5811,2011-09-04,3,0,9,13,0,0,0,2,0.78,0.7424,0.62,0.2836,245,3675,174,1740,419,5415
5812,2011-09-04,3,0,9,14,0,0,0,1,0.78,0.7576,0.66,0.3284,205,3075,156,1560,361,4635
5813,2011-09-04,3,0,9,15,0,0,0,1,0.78,0.7576,0.66,0.2836,218,3270,192,1920,410,5190
5814,2011-09-04,3,0,9,16,0,0,0,1,0.8,0.7727,0.59,0.2239,196,2940,141,1410,337,4350
5815,2011-09-04,3,0,9,17,0,0,0,1,0.76,0.7273,0.66,0.2239,204,3060,172,1720,376,4780
5816,2011-09-04,3,0,9,18,0,0,0,1,0.76,0.7273,0.66,0.194,187,2805,169,1690,356,4495
5817,2011-09-04,3,0,9,19,0,0,0,1,0.74,0.697,0.7,0.194,178,2670,150,1500,328,4170
5818,2011-09-04,3,0,9,20,0,0,0,1,0.74,0.697,0.7,0.2985,104,1560,125,1250,229,2810
5819,2011-09-04,3,0,9,21,0,0,0,1,0.72,0.697,0.74,0.2537,104,1560,103,1030,207,2590
5820,2011-09-04,3,0,9,22,0,0,0,2,0.72,0.697,0.74,0.2836,70,1050,85,850,155,1900
5821,2011-09-04,3,0,9,23,0,0,0,2,0.72,0.6818,0.7,0.1642,46,690,58,580,104,1270
5822,2011-09-05,3,0,9,0,1,1,0,2,0.7,0.6667,0.74,0.2239,31,465,66,660,97,1125
5823,2011-09-05,3,0,9,1,1,1,0,2,0.68,0.6364,0.79,0.1045,19,285,35,350,54,635
5824,2011-09-05,3,0,9,2,1,1,0,2,0.68,0.6364,0.79,0.1642,17,255,22,220,39,475
5825,2011-09-05,3,0,9,3,1,1,0,2,0.68,0.6364,0.74,0.2985,4,60,12,120,16,180
5826,2011-09-05,3,0,9,4,1,1,0,2,0.68,0.6364,0.69,0.2836,3,45,5,50,8,95
5827,2011-09-05,3,0,9,5,1,1,0,2,0.66,0.6212,0.74,0.1642,2,30,4,40,6,70
5828,2011-09-05,3,0,9,6,1,1,0,2,0.66,0.6212,0.74,0.1343,6,90,5,50,11,140
5829,2011-09-05,3,0,9,7,1,1,0,1,0.66,0.6212,0.74,0.1642,11,165,30,300,41,465
5830,2011-09-05,3,0,9,8,1,1,0,2,0.66,0.6061,0.78,0.194,45,675,56,560,101,1235
5831,2011-09-05,3,0,9,9,1,1,0,3,0.68,0.6364,0.74,0.1642,63,945,89,890,152,1835
5832,2011-09-05,3,0,9,10,1,1,0,2,0.7,0.6515,0.7,0.1642,107,1605,137,1370,244,2975
5833,2011-09-05,3,0,9,11,1,1,0,2,0.7,0.6667,0.74,0.1642,101,1515,207,2070,308,3585
5834,2011-09-05,3,0,9,12,1,1,0,2,0.72,0.6818,0.7,0.194,141,2115,212,2120,353,4235
5835,2011-09-05,3,0,9,13,1,1,0,2,0.74,0.697,0.7,0.1343,154,2310,235,2350,389,4660
5836,2011-09-05,3,0,9,14,1,1,0,1,0.74,0.697,0.7,0.1642,145,2175,212,2120,357,4295
5837,2011-09-05,3,0,9,15,1,1,0,2,0.68,0.6364,0.79,0.2836,111,1665,142,1420,253,3085
5838,2011-09-05,3,0,9,16,1,1,0,2,0.68,0.6364,0.79,0.2836,92,1380,192,1920,284,3300
5839,2011-09-05,3,0,9,17,1,1,0,2,0.66,0.5909,0.89,0.1045,37,555,77,770,114,1325
5840,2011-09-05,3,0,9,18,1,1,0,1,0.66,0.5909,0.89,0.0896,31,465,92,920,123,1385
5841,2011-09-05,3,0,9,19,1,1,0,3,0.66,0.5909,0.94,0.1045,52,780,123,1230,175,2010
5842,2011-09-05,3,0,9,20,1,1,0,3,0.66,0.5909,0.94,0.2537,26,390,56,560,82,950
5843,2011-09-05,3,0,9,21,1,1,0,2,0.66,0.5909,0.94,0.2985,20,300,40,400,60,700
5844,2011-09-05,3,0,9,22,1,1,0,2,0.6,0.5455,0.88,0.5821,15,225,49,490,64,715
5845,2011-09-05,3,0,9,23,1,1,0,3,0.56,0.5303,0.88,0.3881,3,45,17,170,20,215
5846,2011-09-06,3,0,9,0,0,2,1,3,0.54,0.5152,0.94,0.3582,1,15,7,70,8,85
5847,2011-09-06,3,0,9,2,0,2,1,3,0.54,0.5152,0.94,0.2537,0,0,2,20,2,20
5848,2011-09-06,3,0,9,3,0,2,1,3,0.54,0.5152,0.94,0.2985,1,15,0,0,1,15
5849,2011-09-06,3,0,9,4,0,2,1,2,0.54,0.5152,0.94,0.2985,1,15,3,30,4,45
5850,2011-09-06,3,0,9,5,0,2,1,3,0.54,0.5152,0.88,0.3582,1,15,20,200,21,215
5851,2011-09-06,3,0,9,6,0,2,1,2,0.54,0.5152,0.88,0.3284,0,0,72,720,72,720
5852,2011-09-06,3,0,9,7,0,2,1,2,0.54,0.5152,0.83,0.3582,6,90,166,1660,172,1750
5853,2011-09-06,3,0,9,8,0,2,1,3,0.54,0.5152,0.83,0.3881,15,225,349,3490,364,3715
5854,2011-09-06,3,0,9,9,0,2,1,2,0.54,0.5152,0.81,0.4179,18,270,167,1670,185,1940
5855,2011-09-06,3,0,9,10,0,2,1,3,0.54,0.5152,0.83,0.3582,16,240,90,900,106,1140
5856,2011-09-06,3,0,9,11,0,2,1,3,0.54,0.5152,0.83,0.3881,11,165,78,780,89,945
5857,2011-09-06,3,0,9,12,0,2,1,3,0.54,0.5152,0.83,0.3881,16,240,51,510,67,750
5858,2011-09-06,3,0,9,13,0,2,1,3,0.54,0.5152,0.88,0.2985,5,75,24,240,29,315
5859,2011-09-06,3,0,9,14,0,2,1,3,0.54,0.5152,0.88,0.2836,3,45,21,210,24,255
5860,2011-09-06,3,0,9,15,0,2,1,3,0.54,0.5152,0.94,0.3881,18,270,71,710,89,980
5861,2011-09-06,3,0,9,16,0,2,1,3,0.54,0.5152,0.94,0.3881,11,165,95,950,106,1115
5862,2011-09-06,3,0,9,17,0,2,1,2,0.54,0.5152,0.88,0.3881,15,225,276,2760,291,2985
5863,2011-09-06,3,0,9,18,0,2,1,2,0.54,0.5152,0.88,0.3881,22,330,351,3510,373,3840
5864,2011-09-06,3,0,9,19,0,2,1,2,0.54,0.5152,0.88,0.4179,12,180,269,2690,281,2870
5865,2011-09-06,3,0,9,20,0,2,1,3,0.54,0.5152,0.88,0.2985,13,195,150,1500,163,1695
5866,2011-09-06,3,0,9,21,0,2,1,3,0.54,0.5152,0.88,0.2836,12,180,109,1090,121,1270
5867,2011-09-06,3,0,9,22,0,2,1,2,0.54,0.5152,0.94,0.3284,5,75,79,790,84,865
5868,2011-09-06,3,0,9,23,0,2,1,3,0.54,0.5152,0.94,0.2537,2,30,56,560,58,590
5869,2011-09-07,3,0,9,0,0,3,1,2,0.54,0.5152,0.94,0.2239,1,15,12,120,13,135
5870,2011-09-07,3,0,9,1,0,3,1,3,0.54,0.5152,0.94,0.2537,2,30,3,30,5,60
5871,2011-09-07,3,0,9,2,0,3,1,2,0.54,0.5152,0.94,0.2239,2,30,4,40,6,70
5872,2011-09-07,3,0,9,3,0,3,1,3,0.56,0.5303,0.94,0.1343,1,15,1,10,2,25
5873,2011-09-07,3,0,9,4,0,3,1,3,0.56,0.5303,0.94,0.1642,0,0,4,40,4,40
5874,2011-09-07,3,0,9,5,0,3,1,2,0.56,0.5303,1.0,0.1343,1,15,15,150,16,165
5875,2011-09-07,3,0,9,6,0,3,1,3,0.6,0.5455,0.88,0.1045,1,15,74,740,75,755
5876,2011-09-07,3,0,9,7,0,3,1,3,0.6,0.5455,0.88,0.0896,3,45,83,830,86,875
5877,2011-09-07,3,0,9,8,0,3,1,3,0.62,0.5455,0.94,0.0896,9,135,319,3190,328,3325
5878,2011-09-07,3,0,9,9,0,3,1,3,0.6,0.5455,0.88,0.1343,14,210,176,1760,190,1970
5879,2011-09-07,3,0,9,10,0,3,1,3,0.6,0.5455,0.88,0.1343,3,45,63,630,66,675
5880,2011-09-07,3,0,9,11,0,3,1,3,0.6,0.5152,0.94,0.0,1,15,9,90,10,105
5881,2011-09-07,3,0,9,12,0,3,1,3,0.56,0.5303,0.94,0.0,1,15,21,210,22,225
5882,2011-09-07,3,0,9,13,0,3,1,3,0.6,0.5455,0.88,0.0,2,30,9,90,11,120
5883,2011-09-07,3,0,9,14,0,3,1,3,0.6,0.5152,0.93,0.0,1,15,24,240,25,255
5884,2011-09-07,3,0,9,15,0,3,1,3,0.62,0.5455,0.94,0.1045,3,45,55,550,58,595
5885,2011-09-07,3,0,9,16,0,3,1,1,0.64,0.5758,0.89,0.0,7,105,137,1370,144,1475
5886,2011-09-07,3,0,9,17,0,3,1,3,0.64,0.5758,0.89,0.0,21,315,264,2640,285,2955
5887,2011-09-07,3,0,9,18,0,3,1,3,0.64,0.5758,0.89,0.0,18,270,219,2190,237,2460
5888,2011-09-07,3,0,9,19,0,3,1,2,0.64,0.5758,0.89,0.0,14,210,212,2120,226,2330
5889,2011-09-07,3,0,9,20,0,3,1,3,0.64,0.5758,0.89,0.0896,3,45,93,930,96,975
5890,2011-09-07,3,0,9,21,0,3,1,3,0.64,0.5758,0.89,0.0896,4,60,34,340,38,400
5891,2011-09-07,3,0,9,22,0,3,1,3,0.62,0.5455,0.94,0.1642,3,45,26,260,29,305
5892,2011-09-07,3,0,9,23,0,3,1,3,0.62,0.5455,0.94,0.194,3,45,21,210,24,255
5893,2011-09-08,3,0,9,0,0,4,1,3,0.6,0.5,1.0,0.194,3,45,11,110,14,155
5894,2011-09-08,3,0,9,1,0,4,1,3,0.62,0.5455,0.94,0.1045,0,0,4,40,4,40
5895,2011-09-08,3,0,9,3,0,4,1,3,0.62,0.5455,0.94,0.0,0,0,2,20,2,20
5896,2011-09-08,3,0,9,4,0,4,1,2,0.62,0.5455,0.94,0.0896,0,0,3,30,3,30
5897,2011-09-08,3,0,9,5,0,4,1,3,0.62,0.5455,0.94,0.0896,1,15,13,130,14,145
5898,2011-09-08,3,0,9,6,0,4,1,3,0.62,0.5455,0.94,0.1642,1,15,55,550,56,565
5899,2011-09-08,3,0,9,7,0,4,1,3,0.62,0.5455,0.94,0.1045,7,105,172,1720,179,1825
5900,2011-09-08,3,0,9,8,0,4,1,3,0.62,0.5455,0.94,0.1343,7,105,188,1880,195,1985
5901,2011-09-08,3,0,9,9,0,4,1,2,0.62,0.5152,1.0,0.2537,4,60,65,650,69,710
5902,2011-09-08,3,0,9,10,0,4,1,2,0.64,0.5606,0.94,0.1045,8,120,57,570,65,690
5903,2011-09-08,3,0,9,11,0,4,1,2,0.64,0.5606,0.94,0.2239,16,240,82,820,98,1060
5904,2011-09-08,3,0,9,12,0,4,1,2,0.66,0.5909,0.94,0.2239,17,255,85,850,102,1105
5905,2011-09-08,3,0,9,13,0,4,1,2,0.68,0.6364,0.83,0.3881,14,210,112,1120,126,1330
5906,2011-09-08,3,0,9,14,0,4,1,2,0.7,0.6667,0.79,0.3582,15,225,105,1050,120,1275
5907,2011-09-08,3,0,9,15,0,4,1,3,0.66,0.5909,0.89,0.2985,24,360,115,1150,139,1510
5908,2011-09-08,3,0,9,16,0,4,1,3,0.64,0.5606,0.94,0.2836,5,75,151,1510,156,1585
5909,2011-09-08,3,0,9,17,0,4,1,3,0.64,0.5606,0.94,0.2836,11,165,102,1020,113,1185
5910,2011-09-08,3,0,9,18,0,4,1,3,0.64,0.5606,0.94,0.3582,2,30,66,660,68,690
5911,2011-09-08,3,0,9,19,0,4,1,3,0.62,0.5152,1.0,0.3284,1,15,51,510,52,525
5912,2011-09-08,3,0,9,20,0,4,1,2,0.62,0.5455,0.94,0.1642,6,90,83,830,89,920
5913,2011-09-08,3,0,9,21,0,4,1,3,0.64,0.5606,0.94,0.1045,6,90,76,760,82,850
5914,2011-09-08,3,0,9,22,0,4,1,3,0.62,0.5152,1.0,0.0896,5,75,65,650,70,725
5915,2011-09-08,3,0,9,23,0,4,1,3,0.62,0.5152,1.0,0.0896,0,0,26,260,26,260
5916,2011-09-09,3,0,9,0,0,5,1,3,0.64,0.5606,0.94,0.194,1,15,15,150,16,165
5917,2011-09-09,3,0,9,1,0,5,1,2,0.62,0.5152,1.0,0.1642,0,0,8,80,8,80
5918,2011-09-09,3,0,9,2,0,5,1,2,0.62,0.5152,1.0,0.2537,1,15,7,70,8,85
5919,2011-09-09,3,0,9,3,0,5,1,2,0.62,0.5455,0.94,0.2537,1,15,1,10,2,25
5920,2011-09-09,3,0,9,4,0,5,1,3,0.62,0.5455,0.94,0.1642,0,0,3,30,3,30
5921,2011-09-09,3,0,9,5,0,5,1,2,0.62,0.5455,0.94,0.1343,0,0,14,140,14,140
5922,2011-09-09,3,0,9,6,0,5,1,2,0.62,0.5152,1.0,0.1343,3,45,54,540,57,585
5923,2011-09-09,3,0,9,7,0,5,1,3,0.62,0.5152,1.0,0.2537,4,60,104,1040,108,1100
5924,2011-09-09,3,0,9,8,0,5,1,3,0.62,0.5455,0.94,0.1642,12,180,276,2760,288,2940
5925,2011-09-09,3,0,9,9,0,5,1,3,0.62,0.5455,0.94,0.1642,5,75,131,1310,136,1385
5926,2011-09-09,3,0,9,10,0,5,1,2,0.62,0.5152,1.0,0.0,2,30,27,270,29,300
5927,2011-09-09,3,0,9,11,0,5,1,2,0.62,0.5455,0.94,0.0,6,90,66,660,72,750
5928,2011-09-09,3,0,9,12,0,5,1,1,0.64,0.5606,0.94,0.0,4,60,71,710,75,770
5929,2011-09-09,3,0,9,13,0,5,1,1,0.7,0.6667,0.79,0.0896,14,210,108,1080,122,1290
5930,2011-09-09,3,0,9,14,0,5,1,1,0.72,0.697,0.74,0.0896,29,435,119,1190,148,1625
5931,2011-09-09,3,0,9,15,0,5,1,1,0.74,0.697,0.66,0.0,27,405,161,1610,188,2015
5932,2011-09-09,3,0,9,16,0,5,1,1,0.74,0.697,0.66,0.1343,41,615,244,2440,285,3055
5933,2011-09-09,3,0,9,17,0,5,1,1,0.7,0.6667,0.79,0.2537,54,810,451,4510,505,5320
5934,2011-09-09,3,0,9,18,0,5,1,1,0.7,0.6667,0.79,0.194,33,495,377,3770,410,4265
5935,2011-09-09,3,0,9,19,0,5,1,1,0.66,0.5909,0.89,0.1642,33,495,316,3160,349,3655
5936,2011-09-09,3,0,9,20,0,5,1,1,0.64,0.5606,0.94,0.0896,30,450,180,1800,210,2250
5937,2011-09-09,3,0,9,21,0,5,1,1,0.66,0.5909,0.89,0.0,49,735,154,1540,203,2275
5938,2011-09-09,3,0,9,22,0,5,1,1,0.62,0.5455,0.94,0.0,33,495,127,1270,160,1765
5939,2011-09-09,3,0,9,23,0,5,1,1,0.62,0.5455,0.94,0.0896,35,525,113,1130,148,1655
5940,2011-09-10,3,0,9,0,0,6,0,1,0.62,0.5455,0.94,0.0,32,480,84,840,116,1320
5941,2011-09-10,3,0,9,1,0,6,0,2,0.62,0.5455,0.94,0.0,16,240,67,670,83,910
5942,2011-09-10,3,0,9,2,0,6,0,2,0.6,0.5,0.97,0.1045,18,270,46,460,64,730
5943,2011-09-10,3,0,9,3,0,6,0,1,0.58,0.5455,1.0,0.1343,8,120,29,290,37,410
5944,2011-09-10,3,0,9,4,0,6,0,1,0.58,0.5455,0.94,0.0896,3,45,4,40,7,85
5945,2011-09-10,3,0,9,5,0,6,0,1,0.58,0.5455,0.94,0.1343,2,30,6,60,8,90
5946,2011-09-10,3,0,9,6,0,6,0,1,0.58,0.5455,0.94,0.1642,0,0,6,60,6,60
5947,2011-09-10,3,0,9,7,0,6,0,1,0.6,0.5455,0.88,0.1343,9,135,43,430,52,565
5948,2011-09-10,3,0,9,8,0,6,0,1,0.62,0.5758,0.83,0.1642,16,240,103,1030,119,1270
5949,2011-09-10,3,0,9,9,0,6,0,1,0.64,0.5909,0.78,0.2985,39,585,168,1680,207,2265
5950,2011-09-10,3,0,9,10,0,6,0,1,0.7,0.6515,0.65,0.2537,85,1275,233,2330,318,3605
5951,2011-09-10,3,0,9,11,0,6,0,1,0.72,0.6818,0.62,0.2537,108,1620,252,2520,360,4140
5952,2011-09-10,3,0,9,12,0,6,0,1,0.72,0.6818,0.62,0.2239,144,2160,260,2600,404,4760
5953,2011-09-10,3,0,9,13,0,6,0,1,0.74,0.6818,0.55,0.2836,131,1965,239,2390,370,4355
5954,2011-09-10,3,0,9,14,0,6,0,1,0.74,0.6818,0.55,0.2836,129,1935,230,2300,359,4235
5955,2011-09-10,3,0,9,15,0,6,0,1,0.74,0.6818,0.55,0.2239,217,3255,263,2630,480,5885
5956,2011-09-10,3,0,9,16,0,6,0,1,0.74,0.6818,0.55,0.194,170,2550,261,2610,431,5160
5957,2011-09-10,3,0,9,17,0,6,0,1,0.74,0.6818,0.55,0.2239,185,2775,275,2750,460,5525
5958,2011-09-10,3,0,9,18,0,6,0,1,0.72,0.6667,0.58,0.194,119,1785,241,2410,360,4195
5959,2011-09-10,3,0,9,19,0,6,0,1,0.7,0.6515,0.58,0.1343,101,1515,214,2140,315,3655
5960,2011-09-10,3,0,9,20,0,6,0,1,0.66,0.6212,0.69,0.1045,78,1170,167,1670,245,2840
5961,2011-09-10,3,0,9,21,0,6,0,1,0.64,0.5909,0.78,0.0896,59,885,171,1710,230,2595
5962,2011-09-10,3,0,9,22,0,6,0,1,0.64,0.5909,0.78,0.0,49,735,126,1260,175,1995
5963,2011-09-10,3,0,9,23,0,6,0,2,0.62,0.5606,0.88,0.0,32,480,107,1070,139,1550
5964,2011-09-11,3,0,9,0,0,0,0,1,0.62,0.5606,0.88,0.0,29,435,79,790,108,1225
5965,2011-09-11,3,0,9,1,0,0,0,2,0.62,0.5606,0.88,0.0,22,330,66,660,88,990
5966,2011-09-11,3,0,9,2,0,0,0,2,0.62,0.5909,0.78,0.194,16,240,60,600,76,840
5967,2011-09-11,3,0,9,3,0,0,0,2,0.62,0.5909,0.78,0.0896,15,225,30,300,45,525
5968,2011-09-11,3,0,9,4,0,0,0,1,0.6,0.5606,0.83,0.1343,3,45,6,60,9,105
5969,2011-09-11,3,0,9,5,0,0,0,1,0.6,0.5606,0.83,0.1343,15,225,24,240,39,465
5970,2011-09-11,3,0,9,6,0,0,0,1,0.58,0.5455,0.88,0.1045,4,60,16,160,20,220
5971,2011-09-11,3,0,9,7,0,0,0,1,0.6,0.5455,0.88,0.0,9,135,28,280,37,415
5972,2011-09-11,3,0,9,8,0,0,0,1,0.64,0.5909,0.78,0.0,25,375,69,690,94,1065
5973,2011-09-11,3,0,9,9,0,0,0,1,0.66,0.6212,0.74,0.0,59,885,168,1680,227,2565
5974,2011-09-11,3,0,9,10,0,0,0,1,0.7,0.6515,0.65,0.0,120,1800,214,2140,334,3940
5975,2011-09-11,3,0,9,11,0,0,0,1,0.7,0.6515,0.65,0.0,144,2160,258,2580,402,4740
5976,2011-09-11,3,0,9,12,0,0,0,1,0.7,0.6515,0.65,0.0,113,1695,298,2980,411,4675
5977,2011-09-11,3,0,9,13,0,0,0,1,0.74,0.6818,0.58,0.1045,119,1785,231,2310,350,4095
5978,2011-09-11,3,0,9,14,0,0,0,1,0.72,0.6667,0.58,0.2836,120,1800,222,2220,342,4020
5979,2011-09-11,3,0,9,15,0,0,0,1,0.74,0.6667,0.51,0.2985,134,2010,270,2700,404,4710
5980,2011-09-11,3,0,9,16,0,0,0,1,0.72,0.6667,0.51,0.2985,180,2700,303,3030,483,5730
5981,2011-09-11,3,0,9,17,0,0,0,1,0.72,0.6667,0.51,0.1343,152,2280,228,2280,380,4560
5982,2011-09-11,3,0,9,18,0,0,0,1,0.68,0.6364,0.65,0.2985,110,1650,229,2290,339,3940
5983,2011-09-11,3,0,9,19,0,0,0,1,0.64,0.6061,0.69,0.1045,101,1515,232,2320,333,3835
5984,2011-09-11,3,0,9,20,0,0,0,1,0.62,0.5909,0.73,0.1045,65,975,161,1610,226,2585
5985,2011-09-11,3,0,9,21,0,0,0,1,0.64,0.6061,0.69,0.0,45,675,114,1140,159,1815
5986,2011-09-11,3,0,9,22,0,0,0,1,0.62,0.6061,0.69,0.3881,21,315,74,740,95,1055
5987,2011-09-11,3,0,9,23,0,0,0,3,0.58,0.5455,0.78,0.0896,12,180,33,330,45,510
5988,2011-09-12,3,0,9,0,0,1,1,1,0.56,0.5303,0.88,0.0896,5,75,11,110,16,185
5989,2011-09-12,3,0,9,1,0,1,1,1,0.56,0.5303,0.88,0.0,1,15,11,110,12,125
5990,2011-09-12,3,0,9,2,0,1,1,1,0.56,0.5303,0.88,0.0,2,30,0,0,2,30
5991,2011-09-12,3,0,9,4,0,1,1,1,0.54,0.5152,0.94,0.1045,0,0,4,40,4,40
5992,2011-09-12,3,0,9,5,0,1,1,1,0.56,0.5303,0.83,0.0,1,15,23,230,24,245
5993,2011-09-12,3,0,9,6,0,1,1,1,0.56,0.5303,0.83,0.0,1,15,108,1080,109,1095
5994,2011-09-12,3,0,9,7,0,1,1,1,0.58,0.5455,0.83,0.0,12,180,300,3000,312,3180
5995,2011-09-12,3,0,9,8,0,1,1,1,0.6,0.5758,0.78,0.0896,26,390,382,3820,408,4210
5996,2011-09-12,3,0,9,9,0,1,1,1,0.64,0.6061,0.69,0.0,21,315,155,1550,176,1865
5997,2011-09-12,3,0,9,10,0,1,1,1,0.68,0.6364,0.62,0.1642,40,600,89,890,129,1490
5998,2011-09-12,3,0,9,11,0,1,1,1,0.7,0.6515,0.58,0.194,34,510,131,1310,165,1820
5999,2011-09-12,3,0,9,12,0,1,1,1,0.72,0.6667,0.51,0.194,37,555,147,1470,184,2025
6000,2011-09-12,3,0,9,13,0,1,1,1,0.72,0.6667,0.54,0.1045,43,645,120,1200,163,1845
6001,2011-09-12,3,0,9,14,0,1,1,1,0.74,0.6667,0.51,0.1642,60,900,129,1290,189,2190
6002,2011-09-12,3,0,9,15,0,1,1,1,0.74,0.6667,0.48,0.0896,60,900,152,1520,212,2420
6003,2011-09-12,3,0,9,16,0,1,1,1,0.72,0.6667,0.48,0.0,60,900,238,2380,298,3280
6004,2011-09-12,3,0,9,17,0,1,1,1,0.72,0.6667,0.51,0.1642,75,1125,515,5150,590,6275
6005,2011-09-12,3,0,9,18,0,1,1,1,0.7,0.6515,0.54,0.194,56,840,515,5150,571,5990
6006,2011-09-12,3,0,9,19,0,1,1,1,0.68,0.6364,0.57,0.1343,63,945,373,3730,436,4675
6007,2011-09-12,3,0,9,20,0,1,1,1,0.66,0.6212,0.65,0.0,41,615,258,2580,299,3195
6008,2011-09-12,3,0,9,21,0,1,1,1,0.64,0.6061,0.73,0.0896,29,435,166,1660,195,2095
6009,2011-09-12,3,0,9,22,0,1,1,1,0.62,0.5758,0.83,0.1642,16,240,134,1340,150,1580
6010,2011-09-12,3,0,9,23,0,1,1,1,0.62,0.5758,0.83,0.1045,7,105,62,620,69,725
6011,2011-09-13,3,0,9,0,0,2,1,1,0.6,0.5455,0.88,0.1045,7,105,19,190,26,295
6012,2011-09-13,3,0,9,1,0,2,1,1,0.58,0.5455,0.83,0.1045,4,60,6,60,10,120
6013,2011-09-13,3,0,9,2,0,2,1,1,0.6,0.5758,0.78,0.0,2,30,0,0,2,30
6014,2011-09-13,3,0,9,3,0,2,1,1,0.58,0.5455,0.83,0.0,2,30,2,20,4,50
6015,2011-09-13,3,0,9,4,0,2,1,1,0.56,0.5303,0.88,0.0,2,30,6,60,8,90
6016,2011-09-13,3,0,9,5,0,2,1,1,0.56,0.5303,0.88,0.0,1,15,19,190,20,205
6017,2011-09-13,3,0,9,6,0,2,1,1,0.56,0.5303,0.88,0.1045,6,90,116,1160,122,1250
6018,2011-09-13,3,0,9,7,0,2,1,1,0.58,0.5455,0.83,0.0896,14,210,348,3480,362,3690
6019,2011-09-13,3,0,9,8,0,2,1,1,0.6,0.5606,0.81,0.1045,26,390,399,3990,425,4380
6020,2011-09-13,3,0,9,9,0,2,1,1,0.64,0.6061,0.69,0.0896,35,525,179,1790,214,2315
6021,2011-09-13,3,0,9,10,0,2,1,1,0.68,0.6364,0.69,0.1343,42,630,93,930,135,1560
6022,2011-09-13,3,0,9,11,0,2,1,1,0.7,0.6515,0.61,0.1642,33,495,120,1200,153,1695
6023,2011-09-13,3,0,9,12,0,2,1,1,0.72,0.6667,0.58,0.2239,43,645,144,1440,187,2085
6024,2011-09-13,3,0,9,13,0,2,1,1,0.74,0.6667,0.51,0.2836,48,720,136,1360,184,2080
6025,2011-09-13,3,0,9,14,0,2,1,1,0.74,0.6667,0.51,0.3284,51,765,139,1390,190,2155
6026,2011-09-13,3,0,9,15,0,2,1,1,0.74,0.6667,0.51,0.2985,35,525,145,1450,180,1975
6027,2011-09-13,3,0,9,16,0,2,1,1,0.74,0.6667,0.51,0.2239,41,615,251,2510,292,3125
6028,2011-09-13,3,0,9,17,0,2,1,1,0.74,0.6667,0.51,0.2239,72,1080,507,5070,579,6150
6029,2011-09-13,3,0,9,18,0,2,1,1,0.7,0.6515,0.61,0.1642,67,1005,472,4720,539,5725
6030,2011-09-13,3,0,9,19,0,2,1,1,0.68,0.6364,0.69,0.1642,55,825,341,3410,396,4235
6031,2011-09-13,3,0,9,20,0,2,1,1,0.66,0.6212,0.74,0.194,31,465,241,2410,272,2875
6032,2011-09-13,3,0,9,21,0,2,1,1,0.64,0.5909,0.78,0.1642,45,675,200,2000,245,2675
6033,2011-09-13,3,0,9,22,0,2,1,1,0.64,0.5909,0.78,0.1343,24,360,120,1200,144,1560
6034,2011-09-13,3,0,9,23,0,2,1,1,0.64,0.5909,0.78,0.1045,15,225,59,590,74,815
6035,2011-09-14,3,0,9,0,0,3,1,1,0.62,0.5909,0.78,0.0896,5,75,28,280,33,355
6036,2011-09-14,3,0,9,1,0,3,1,1,0.62,0.5909,0.78,0.0896,1,15,7,70,8,85
6037,2011-09-14,3,0,9,2,0,3,1,1,0.6,0.5606,0.83,0.0,1,15,4,40,5,55
6038,2011-09-14,3,0,9,3,0,3,1,1,0.6,0.5455,0.88,0.1343,1,15,7,70,8,85
6039,2011-09-14,3,0,9,4,0,3,1,1,0.6,0.5606,0.83,0.0896,1,15,8,80,9,95
6040,2011-09-14,3,0,9,5,0,3,1,1,0.58,0.5455,0.88,0.1045,1,15,30,300,31,315
6041,2011-09-14,3,0,9,6,0,3,1,1,0.58,0.5455,0.88,0.1045,7,105,138,1380,145,1485
6042,2011-09-14,3,0,9,7,0,3,1,1,0.6,0.5606,0.83,0.1045,20,300,350,3500,370,3800
6043,2011-09-14,3,0,9,8,0,3,1,1,0.62,0.5758,0.83,0.1642,33,495,396,3960,429,4455
6044,2011-09-14,3,0,9,9,0,3,1,1,0.64,0.5909,0.78,0.1642,19,285,183,1830,202,2115
6045,2011-09-14,3,0,9,10,0,3,1,1,0.7,0.6515,0.7,0.1343,27,405,115,1150,142,1555
6046,2011-09-14,3,0,9,11,0,3,1,1,0.72,0.6818,0.66,0.1642,43,645,121,1210,164,1855
6047,2011-09-14,3,0,9,12,0,3,1,1,0.74,0.6818,0.58,0.2239,56,840,156,1560,212,2400
6048,2011-09-14,3,0,9,13,0,3,1,1,0.76,0.697,0.55,0.2537,39,585,139,1390,178,1975
6049,2011-09-14,3,0,9,14,0,3,1,1,0.78,0.7121,0.52,0.2239,19,285,105,1050,124,1335
6050,2011-09-14,3,0,9,15,0,3,1,1,0.78,0.7121,0.49,0.2537,30,450,146,1460,176,1910
6051,2011-09-14,3,0,9,16,0,3,1,1,0.76,0.697,0.52,0.2836,36,540,241,2410,277,2950
6052,2011-09-14,3,0,9,17,0,3,1,1,0.76,0.697,0.52,0.2836,87,1305,512,5120,599,6425
6053,2011-09-14,3,0,9,18,0,3,1,1,0.72,0.6818,0.62,0.1642,83,1245,503,5030,586,6275
6054,2011-09-14,3,0,9,19,0,3,1,2,0.7,0.6515,0.7,0.1045,44,660,337,3370,381,4030
6055,2011-09-14,3,0,9,20,0,3,1,2,0.72,0.6667,0.58,0.4179,40,600,221,2210,261,2810
6056,2011-09-14,3,0,9,21,0,3,1,2,0.66,0.6212,0.65,0.2239,24,360,189,1890,213,2250
6057,2011-09-14,3,0,9,22,0,3,1,2,0.66,0.6212,0.65,0.1343,20,300,140,1400,160,1700
6058,2011-09-14,3,0,9,23,0,3,1,2,0.64,0.6061,0.69,0.1045,10,150,62,620,72,770
6059,2011-09-15,3,0,9,0,0,4,1,1,0.64,0.6061,0.69,0.1343,3,45,34,340,37,385
6060,2011-09-15,3,0,9,1,0,4,1,1,0.64,0.6061,0.69,0.1642,0,0,20,200,20,200
6061,2011-09-15,3,0,9,2,0,4,1,1,0.62,0.5909,0.73,0.1045,0,0,5,50,5,50
6062,2011-09-15,3,0,9,3,0,4,1,1,0.62,0.5909,0.73,0.0896,3,45,5,50,8,95
6063,2011-09-15,3,0,9,4,0,4,1,1,0.6,0.5758,0.78,0.1045,2,30,5,50,7,80
6064,2011-09-15,3,0,9,5,0,4,1,1,0.6,0.5758,0.78,0.0,1,15,30,300,31,315
6065,2011-09-15,3,0,9,6,0,4,1,2,0.6,0.5606,0.83,0.2537,5,75,119,1190,124,1265
6066,2011-09-15,3,0,9,7,0,4,1,2,0.62,0.5909,0.78,0.194,17,255,321,3210,338,3465
6067,2011-09-15,3,0,9,8,0,4,1,1,0.64,0.6061,0.73,0.1343,27,405,364,3640,391,4045
6068,2011-09-15,3,0,9,9,0,4,1,2,0.64,0.6061,0.73,0.3582,23,345,186,1860,209,2205
6069,2011-09-15,3,0,9,10,0,4,1,2,0.66,0.6212,0.69,0.2537,25,375,96,960,121,1335
6070,2011-09-15,3,0,9,11,0,4,1,2,0.68,0.6364,0.65,0.1343,39,585,120,1200,159,1785
6071,2011-09-15,3,0,9,12,0,4,1,2,0.66,0.6212,0.69,0.2985,31,465,148,1480,179,1945
6072,2011-09-15,3,0,9,13,0,4,1,2,0.64,0.6061,0.65,0.2836,38,570,151,1510,189,2080
6073,2011-09-15,3,0,9,14,0,4,1,2,0.64,0.6061,0.65,0.4179,36,540,134,1340,170,1880
6074,2011-09-15,3,0,9,15,0,4,1,2,0.6,0.5909,0.69,0.4179,25,375,110,1100,135,1475
6075,2011-09-15,3,0,9,16,0,4,1,2,0.54,0.5152,0.77,0.4627,29,435,193,1930,222,2365
6076,2011-09-15,3,0,9,17,0,4,1,3,0.48,0.4697,0.82,0.4627,31,465,230,2300,261,2765
6077,2011-09-15,3,0,9,18,0,4,1,3,0.48,0.4697,0.67,0.6119,22,330,222,2220,244,2550
6078,2011-09-15,3,0,9,19,0,4,1,1,0.46,0.4545,0.67,0.4627,20,300,212,2120,232,2420
6079,2011-09-15,3,0,9,20,0,4,1,1,0.46,0.4545,0.63,0.3284,25,375,223,2230,248,2605
6080,2011-09-15,3,0,9,21,0,4,1,1,0.46,0.4545,0.63,0.3284,11,165,134,1340,145,1505
6081,2011-09-15,3,0,9,22,0,4,1,1,0.44,0.4394,0.67,0.2836,7,105,108,1080,115,1185
6082,2011-09-15,3,0,9,23,0,4,1,1,0.44,0.4394,0.67,0.2239,8,120,61,610,69,730
6083,2011-09-16,3,0,9,0,0,5,1,1,0.42,0.4242,0.71,0.2239,5,75,43,430,48,505
6084,2011-09-16,3,0,9,1,0,5,1,1,0.42,0.4242,0.67,0.194,7,105,19,190,26,295
6085,2011-09-16,3,0,9,2,0,5,1,1,0.4,0.4091,0.71,0.2836,3,45,7,70,10,115
6086,2011-09-16,3,0,9,3,0,5,1,1,0.4,0.4091,0.71,0.2537,2,30,4,40,6,70
6087,2011-09-16,3,0,9,4,0,5,1,1,0.4,0.4091,0.71,0.2836,1,15,3,30,4,45
6088,2011-09-16,3,0,9,5,0,5,1,1,0.38,0.3939,0.76,0.194,2,30,30,300,32,330
6089,2011-09-16,3,0,9,6,0,5,1,1,0.38,0.3939,0.71,0.2239,6,90,87,870,93,960
6090,2011-09-16,3,0,9,7,0,5,1,1,0.4,0.4091,0.71,0.2836,16,240,283,2830,299,3070
6091,2011-09-16,3,0,9,8,0,5,1,1,0.42,0.4242,0.67,0.2239,23,345,386,3860,409,4205
6092,2011-09-16,3,0,9,9,0,5,1,1,0.46,0.4545,0.55,0.2537,21,315,189,1890,210,2205
6093,2011-09-16,3,0,9,10,0,5,1,2,0.5,0.4848,0.51,0.2836,36,540,104,1040,140,1580
6094,2011-09-16,3,0,9,11,0,5,1,2,0.5,0.4848,0.51,0.1343,40,600,139,1390,179,1990
6095,2011-09-16,3,0,9,12,0,5,1,2,0.52,0.5,0.45,0.0,39,585,212,2120,251,2705
6096,2011-09-16,3,0,9,13,0,5,1,2,0.54,0.5152,0.42,0.0,55,825,168,1680,223,2505
6097,2011-09-16,3,0,9,14,0,5,1,2,0.54,0.5152,0.45,0.1642,49,735,176,1760,225,2495
6098,2011-09-16,3,0,9,15,0,5,1,2,0.54,0.5152,0.45,0.2239,38,570,165,1650,203,2220
6099,2011-09-16,3,0,9,16,0,5,1,2,0.52,0.5,0.48,0.1642,67,1005,291,2910,358,3915
6100,2011-09-16,3,0,9,17,0,5,1,2,0.52,0.5,0.48,0.1343,86,1290,480,4800,566,6090
6101,2011-09-16,3,0,9,18,0,5,1,2,0.52,0.5,0.52,0.1642,55,825,427,4270,482,5095
6102,2011-09-16,3,0,9,19,0,5,1,2,0.5,0.4848,0.55,0.1642,59,885,256,2560,315,3445
6103,2011-09-16,3,0,9,20,0,5,1,2,0.5,0.4848,0.55,0.0,41,615,184,1840,225,2455
6104,2011-09-16,3,0,9,21,0,5,1,2,0.5,0.4848,0.63,0.0,39,585,124,1240,163,1825
6105,2011-09-16,3,0,9,22,0,5,1,1,0.48,0.4697,0.67,0.0896,32,480,135,1350,167,1830
6106,2011-09-16,3,0,9,23,0,5,1,1,0.5,0.4848,0.59,0.0,20,300,106,1060,126,1360
6107,2011-09-17,3,0,9,0,0,6,0,1,0.46,0.4545,0.72,0.1642,28,420,80,800,108,1220
6108,2011-09-17,3,0,9,1,0,6,0,1,0.46,0.4545,0.72,0.1045,28,420,52,520,80,940
6109,2011-09-17,3,0,9,2,0,6,0,1,0.46,0.4545,0.82,0.0896,18,270,61,610,79,880
6110,2011-09-17,3,0,9,3,0,6,0,1,0.46,0.4545,0.72,0.1343,7,105,21,210,28,315
6111,2011-09-17,3,0,9,4,0,6,0,1,0.46,0.4545,0.72,0.1343,1,15,4,40,5,55
6112,2011-09-17,3,0,9,5,0,6,0,1,0.46,0.4545,0.72,0.1642,2,30,3,30,5,60
6113,2011-09-17,3,0,9,6,0,6,0,2,0.46,0.4545,0.72,0.2239,5,75,17,170,22,245
6114,2011-09-17,3,0,9,7,0,6,0,2,0.46,0.4545,0.77,0.194,4,60,33,330,37,390
6115,2011-09-17,3,0,9,8,0,6,0,2,0.46,0.4545,0.77,0.2537,27,405,81,810,108,1215
6116,2011-09-17,3,0,9,9,0,6,0,2,0.48,0.4697,0.67,0.2239,32,480,145,1450,177,1930
6117,2011-09-17,3,0,9,10,0,6,0,2,0.5,0.4848,0.68,0.2836,72,1080,177,1770,249,2850
6118,2011-09-17,3,0,9,11,0,6,0,2,0.52,0.5,0.68,0.2239,119,1785,248,2480,367,4265
6119,2011-09-17,3,0,9,12,0,6,0,2,0.52,0.5,0.67,0.2239,115,1725,257,2570,372,4295
6120,2011-09-17,3,0,9,13,0,6,0,2,0.52,0.5,0.68,0.194,124,1860,225,2250,349,4110
6121,2011-09-17,3,0,9,14,0,6,0,2,0.52,0.5,0.72,0.194,123,1845,174,1740,297,3585
6122,2011-09-17,3,0,9,15,0,6,0,2,0.52,0.5,0.72,0.194,148,2220,206,2060,354,4280
6123,2011-09-17,3,0,9,16,0,6,0,1,0.54,0.5152,0.68,0.2537,116,1740,189,1890,305,3630
6124,2011-09-17,3,0,9,17,0,6,0,1,0.52,0.5,0.72,0.2239,141,2115,218,2180,359,4295
6125,2011-09-17,3,0,9,18,0,6,0,2,0.52,0.5,0.72,0.2239,95,1425,234,2340,329,3765
6126,2011-09-17,3,0,9,19,0,6,0,1,0.52,0.5,0.68,0.1343,70,1050,186,1860,256,2910
6127,2011-09-17,3,0,9,20,0,6,0,1,0.52,0.5,0.68,0.1343,43,645,133,1330,176,1975
6128,2011-09-17,3,0,9,21,0,6,0,2,0.5,0.4848,0.72,0.194,49,735,121,1210,170,1945
6129,2011-09-17,3,0,9,22,0,6,0,1,0.5,0.4848,0.72,0.2239,31,465,112,1120,143,1585
6130,2011-09-17,3,0,9,23,0,6,0,1,0.46,0.4545,0.82,0.1642,36,540,100,1000,136,1540
6131,2011-09-18,3,0,9,0,0,0,0,1,0.46,0.4545,0.77,0.2239,24,360,88,880,112,1240
6132,2011-09-18,3,0,9,1,0,0,0,1,0.46,0.4545,0.77,0.2239,13,195,66,660,79,855
6133,2011-09-18,3,0,9,2,0,0,0,1,0.44,0.4394,0.82,0.2537,21,315,68,680,89,995
6134,2011-09-18,3,0,9,3,0,0,0,1,0.44,0.4394,0.82,0.194,11,165,25,250,36,415
6135,2011-09-18,3,0,9,4,0,0,0,1,0.44,0.4394,0.77,0.2239,1,15,0,0,1,15
6136,2011-09-18,3,0,9,5,0,0,0,1,0.44,0.4394,0.77,0.2239,1,15,5,50,6,65
6137,2011-09-18,3,0,9,6,0,0,0,1,0.44,0.4394,0.77,0.2537,2,30,10,100,12,130
6138,2011-09-18,3,0,9,7,0,0,0,1,0.46,0.4545,0.72,0.2239,15,225,29,290,44,515
6139,2011-09-18,3,0,9,8,0,0,0,1,0.46,0.4545,0.72,0.2537,16,240,53,530,69,770
6140,2011-09-18,3,0,9,9,0,0,0,1,0.48,0.4697,0.67,0.2537,46,690,94,940,140,1630
6141,2011-09-18,3,0,9,10,0,0,0,1,0.5,0.4848,0.72,0.1642,82,1230,178,1780,260,3010
6142,2011-09-18,3,0,9,11,0,0,0,1,0.52,0.5,0.68,0.2239,116,1740,201,2010,317,3750
6143,2011-09-18,3,0,9,12,0,0,0,1,0.54,0.5152,0.64,0.1343,135,2025,229,2290,364,4315
6144,2011-09-18,3,0,9,13,0,0,0,1,0.56,0.5303,0.6,0.1343,162,2430,214,2140,376,4570
6145,2011-09-18,3,0,9,14,0,0,0,2,0.58,0.5455,0.56,0.1343,127,1905,184,1840,311,3745
6146,2011-09-18,3,0,9,15,0,0,0,2,0.58,0.5455,0.6,0.1343,132,1980,233,2330,365,4310
6147,2011-09-18,3,0,9,16,0,0,0,2,0.56,0.5303,0.64,0.1642,134,2010,235,2350,369,4360
6148,2011-09-18,3,0,9,17,0,0,0,2,0.56,0.5303,0.64,0.194,95,1425,230,2300,325,3725
6149,2011-09-18,3,0,9,18,0,0,0,2,0.56,0.5303,0.6,0.1045,66,990,223,2230,289,3220
6150,2011-09-18,3,0,9,19,0,0,0,2,0.54,0.5152,0.68,0.1045,54,810,191,1910,245,2720
6151,2011-09-18,3,0,9,20,0,0,0,2,0.54,0.5152,0.68,0.0896,44,660,136,1360,180,2020
6152,2011-09-18,3,0,9,21,0,0,0,2,0.54,0.5152,0.68,0.0896,37,555,110,1100,147,1655
6153,2011-09-18,3,0,9,22,0,0,0,2,0.54,0.5152,0.68,0.0896,9,135,75,750,84,885
6154,2011-09-18,3,0,9,23,0,0,0,1,0.54,0.5152,0.68,0.194,10,150,44,440,54,590
6155,2011-09-19,3,0,9,0,0,1,1,2,0.52,0.5,0.72,0.1642,14,210,23,230,37,440
6156,2011-09-19,3,0,9,1,0,1,1,2,0.52,0.5,0.72,0.1045,3,45,7,70,10,115
6157,2011-09-19,3,0,9,2,0,1,1,2,0.52,0.5,0.72,0.1343,6,90,7,70,13,160
6158,2011-09-19,3,0,9,3,0,1,1,2,0.5,0.4848,0.77,0.1343,1,15,4,40,5,55
6159,2011-09-19,3,0,9,4,0,1,1,2,0.5,0.4848,0.77,0.1642,2,30,6,60,8,90
6160,2011-09-19,3,0,9,5,0,1,1,2,0.5,0.4848,0.77,0.194,2,30,26,260,28,290
6161,2011-09-19,3,0,9,6,0,1,1,1,0.5,0.4848,0.77,0.2239,6,90,107,1070,113,1160
6162,2011-09-19,3,0,9,7,0,1,1,2,0.5,0.4848,0.82,0.2239,20,300,312,3120,332,3420
6163,2011-09-19,3,0,9,8,0,1,1,2,0.52,0.5,0.77,0.1343,29,435,391,3910,420,4345
6164,2011-09-19,3,0,9,9,0,1,1,2,0.54,0.5152,0.68,0.1642,32,480,183,1830,215,2310
6165,2011-09-19,3,0,9,10,0,1,1,2,0.56,0.5303,0.64,0.1343,21,315,84,840,105,1155
6166,2011-09-19,3,0,9,11,0,1,1,2,0.58,0.5455,0.64,0.1642,41,615,98,980,139,1595
6167,2011-09-19,3,0,9,12,0,1,1,2,0.58,0.5455,0.6,0.0896,51,765,138,1380,189,2145
6168,2011-09-19,3,0,9,13,0,1,1,2,0.6,0.6061,0.6,0.0,53,795,124,1240,177,2035
6169,2011-09-19,3,0,9,14,0,1,1,2,0.6,0.6061,0.6,0.194,45,675,143,1430,188,2105
6170,2011-09-19,3,0,9,15,0,1,1,2,0.6,0.6061,0.6,0.2239,44,660,143,1430,187,2090
6171,2011-09-19,3,0,9,16,0,1,1,2,0.6,0.6061,0.6,0.1642,55,825,208,2080,263,2905
6172,2011-09-19,3,0,9,17,0,1,1,2,0.58,0.5455,0.64,0.1343,85,1275,483,4830,568,6105
6173,2011-09-19,3,0,9,18,0,1,1,2,0.56,0.5303,0.68,0.1343,56,840,484,4840,540,5680
6174,2011-09-19,3,0,9,19,0,1,1,2,0.56,0.5303,0.68,0.1045,41,615,333,3330,374,3945
6175,2011-09-19,3,0,9,20,0,1,1,2,0.56,0.5303,0.68,0.1343,27,405,204,2040,231,2445
6176,2011-09-19,3,0,9,21,0,1,1,2,0.56,0.5303,0.68,0.1642,19,285,181,1810,200,2095
6177,2011-09-19,3,0,9,22,0,1,1,2,0.56,0.5303,0.68,0.1642,25,375,104,1040,129,1415
6178,2011-09-19,3,0,9,23,0,1,1,2,0.56,0.5303,0.73,0.194,13,195,55,550,68,745
6179,2011-09-20,3,0,9,0,0,2,1,2,0.56,0.5303,0.73,0.1642,4,60,21,210,25,270
6180,2011-09-20,3,0,9,1,0,2,1,2,0.54,0.5152,0.88,0.1642,3,45,11,110,14,155
6181,2011-09-20,3,0,9,2,0,2,1,2,0.54,0.5152,0.88,0.1642,1,15,4,40,5,55
6182,2011-09-20,3,0,9,3,0,2,1,2,0.54,0.5152,0.83,0.2239,0,0,3,30,3,30
6183,2011-09-20,3,0,9,4,0,2,1,1,0.54,0.5152,0.88,0.194,2,30,4,40,6,70
6184,2011-09-20,3,0,9,5,0,2,1,2,0.54,0.5152,0.88,0.194,1,15,21,210,22,225
6185,2011-09-20,3,0,9,6,0,2,1,2,0.54,0.5152,0.88,0.194,3,45,111,1110,114,1155
6186,2011-09-20,3,0,9,7,0,2,1,2,0.54,0.5152,0.88,0.1642,23,345,306,3060,329,3405
6187,2011-09-20,3,0,9,8,0,2,1,3,0.54,0.5152,0.94,0.2537,13,195,196,1960,209,2155
6188,2011-09-20,3,0,9,9,0,2,1,3,0.54,0.5152,0.94,0.2239,5,75,64,640,69,715
6189,2011-09-20,3,0,9,10,0,2,1,3,0.56,0.5303,0.88,0.1642,4,60,26,260,30,320
6190,2011-09-20,3,0,9,11,0,2,1,3,0.56,0.5303,0.88,0.1642,8,120,48,480,56,600
6191,2011-09-20,3,0,9,12,0,2,1,2,0.56,0.5303,0.94,0.1642,13,195,47,470,60,665
6192,2011-09-20,3,0,9,13,0,2,1,2,0.56,0.5303,0.94,0.1343,22,330,81,810,103,1140
6193,2011-09-20,3,0,9,14,0,2,1,2,0.58,0.5455,0.88,0.194,27,405,85,850,112,1255
6194,2011-09-20,3,0,9,15,0,2,1,2,0.62,0.5909,0.78,0.1045,34,510,158,1580,192,2090
6195,2011-09-20,3,0,9,16,0,2,1,2,0.6,0.5606,0.83,0.1642,23,345,241,2410,264,2755
6196,2011-09-20,3,0,9,17,0,2,1,1,0.6,0.5606,0.83,0.1045,66,990,445,4450,511,5440
6197,2011-09-20,3,0,9,18,0,2,1,1,0.6,0.5606,0.83,0.1045,39,585,453,4530,492,5115
6198,2011-09-20,3,0,9,19,0,2,1,1,0.58,0.5455,0.88,0.0,43,645,294,2940,337,3585
6199,2011-09-20,3,0,9,20,0,2,1,1,0.56,0.5303,0.94,0.0,41,615,212,2120,253,2735
6200,2011-09-20,3,0,9,21,0,2,1,1,0.56,0.5303,0.94,0.0,29,435,177,1770,206,2205
6201,2011-09-20,3,0,9,22,0,2,1,1,0.56,0.5303,0.94,0.0,23,345,125,1250,148,1595
6202,2011-09-20,3,0,9,23,0,2,1,1,0.56,0.5303,0.94,0.0,11,165,70,700,81,865
6203,2011-09-21,3,0,9,0,0,3,1,1,0.54,0.5152,1.0,0.0,7,105,20,200,27,305
6204,2011-09-21,3,0,9,1,0,3,1,1,0.54,0.5152,0.94,0.0,0,0,17,170,17,170
6205,2011-09-21,3,0,9,2,0,3,1,1,0.54,0.5152,0.94,0.0,1,15,5,50,6,65
6206,2011-09-21,3,0,9,3,0,3,1,2,0.54,0.5152,0.94,0.0896,0,0,6,60,6,60
6207,2011-09-21,3,0,9,4,0,3,1,2,0.54,0.5152,1.0,0.1343,2,30,5,50,7,80
6208,2011-09-21,3,0,9,5,0,3,1,2,0.54,0.5152,1.0,0.1642,1,15,30,300,31,315
6209,2011-09-21,3,0,9,6,0,3,1,2,0.54,0.5152,1.0,0.194,5,75,112,1120,117,1195
6210,2011-09-21,3,0,9,7,0,3,1,2,0.54,0.5152,1.0,0.194,18,270,312,3120,330,3390
6211,2011-09-21,3,0,9,8,0,3,1,2,0.54,0.5152,1.0,0.1045,18,270,444,4440,462,4710
6212,2011-09-21,3,0,9,9,0,3,1,2,0.56,0.5303,1.0,0.0896,21,315,187,1870,208,2185
6213,2011-09-21,3,0,9,10,0,3,1,2,0.6,0.5455,0.88,0.0,30,450,103,1030,133,1480
6214,2011-09-21,3,0,9,11,0,3,1,2,0.62,0.5758,0.83,0.1642,42,630,138,1380,180,2010
6215,2011-09-21,3,0,9,12,0,3,1,2,0.64,0.5909,0.78,0.0896,42,630,151,1510,193,2140
6216,2011-09-21,3,0,9,13,0,3,1,2,0.66,0.6212,0.74,0.1642,37,555,144,1440,181,1995
6217,2011-09-21,3,0,9,14,0,3,1,2,0.66,0.6212,0.74,0.194,40,600,139,1390,179,1990
6218,2011-09-21,3,0,9,15,0,3,1,2,0.66,0.6212,0.74,0.1045,43,645,142,1420,185,2065
6219,2011-09-21,3,0,9,16,0,3,1,2,0.66,0.6212,0.74,0.1045,51,765,230,2300,281,3065
6220,2011-09-21,3,0,9,17,0,3,1,3,0.66,0.6212,0.74,0.1642,61,915,475,4750,536,5665
6221,2011-09-21,3,0,9,18,0,3,1,3,0.64,0.5758,0.83,0.1642,24,360,384,3840,408,4200
6222,2011-09-21,3,0,9,19,0,3,1,3,0.62,0.5455,0.94,0.0,30,450,253,2530,283,2980
6223,2011-09-21,3,0,9,20,0,3,1,3,0.62,0.5455,0.94,0.0,11,165,149,1490,160,1655
6224,2011-09-21,3,0,9,21,0,3,1,2,0.6,0.5,1.0,0.0896,25,375,175,1750,200,2125
6225,2011-09-21,3,0,9,22,0,3,1,2,0.62,0.5455,0.94,0.0,15,225,112,1120,127,1345
6226,2011-09-21,3,0,9,23,0,3,1,1,0.6,0.5152,0.94,0.1045,15,225,80,800,95,1025
6227,2011-09-22,3,0,9,0,0,4,1,1,0.6,0.5152,0.94,0.1045,11,165,30,300,41,465
6228,2011-09-22,3,0,9,1,0,4,1,2,0.6,0.5152,0.94,0.0896,5,75,6,60,11,135
6229,2011-09-22,3,0,9,2,0,4,1,2,0.6,0.5152,0.94,0.1045,2,30,8,80,10,110
6230,2011-09-22,3,0,9,3,0,4,1,2,0.6,0.5152,0.94,0.0896,5,75,7,70,12,145
6231,2011-09-22,3,0,9,4,0,4,1,2,0.6,0.5152,0.94,0.0896,0,0,2,20,2,20
6232,2011-09-22,3,0,9,5,0,4,1,2,0.6,0.5152,0.94,0.1045,2,30,28,280,30,310
6233,2011-09-22,3,0,9,6,0,4,1,2,0.6,0.5,1.0,0.1343,7,105,94,940,101,1045
6234,2011-09-22,3,0,9,7,0,4,1,2,0.6,0.5,1.0,0.1045,16,240,295,2950,311,3190
6235,2011-09-22,3,0,9,8,0,4,1,2,0.6,0.5,1.0,0.1642,26,390,389,3890,415,4280
6236,2011-09-22,3,0,9,9,0,4,1,2,0.62,0.5455,0.94,0.194,35,525,168,1680,203,2205
6237,2011-09-22,3,0,9,10,0,4,1,2,0.64,0.5758,0.89,0.2239,19,285,101,1010,120,1295
6238,2011-09-22,3,0,9,11,0,4,1,2,0.64,0.5758,0.89,0.194,23,345,142,1420,165,1765
6239,2011-09-22,3,0,9,12,0,4,1,2,0.66,0.6061,0.83,0.1642,25,375,151,1510,176,1885
6240,2011-09-22,3,0,9,13,0,4,1,2,0.66,0.6061,0.83,0.194,38,570,155,1550,193,2120
6241,2011-09-22,3,0,9,14,0,4,1,2,0.66,0.6061,0.83,0.2239,41,615,142,1420,183,2035
6242,2011-09-22,3,0,9,15,0,4,1,2,0.68,0.6364,0.79,0.1642,32,480,149,1490,181,1970
6243,2011-09-22,3,0,9,16,0,4,1,2,0.68,0.6364,0.74,0.1343,39,585,262,2620,301,3205
6244,2011-09-22,3,0,9,17,0,4,1,2,0.66,0.6061,0.78,0.0896,50,750,513,5130,563,5880
6245,2011-09-22,3,0,9,18,0,4,1,2,0.64,0.5758,0.83,0.1045,50,750,501,5010,551,5760
6246,2011-09-22,3,0,9,19,0,4,1,2,0.64,0.5758,0.89,0.0896,32,480,388,3880,420,4360
6247,2011-09-22,3,0,9,20,0,4,1,2,0.62,0.5455,0.94,0.1343,35,525,250,2500,285,3025
6248,2011-09-22,3,0,9,21,0,4,1,2,0.64,0.5758,0.89,0.0896,27,405,194,1940,221,2345
6249,2011-09-22,3,0,9,22,0,4,1,2,0.62,0.5152,1.0,0.0896,21,315,166,1660,187,1975
6250,2011-09-22,3,0,9,23,0,4,1,2,0.62,0.5455,0.94,0.0,14,210,99,990,113,1200
6251,2011-09-23,4,0,9,0,0,5,1,2,0.62,0.5455,0.94,0.0896,11,165,41,410,52,575
6252,2011-09-23,4,0,9,1,0,5,1,2,0.6,0.5,1.0,0.0,2,30,29,290,31,320
6253,2011-09-23,4,0,9,2,0,5,1,2,0.6,0.5,1.0,0.1045,6,90,14,140,20,230
6254,2011-09-23,4,0,9,3,0,5,1,2,0.6,0.5,1.0,0.0,3,45,5,50,8,95
6255,2011-09-23,4,0,9,4,0,5,1,3,0.6,0.5,1.0,0.0,6,90,7,70,13,160
6256,2011-09-23,4,0,9,5,0,5,1,2,0.62,0.5455,0.94,0.0,2,30,20,200,22,230
6257,2011-09-23,4,0,9,6,0,5,1,2,0.62,0.5455,0.94,0.0896,5,75,99,990,104,1065
6258,2011-09-23,4,0,9,7,0,5,1,3,0.62,0.5455,0.94,0.1343,14,210,240,2400,254,2610
6259,2011-09-23,4,0,9,8,0,5,1,3,0.62,0.5455,0.94,0.1343,20,300,297,2970,317,3270
6260,2011-09-23,4,0,9,9,0,5,1,3,0.62,0.5152,1.0,0.1343,3,45,108,1080,111,1125
6261,2011-09-23,4,0,9,10,0,5,1,3,0.62,0.5152,1.0,0.1045,7,105,28,280,35,385
6262,2011-09-23,4,0,9,11,0,5,1,3,0.62,0.5152,1.0,0.1045,1,15,20,200,21,215
6263,2011-09-23,4,0,9,12,0,5,1,3,0.62,0.5455,0.94,0.1045,1,15,28,280,29,295
6264,2011-09-23,4,0,9,13,0,5,1,3,0.6,0.5,1.0,0.0896,7,105,27,270,34,375
6265,2011-09-23,4,0,9,14,0,5,1,3,0.6,0.5,1.0,0.0896,3,45,21,210,24,255
6266,2011-09-23,4,0,9,15,0,5,1,3,0.62,0.5455,0.94,0.1045,9,135,52,520,61,655
6267,2011-09-23,4,0,9,16,0,5,1,3,0.62,0.5455,0.94,0.0,5,75,51,510,56,585
6268,2011-09-23,4,0,9,17,0,5,1,2,0.6,0.5,1.0,0.0,13,195,86,860,99,1055
6269,2011-09-23,4,0,9,18,0,5,1,1,0.6,0.5,1.0,0.0,14,210,220,2200,234,2410
6270,2011-09-23,4,0,9,19,0,5,1,1,0.62,0.5455,0.94,0.1343,16,240,232,2320,248,2560
6271,2011-09-23,4,0,9,20,0,5,1,1,0.6,0.5152,0.94,0.0,21,315,158,1580,179,1895
6272,2011-09-23,4,0,9,21,0,5,1,1,0.6,0.5,1.0,0.1642,17,255,121,1210,138,1465
6273,2011-09-23,4,0,9,22,0,5,1,1,0.6,0.5152,0.94,0.1642,31,465,126,1260,157,1725
6274,2011-09-23,4,0,9,23,0,5,1,2,0.58,0.5455,1.0,0.1343,41,615,107,1070,148,1685
6275,2011-09-24,4,0,9,0,0,6,0,1,0.58,0.5455,1.0,0.0896,7,105,86,860,93,965
6276,2011-09-24,4,0,9,1,0,6,0,2,0.58,0.5455,0.94,0.0896,18,270,61,610,79,880
6277,2011-09-24,4,0,9,2,0,6,0,2,0.58,0.5455,0.94,0.0896,14,210,54,540,68,750
6278,2011-09-24,4,0,9,3,0,6,0,1,0.58,0.5455,0.94,0.0,4,60,27,270,31,330
6279,2011-09-24,4,0,9,4,0,6,0,1,0.56,0.5303,0.94,0.1045,1,15,7,70,8,85
6280,2011-09-24,4,0,9,5,0,6,0,2,0.56,0.5303,0.94,0.1045,2,30,3,30,5,60
6281,2011-09-24,4,0,9,6,0,6,0,2,0.56,0.5303,0.94,0.1045,6,90,12,120,18,210
6282,2011-09-24,4,0,9,7,0,6,0,2,0.56,0.5303,0.88,0.1045,12,180,34,340,46,520
6283,2011-09-24,4,0,9,8,0,6,0,2,0.58,0.5455,0.9,0.0896,19,285,102,1020,121,1305
6284,2011-09-24,4,0,9,9,0,6,0,2,0.6,0.5455,0.88,0.0896,41,615,134,1340,175,1955
6285,2011-09-24,4,0,9,10,0,6,0,2,0.6,0.5455,0.88,0.0896,90,1350,203,2030,293,3380
6286,2011-09-24,4,0,9,11,0,6,0,2,0.62,0.5758,0.83,0.0896,118,1770,268,2680,386,4450
6287,2011-09-24,4,0,9,12,0,6,0,2,0.62,0.5758,0.83,0.0896,141,2115,266,2660,407,4775
6288,2011-09-24,4,0,9,13,0,6,0,1,0.64,0.5909,0.78,0.0,170,2550,290,2900,460,5450
6289,2011-09-24,4,0,9,14,0,6,0,2,0.66,0.6212,0.74,0.1343,164,2460,226,2260,390,4720
6290,2011-09-24,4,0,9,15,0,6,0,2,0.66,0.6212,0.74,0.1343,168,2520,284,2840,452,5360
6291,2011-09-24,4,0,9,16,0,6,0,2,0.64,0.5909,0.78,0.0896,167,2505,282,2820,449,5325
6292,2011-09-24,4,0,9,17,0,6,0,1,0.66,0.6212,0.74,0.1045,180,2700,246,2460,426,5160
6293,2011-09-24,4,0,9,18,0,6,0,1,0.64,0.5909,0.78,0.1045,157,2355,243,2430,400,4785
6294,2011-09-24,4,0,9,19,0,6,0,1,0.62,0.5606,0.88,0.0,77,1155,231,2310,308,3465
6295,2011-09-24,4,0,9,20,0,6,0,1,0.62,0.5758,0.83,0.0,77,1155,166,1660,243,2815
6296,2011-09-24,4,0,9,21,0,6,0,1,0.62,0.5758,0.83,0.0896,66,990,156,1560,222,2550
6297,2011-09-24,4,0,9,22,0,6,0,2,0.62,0.5606,0.88,0.0,50,750,143,1430,193,2180
6298,2011-09-24,4,0,9,23,0,6,0,2,0.6,0.5455,0.88,0.0896,27,405,123,1230,150,1635
6299,2011-09-25,4,0,9,0,0,0,0,2,0.6,0.5455,0.88,0.0,37,555,136,1360,173,1915
6300,2011-09-25,4,0,9,1,0,0,0,2,0.6,0.5455,0.88,0.1045,31,465,93,930,124,1395
6301,2011-09-25,4,0,9,2,0,0,0,3,0.6,0.5152,0.94,0.0,27,405,79,790,106,1195
6302,2011-09-25,4,0,9,3,0,0,0,3,0.6,0.5152,0.94,0.0,20,300,39,390,59,690
6303,2011-09-25,4,0,9,4,0,0,0,3,0.6,0.5152,0.94,0.1343,3,45,5,50,8,95
6304,2011-09-25,4,0,9,5,0,0,0,1,0.6,0.5455,0.88,0.0896,1,15,2,20,3,35
6305,2011-09-25,4,0,9,6,0,0,0,2,0.6,0.5455,0.88,0.1045,4,60,13,130,17,190
6306,2011-09-25,4,0,9,7,0,0,0,2,0.6,0.5152,0.94,0.1343,15,225,23,230,38,455
6307,2011-09-25,4,0,9,8,0,0,0,2,0.62,0.5606,0.88,0.0,27,405,59,590,86,995
6308,2011-09-25,4,0,9,9,0,0,0,2,0.64,0.5758,0.83,0.0,55,825,100,1000,155,1825
6309,2011-09-25,4,0,9,10,0,0,0,2,0.64,0.5758,0.83,0.0,85,1275,190,1900,275,3175
6310,2011-09-25,4,0,9,11,0,0,0,2,0.66,0.6061,0.78,0.1343,131,1965,230,2300,361,4265
6311,2011-09-25,4,0,9,12,0,0,0,2,0.66,0.6061,0.78,0.0,143,2145,270,2700,413,4845
6312,2011-09-25,4,0,9,13,0,0,0,2,0.68,0.6364,0.74,0.0,122,1830,247,2470,369,4300
6313,2011-09-25,4,0,9,14,0,0,0,2,0.66,0.6061,0.78,0.0,116,1740,231,2310,347,4050
6314,2011-09-25,4,0,9,15,0,0,0,2,0.66,0.6061,0.78,0.0,119,1785,234,2340,353,4125
6315,2011-09-25,4,0,9,16,0,0,0,1,0.7,0.6515,0.7,0.0,144,2160,320,3200,464,5360
6316,2011-09-25,4,0,9,17,0,0,0,1,0.68,0.6364,0.74,0.0,145,2175,275,2750,420,4925
6317,2011-09-25,4,0,9,18,0,0,0,1,0.68,0.6364,0.74,0.0,125,1875,279,2790,404,4665
6318,2011-09-25,4,0,9,19,0,0,0,1,0.64,0.5758,0.83,0.1343,87,1305,242,2420,329,3725
6319,2011-09-25,4,0,9,20,0,0,0,1,0.64,0.5758,0.83,0.0896,51,765,135,1350,186,2115
6320,2011-09-25,4,0,9,21,0,0,0,1,0.62,0.5455,0.94,0.0896,24,360,113,1130,137,1490
6321,2011-09-25,4,0,9,22,0,0,0,1,0.62,0.5606,0.88,0.0896,20,300,84,840,104,1140
6322,2011-09-25,4,0,9,23,0,0,0,2,0.62,0.5455,0.94,0.1045,12,180,67,670,79,850
6323,2011-09-26,4,0,9,0,0,1,1,2,0.62,0.5455,0.94,0.0,6,90,23,230,29,320
6324,2011-09-26,4,0,9,1,0,1,1,2,0.62,0.5606,0.88,0.1045,3,45,14,140,17,185
6325,2011-09-26,4,0,9,2,0,1,1,2,0.62,0.5606,0.88,0.1045,4,60,4,40,8,100
6326,2011-09-26,4,0,9,3,0,1,1,2,0.62,0.5455,0.94,0.0,0,0,5,50,5,50
6327,2011-09-26,4,0,9,4,0,1,1,2,0.62,0.5455,0.94,0.0896,2,30,4,40,6,70
6328,2011-09-26,4,0,9,5,0,1,1,2,0.62,0.5606,0.88,0.0,0,0,25,250,25,250
6329,2011-09-26,4,0,9,6,0,1,1,2,0.62,0.5455,0.94,0.0896,6,90,107,1070,113,1160
6330,2011-09-26,4,0,9,7,0,1,1,2,0.62,0.5455,0.94,0.0,17,255,315,3150,332,3405
6331,2011-09-26,4,0,9,8,0,1,1,2,0.62,0.5455,0.94,0.0,29,435,326,3260,355,3695
6332,2011-09-26,4,0,9,9,0,1,1,2,0.64,0.5758,0.89,0.194,44,660,161,1610,205,2270
6333,2011-09-26,4,0,9,10,0,1,1,2,0.64,0.5758,0.89,0.194,37,555,117,1170,154,1725
6334,2011-09-26,4,0,9,11,0,1,1,1,0.68,0.6364,0.79,0.2239,43,645,116,1160,159,1805
6335,2011-09-26,4,0,9,12,0,1,1,2,0.68,0.6364,0.79,0.1642,48,720,161,1610,209,2330
6336,2011-09-26,4,0,9,13,0,1,1,2,0.7,0.6667,0.74,0.1642,48,720,139,1390,187,2110
6337,2011-09-26,4,0,9,14,0,1,1,1,0.7,0.6515,0.7,0.1642,44,660,110,1100,154,1760
6338,2011-09-26,4,0,9,15,0,1,1,1,0.72,0.6818,0.62,0.1343,52,780,157,1570,209,2350
6339,2011-09-26,4,0,9,16,0,1,1,1,0.7,0.6515,0.65,0.1642,74,1110,239,2390,313,3500
6340,2011-09-26,4,0,9,17,0,1,1,1,0.7,0.6515,0.7,0.1343,61,915,509,5090,570,6005
6341,2011-09-26,4,0,9,18,0,1,1,1,0.66,0.6061,0.83,0.1045,63,945,490,4900,553,5845
6342,2011-09-26,4,0,9,19,0,1,1,1,0.66,0.6061,0.82,0.0896,36,540,347,3470,383,4010
6343,2011-09-26,4,0,9,20,0,1,1,1,0.64,0.5758,0.89,0.1343,24,360,227,2270,251,2630
6344,2011-09-26,4,0,9,21,0,1,1,1,0.64,0.5758,0.89,0.1343,18,270,164,1640,182,1910
6345,2011-09-26,4,0,9,22,0,1,1,1,0.62,0.5455,0.94,0.1343,14,210,122,1220,136,1430
6346,2011-09-26,4,0,9,23,0,1,1,1,0.62,0.5455,0.94,0.1343,11,165,64,640,75,805
6347,2011-09-27,4,0,9,0,0,2,1,1,0.62,0.5455,0.94,0.1343,9,135,28,280,37,415
6348,2011-09-27,4,0,9,1,0,2,1,1,0.62,0.5455,0.94,0.1642,4,60,6,60,10,120
6349,2011-09-27,4,0,9,2,0,2,1,1,0.62,0.5455,0.94,0.1045,7,105,4,40,11,145
6350,2011-09-27,4,0,9,3,0,2,1,2,0.62,0.5455,0.94,0.0,5,75,5,50,10,125
6351,2011-09-27,4,0,9,4,0,2,1,3,0.62,0.5455,0.94,0.0896,5,75,3,30,8,105
6352,2011-09-27,4,0,9,5,0,2,1,3,0.62,0.5455,0.94,0.0896,0,0,24,240,24,240
6353,2011-09-27,4,0,9,6,0,2,1,2,0.62,0.5455,0.94,0.1045,8,120,116,1160,124,1280
6354,2011-09-27,4,0,9,7,0,2,1,2,0.62,0.5455,0.94,0.1045,15,225,234,2340,249,2565
6355,2011-09-27,4,0,9,8,0,2,1,2,0.64,0.5758,0.89,0.1045,27,405,400,4000,427,4405
6356,2011-09-27,4,0,9,9,0,2,1,3,0.64,0.5758,0.89,0.194,20,300,173,1730,193,2030
6357,2011-09-27,4,0,9,10,0,2,1,3,0.64,0.5606,0.94,0.1642,21,315,101,1010,122,1325
6358,2011-09-27,4,0,9,11,0,2,1,2,0.66,0.5909,0.89,0.1045,26,390,97,970,123,1360
6359,2011-09-27,4,0,9,12,0,2,1,2,0.66,0.5909,0.89,0.1343,33,495,129,1290,162,1785
6360,2011-09-27,4,0,9,13,0,2,1,2,0.7,0.6667,0.74,0.2239,29,435,122,1220,151,1655
6361,2011-09-27,4,0,9,14,0,2,1,2,0.68,0.6364,0.79,0.1045,29,435,123,1230,152,1665
6362,2011-09-27,4,0,9,15,0,2,1,2,0.68,0.6364,0.83,0.0896,35,525,170,1700,205,2225
6363,2011-09-27,4,0,9,16,0,2,1,2,0.66,0.6061,0.83,0.194,33,495,225,2250,258,2745
6364,2011-09-27,4,0,9,17,0,2,1,2,0.66,0.5909,0.89,0.194,50,750,480,4800,530,5550
6365,2011-09-27,4,0,9,18,0,2,1,2,0.64,0.5758,0.89,0.2239,31,465,325,3250,356,3715
6366,2011-09-27,4,0,9,19,0,2,1,2,0.64,0.5758,0.89,0.1343,26,390,294,2940,320,3330
6367,2011-09-27,4,0,9,20,0,2,1,1,0.62,0.5909,0.78,0.0,17,255,221,2210,238,2465
6368,2011-09-27,4,0,9,21,0,2,1,1,0.6,0.5606,0.83,0.0,17,255,179,1790,196,2045
6369,2011-09-27,4,0,9,22,0,2,1,1,0.6,0.5455,0.88,0.0896,19,285,102,1020,121,1305
6370,2011-09-27,4,0,9,23,0,2,1,1,0.6,0.5455,0.88,0.0896,11,165,82,820,93,985
6371,2011-09-28,4,0,9,0,0,3,1,1,0.6,0.5455,0.88,0.0,7,105,29,290,36,395
6372,2011-09-28,4,0,9,1,0,3,1,1,0.6,0.5455,0.88,0.0,1,15,13,130,14,145
6373,2011-09-28,4,0,9,2,0,3,1,1,0.6,0.5455,0.88,0.2537,0,0,9,90,9,90
6374,2011-09-28,4,0,9,3,0,3,1,2,0.6,0.5152,0.94,0.0896,0,0,3,30,3,30
6375,2011-09-28,4,0,9,4,0,3,1,1,0.6,0.5455,0.88,0.0,1,15,3,30,4,45
6376,2011-09-28,4,0,9,5,0,3,1,2,0.6,0.5152,0.94,0.0,2,30,20,200,22,230
6377,2011-09-28,4,0,9,6,0,3,1,3,0.6,0.5152,0.94,0.1642,3,45,111,1110,114,1155
6378,2011-09-28,4,0,9,7,0,3,1,3,0.6,0.5152,0.94,0.1642,8,120,177,1770,185,1890
6379,2011-09-28,4,0,9,8,0,3,1,3,0.62,0.5455,0.94,0.2239,17,255,270,2700,287,2955
6380,2011-09-28,4,0,9,9,0,3,1,3,0.62,0.5455,0.94,0.2239,14,210,141,1410,155,1620
6381,2011-09-28,4,0,9,10,0,3,1,2,0.62,0.5455,0.94,0.0,20,300,109,1090,129,1390
6382,2011-09-28,4,0,9,11,0,3,1,2,0.66,0.6061,0.83,0.1045,24,360,127,1270,151,1630
6383,2011-09-28,4,0,9,12,0,3,1,2,0.68,0.6364,0.79,0.0,25,375,159,1590,184,1965
6384,2011-09-28,4,0,9,13,0,3,1,1,0.7,0.6667,0.74,0.2537,24,360,138,1380,162,1740
6385,2011-09-28,4,0,9,14,0,3,1,1,0.72,0.6818,0.62,0.2537,25,375,145,1450,170,1825
6386,2011-09-28,4,0,9,15,0,3,1,1,0.7,0.6515,0.7,0.1343,35,525,146,1460,181,1985
6387,2011-09-28,4,0,9,16,0,3,1,1,0.7,0.6515,0.7,0.194,39,585,241,2410,280,2995
6388,2011-09-28,4,0,9,17,0,3,1,1,0.7,0.6515,0.7,0.2239,64,960,527,5270,591,6230
6389,2011-09-28,4,0,9,18,0,3,1,3,0.66,0.6061,0.83,0.2537,65,975,459,4590,524,5565
6390,2011-09-28,4,0,9,19,0,3,1,3,0.66,0.6061,0.83,0.2537,57,855,315,3150,372,4005
6391,2011-09-28,4,0,9,20,0,3,1,3,0.6,0.5606,0.83,0.2985,11,165,91,910,102,1075
6392,2011-09-28,4,0,9,21,0,3,1,3,0.6,0.5455,0.88,0.2537,7,105,67,670,74,775
6393,2011-09-28,4,0,9,22,0,3,1,1,0.6,0.5455,0.88,0.0896,19,285,68,680,87,965
6394,2011-09-28,4,0,9,23,0,3,1,1,0.6,0.5152,0.94,0.1343,12,180,59,590,71,770
6395,2011-09-29,4,0,9,0,0,4,1,1,0.6,0.5152,0.94,0.194,7,105,33,330,40,435
6396,2011-09-29,4,0,9,1,0,4,1,2,0.6,0.5,1.0,0.194,3,45,20,200,23,245
6397,2011-09-29,4,0,9,2,0,4,1,2,0.6,0.5,1.0,0.194,0,0,2,20,2,20
6398,2011-09-29,4,0,9,3,0,4,1,2,0.6,0.5152,0.94,0.194,0,0,8,80,8,80
6399,2011-09-29,4,0,9,4,0,4,1,2,0.6,0.5455,0.88,0.194,2,30,5,50,7,80
6400,2011-09-29,4,0,9,5,0,4,1,2,0.6,0.5455,0.88,0.1045,0,0,22,220,22,220
6401,2011-09-29,4,0,9,6,0,4,1,2,0.6,0.5455,0.88,0.0896,5,75,106,1060,111,1135
6402,2011-09-29,4,0,9,7,0,4,1,1,0.6,0.5455,0.88,0.1343,14,210,269,2690,283,2900
6403,2011-09-29,4,0,9,8,0,4,1,1,0.6,0.5606,0.83,0.0,29,435,402,4020,431,4455
6404,2011-09-29,4,0,9,9,0,4,1,1,0.62,0.5909,0.78,0.2537,27,405,198,1980,225,2385
6405,2011-09-29,4,0,9,10,0,4,1,1,0.64,0.6061,0.65,0.194,24,360,103,1030,127,1390
6406,2011-09-29,4,0,9,11,0,4,1,1,0.62,0.6061,0.61,0.194,36,540,122,1220,158,1760
6407,2011-09-29,4,0,9,12,0,4,1,1,0.66,0.6212,0.61,0.1642,38,570,157,1570,195,2140
6408,2011-09-29,4,0,9,13,0,4,1,1,0.64,0.6212,0.61,0.194,36,540,175,1750,211,2290
6409,2011-09-29,4,0,9,14,0,4,1,1,0.68,0.6364,0.51,0.2985,33,495,134,1340,167,1835
6410,2011-09-29,4,0,9,15,0,4,1,1,0.68,0.6364,0.45,0.3881,42,630,185,1850,227,2480
6411,2011-09-29,4,0,9,16,0,4,1,1,0.68,0.6364,0.41,0.3582,64,960,227,2270,291,3230
6412,2011-09-29,4,0,9,17,0,4,1,1,0.66,0.6212,0.47,0.2985,62,930,527,5270,589,6200
6413,2011-09-29,4,0,9,18,0,4,1,1,0.64,0.6212,0.41,0.2239,84,1260,500,5000,584,6260
6414,2011-09-29,4,0,9,19,0,4,1,1,0.62,0.6212,0.5,0.0896,36,540,348,3480,384,4020
6415,2011-09-29,4,0,9,20,0,4,1,1,0.6,0.6212,0.53,0.0896,39,585,234,2340,273,2925
6416,2011-09-29,4,0,9,21,0,4,1,1,0.58,0.5455,0.56,0.0,30,450,195,1950,225,2400
6417,2011-09-29,4,0,9,22,0,4,1,1,0.56,0.5303,0.68,0.0,25,375,150,1500,175,1875
6418,2011-09-29,4,0,9,23,0,4,1,1,0.52,0.5,0.77,0.1045,17,255,64,640,81,895
6419,2011-09-30,4,0,9,0,0,5,1,1,0.52,0.5,0.83,0.1045,7,105,53,530,60,635
6420,2011-09-30,4,0,9,1,0,5,1,1,0.52,0.5,0.77,0.0896,5,75,18,180,23,255
6421,2011-09-30,4,0,9,2,0,5,1,1,0.52,0.5,0.83,0.1045,6,90,9,90,15,180
6422,2011-09-30,4,0,9,3,0,5,1,1,0.52,0.5,0.83,0.1045,0,0,3,30,3,30
6423,2011-09-30,4,0,9,4,0,5,1,1,0.52,0.5,0.83,0.194,2,30,6,60,8,90
6424,2011-09-30,4,0,9,5,0,5,1,1,0.52,0.5,0.83,0.194,3,45,23,230,26,275
6425,2011-09-30,4,0,9,6,0,5,1,1,0.52,0.5,0.83,0.2239,0,0,98,980,98,980
6426,2011-09-30,4,0,9,7,0,5,1,1,0.52,0.5,0.83,0.2239,14,210,283,2830,297,3040
6427,2011-09-30,4,0,9,8,0,5,1,1,0.54,0.5152,0.77,0.1343,31,465,425,4250,456,4715
6428,2011-09-30,4,0,9,9,0,5,1,1,0.56,0.5303,0.73,0.194,23,345,214,2140,237,2485
6429,2011-09-30,4,0,9,10,0,5,1,1,0.6,0.6061,0.64,0.0,46,690,122,1220,168,1910
6430,2011-09-30,4,0,9,11,0,5,1,1,0.64,0.6212,0.57,0.0896,49,735,168,1680,217,2415
6431,2011-09-30,4,0,9,12,0,5,1,2,0.64,0.6212,0.57,0.194,59,885,195,1950,254,2835
6432,2011-09-30,4,0,9,13,0,5,1,2,0.66,0.6212,0.47,0.3284,72,1080,194,1940,266,3020
6433,2011-09-30,4,0,9,14,0,5,1,2,0.64,0.6212,0.47,0.2985,93,1395,173,1730,266,3125
6434,2011-09-30,4,0,9,15,0,5,1,1,0.64,0.6212,0.5,0.2836,52,780,193,1930,245,2710
6435,2011-09-30,4,0,9,16,0,5,1,1,0.62,0.6212,0.53,0.2239,62,930,298,2980,360,3910
6436,2011-09-30,4,0,9,17,0,5,1,1,0.62,0.6212,0.53,0.194,94,1410,497,4970,591,6380
6437,2011-09-30,4,0,9,18,0,5,1,1,0.58,0.5455,0.49,0.3582,62,930,449,4490,511,5420
6438,2011-09-30,4,0,9,19,0,5,1,1,0.54,0.5152,0.52,0.2836,42,630,332,3320,374,3950
6439,2011-09-30,4,0,9,20,0,5,1,1,0.54,0.5152,0.52,0.2836,28,420,202,2020,230,2440
6440,2011-09-30,4,0,9,21,0,5,1,1,0.52,0.5,0.55,0.194,27,405,179,1790,206,2195
6441,2011-09-30,4,0,9,22,0,5,1,1,0.52,0.5,0.55,0.3284,30,450,129,1290,159,1740
6442,2011-09-30,4,0,9,23,0,5,1,1,0.52,0.5,0.55,0.3284,23,345,109,1090,132,1435
6443,2011-10-01,4,0,10,0,0,6,0,1,0.5,0.4848,0.63,0.3881,24,360,106,1060,130,1420
6444,2011-10-01,4,0,10,1,0,6,0,1,0.48,0.4697,0.67,0.3284,11,165,47,470,58,635
6445,2011-10-01,4,0,10,2,0,6,0,1,0.46,0.4545,0.63,0.4179,21,315,46,460,67,775
6446,2011-10-01,4,0,10,3,0,6,0,1,0.46,0.4545,0.59,0.4179,8,120,17,170,25,290
6447,2011-10-01,4,0,10,4,0,6,0,1,0.44,0.4394,0.58,0.4179,2,30,6,60,8,90
6448,2011-10-01,4,0,10,5,0,6,0,2,0.44,0.4394,0.62,0.2985,1,15,4,40,5,55
6449,2011-10-01,4,0,10,6,0,6,0,1,0.42,0.4242,0.67,0.3284,4,60,15,150,19,210
6450,2011-10-01,4,0,10,7,0,6,0,3,0.42,0.4242,0.67,0.2537,6,90,30,300,36,390
6451,2011-10-01,4,0,10,8,0,6,0,2,0.4,0.4091,0.76,0.3284,9,135,58,580,67,715
6452,2011-10-01,4,0,10,9,0,6,0,3,0.4,0.4091,0.82,0.3582,17,255,112,1120,129,1375
6453,2011-10-01,4,0,10,10,0,6,0,3,0.4,0.4091,0.76,0.3582,21,315,100,1000,121,1315
6454,2011-10-01,4,0,10,11,0,6,0,3,0.38,0.3939,0.82,0.3284,30,450,102,1020,132,1470
6455,2011-10-01,4,0,10,12,0,6,0,2,0.4,0.4091,0.82,0.2537,28,420,130,1300,158,1720
6456,2011-10-01,4,0,10,13,0,6,0,2,0.4,0.4091,0.82,0.3284,27,405,98,980,125,1385
6457,2011-10-01,4,0,10,14,0,6,0,2,0.42,0.4242,0.71,0.3582,33,495,147,1470,180,1965
6458,2011-10-01,4,0,10,15,0,6,0,2,0.42,0.4242,0.71,0.2836,41,615,154,1540,195,2155
6459,2011-10-01,4,0,10,16,0,6,0,2,0.4,0.4091,0.76,0.2985,58,870,165,1650,223,2520
6460,2011-10-01,4,0,10,17,0,6,0,3,0.4,0.4091,0.76,0.194,58,870,170,1700,228,2570
6461,2011-10-01,4,0,10,18,0,6,0,3,0.38,0.3939,0.87,0.2239,23,345,117,1170,140,1515
6462,2011-10-01,4,0,10,19,0,6,0,2,0.38,0.3939,0.82,0.194,27,405,99,990,126,1395
6463,2011-10-01,4,0,10,20,0,6,0,3,0.36,0.3636,0.87,0.1045,8,120,58,580,66,700
6464,2011-10-01,4,0,10,21,0,6,0,3,0.36,0.3636,0.87,0.1045,3,45,53,530,56,575
6465,2011-10-01,4,0,10,22,0,6,0,2,0.36,0.3485,0.93,0.2239,12,180,58,580,70,760
6466,2011-10-01,4,0,10,23,0,6,0,3,0.36,0.3485,0.93,0.2239,8,120,57,570,65,690
6467,2011-10-02,4,0,10,0,0,0,0,3,0.36,0.3333,0.93,0.2985,4,60,43,430,47,490
6468,2011-10-02,4,0,10,1,0,0,0,3,0.34,0.3182,0.87,0.2537,1,15,23,230,24,245
6469,2011-10-02,4,0,10,2,0,0,0,3,0.34,0.303,0.87,0.2985,3,45,27,270,30,315
6470,2011-10-02,4,0,10,3,0,0,0,3,0.34,0.3182,0.87,0.2836,4,60,5,50,9,110
6471,2011-10-02,4,0,10,4,0,0,0,2,0.34,0.3182,0.87,0.2537,4,60,3,30,7,90
6472,2011-10-02,4,0,10,5,0,0,0,1,0.32,0.303,0.87,0.2836,0,0,7,70,7,70
6473,2011-10-02,4,0,10,6,0,0,0,1,0.32,0.3182,0.81,0.1642,2,30,13,130,15,160
6474,2011-10-02,4,0,10,7,0,0,0,1,0.34,0.3333,0.76,0.194,5,75,24,240,29,315
6475,2011-10-02,4,0,10,8,0,0,0,2,0.34,0.3333,0.76,0.194,14,210,50,500,64,710
6476,2011-10-02,4,0,10,9,0,0,0,1,0.36,0.3333,0.76,0.3582,19,285,96,960,115,1245
6477,2011-10-02,4,0,10,10,0,0,0,2,0.36,0.3333,0.71,0.2836,60,900,188,1880,248,2780
6478,2011-10-02,4,0,10,11,0,0,0,2,0.38,0.3939,0.66,0.2537,74,1110,218,2180,292,3290
6479,2011-10-02,4,0,10,12,0,0,0,2,0.4,0.4091,0.62,0.194,78,1170,243,2430,321,3600
6480,2011-10-02,4,0,10,13,0,0,0,3,0.4,0.4091,0.62,0.2239,84,1260,224,2240,308,3500
6481,2011-10-02,4,0,10,14,0,0,0,3,0.36,0.3485,0.81,0.1642,61,915,195,1950,256,2865
6482,2011-10-02,4,0,10,15,0,0,0,3,0.36,0.3333,0.81,0.2537,29,435,144,1440,173,1875
6483,2011-10-02,4,0,10,16,0,0,0,3,0.36,0.3485,0.87,0.194,44,660,162,1620,206,2280
6484,2011-10-02,4,0,10,17,0,0,0,3,0.36,0.3485,0.87,0.1642,32,480,135,1350,167,1830
6485,2011-10-02,4,0,10,18,0,0,0,2,0.36,0.3485,0.81,0.194,16,240,158,1580,174,1820
6486,2011-10-02,4,0,10,19,0,0,0,2,0.38,0.3939,0.76,0.1642,34,510,128,1280,162,1790
6487,2011-10-02,4,0,10,20,0,0,0,2,0.36,0.3333,0.76,0.2537,16,240,71,710,87,950
6488,2011-10-02,4,0,10,21,0,0,0,1,0.36,0.3485,0.71,0.2239,17,255,71,710,88,965
6489,2011-10-02,4,0,10,22,0,0,0,3,0.36,0.3636,0.81,0.0896,9,135,55,550,64,685
6490,2011-10-02,4,0,10,23,0,0,0,1,0.36,0.3636,0.81,0.0896,6,90,19,190,25,280
6491,2011-10-03,4,0,10,0,0,1,1,1,0.34,0.3485,0.87,0.1045,3,45,13,130,16,175
6492,2011-10-03,4,0,10,1,0,1,1,1,0.36,0.3636,0.81,0.0896,1,15,5,50,6,65
6493,2011-10-03,4,0,10,2,0,1,1,1,0.36,0.3636,0.76,0.1045,0,0,4,40,4,40
6494,2011-10-03,4,0,10,3,0,1,1,1,0.36,0.3788,0.81,0.0,1,15,6,60,7,75
6495,2011-10-03,4,0,10,4,0,1,1,1,0.34,0.3485,0.87,0.1045,2,30,6,60,8,90
6496,2011-10-03,4,0,10,5,0,1,1,2,0.36,0.3636,0.76,0.1045,4,60,17,170,21,230
6497,2011-10-03,4,0,10,6,0,1,1,2,0.36,0.3788,0.71,0.0,3,45,91,910,94,955
6498,2011-10-03,4,0,10,7,0,1,1,2,0.36,0.3485,0.71,0.1343,8,120,241,2410,249,2530
6499,2011-10-03,4,0,10,8,0,1,1,2,0.36,0.3636,0.71,0.1045,13,195,359,3590,372,3785
6500,2011-10-03,4,0,10,9,0,1,1,2,0.4,0.4091,0.66,0.0896,12,180,141,1410,153,1590
6501,2011-10-03,4,0,10,10,0,1,1,2,0.4,0.4091,0.66,0.1045,19,285,82,820,101,1105
6502,2011-10-03,4,0,10,11,0,1,1,2,0.4,0.4091,0.71,0.2239,26,390,100,1000,126,1390
6503,2011-10-03,4,0,10,12,0,1,1,2,0.4,0.4091,0.71,0.1343,29,435,118,1180,147,1615
6504,2011-10-03,4,0,10,13,0,1,1,3,0.42,0.4242,0.67,0.1642,16,240,102,1020,118,1260
6505,2011-10-03,4,0,10,14,0,1,1,3,0.4,0.4091,0.76,0.0,26,390,94,940,120,1330
6506,2011-10-03,4,0,10,15,0,1,1,3,0.4,0.4091,0.76,0.0,22,330,79,790,101,1120
6507,2011-10-03,4,0,10,16,0,1,1,2,0.4,0.4091,0.76,0.1045,16,240,202,2020,218,2260
6508,2011-10-03,4,0,10,17,0,1,1,2,0.4,0.4091,0.76,0.1642,40,600,455,4550,495,5150
6509,2011-10-03,4,0,10,18,0,1,1,2,0.4,0.4091,0.76,0.1642,28,420,384,3840,412,4260
6510,2011-10-03,4,0,10,19,0,1,1,1,0.4,0.4091,0.76,0.0,15,225,300,3000,315,3225
6511,2011-10-03,4,0,10,20,0,1,1,3,0.4,0.4091,0.82,0.0,13,195,191,1910,204,2105
6512,2011-10-03,4,0,10,21,0,1,1,2,0.4,0.4091,0.82,0.0,10,150,128,1280,138,1430
6513,2011-10-03,4,0,10,22,0,1,1,2,0.4,0.4091,0.82,0.0,12,180,79,790,91,970
6514,2011-10-03,4,0,10,23,0,1,1,2,0.4,0.4091,0.82,0.1045,11,165,43,430,54,595
6515,2011-10-04,4,0,10,0,0,2,1,2,0.4,0.4091,0.87,0.0896,5,75,22,220,27,295
6516,2011-10-04,4,0,10,1,0,2,1,2,0.4,0.4091,0.87,0.1045,1,15,8,80,9,95
6517,2011-10-04,4,0,10,2,0,2,1,2,0.4,0.4091,0.87,0.0,1,15,2,20,3,35
6518,2011-10-04,4,0,10,3,0,2,1,1,0.4,0.4091,0.82,0.1045,3,45,3,30,6,75
6519,2011-10-04,4,0,10,4,0,2,1,1,0.4,0.4091,0.82,0.0896,3,45,4,40,7,85
6520,2011-10-04,4,0,10,5,0,2,1,1,0.4,0.4091,0.82,0.1343,2,30,25,250,27,280
6521,2011-10-04,4,0,10,6,0,2,1,1,0.4,0.4091,0.82,0.1045,3,45,109,1090,112,1135
6522,2011-10-04,4,0,10,7,0,2,1,1,0.42,0.4242,0.82,0.2836,11,165,298,2980,309,3145
6523,2011-10-04,4,0,10,8,0,2,1,1,0.44,0.4394,0.77,0.2239,28,420,372,3720,400,4140
6524,2011-10-04,4,0,10,9,0,2,1,1,0.46,0.4545,0.67,0.2537,19,285,168,1680,187,1965
6525,2011-10-04,4,0,10,10,0,2,1,1,0.48,0.4697,0.67,0.2836,19,285,107,1070,126,1355
6526,2011-10-04,4,0,10,11,0,2,1,1,0.54,0.5152,0.64,0.2836,22,330,102,1020,124,1350
6527,2011-10-04,4,0,10,12,0,2,1,1,0.56,0.5303,0.56,0.2985,39,585,160,1600,199,2185
6528,2011-10-04,4,0,10,13,0,2,1,1,0.56,0.5303,0.56,0.2985,20,300,153,1530,173,1830
6529,2011-10-04,4,0,10,14,0,2,1,1,0.58,0.5455,0.53,0.2537,27,405,156,1560,183,1965
6530,2011-10-04,4,0,10,15,0,2,1,1,0.58,0.5455,0.56,0.2836,28,420,166,1660,194,2080
6531,2011-10-04,4,0,10,16,0,2,1,1,0.58,0.5455,0.56,0.3284,36,540,273,2730,309,3270
6532,2011-10-04,4,0,10,17,0,2,1,1,0.56,0.5303,0.6,0.3881,55,825,530,5300,585,6125
6533,2011-10-04,4,0,10,18,0,2,1,1,0.54,0.5152,0.64,0.2836,68,1020,456,4560,524,5580
6534,2011-10-04,4,0,10,19,0,2,1,1,0.52,0.5,0.68,0.2239,35,525,310,3100,345,3625
6535,2011-10-04,4,0,10,20,0,2,1,1,0.52,0.5,0.68,0.2239,25,375,236,2360,261,2735
6536,2011-10-04,4,0,10,21,0,2,1,1,0.5,0.4848,0.72,0.1343,22,330,144,1440,166,1770
6537,2011-10-04,4,0,10,22,0,2,1,1,0.5,0.4848,0.72,0.1343,8,120,106,1060,114,1180
6538,2011-10-04,4,0,10,23,0,2,1,1,0.48,0.4697,0.77,0.1343,6,90,60,600,66,690
6539,2011-10-05,4,0,10,0,0,3,1,1,0.48,0.4697,0.77,0.1343,7,105,36,360,43,465
6540,2011-10-05,4,0,10,1,0,3,1,1,0.48,0.4697,0.77,0.1642,4,60,7,70,11,130
6541,2011-10-05,4,0,10,2,0,3,1,1,0.46,0.4545,0.82,0.1642,1,15,2,20,3,35
6542,2011-10-05,4,0,10,3,0,3,1,1,0.46,0.4545,0.82,0.1045,1,15,5,50,6,65
6543,2011-10-05,4,0,10,4,0,3,1,1,0.44,0.4394,0.88,0.0,1,15,4,40,5,55
6544,2011-10-05,4,0,10,5,0,3,1,1,0.44,0.4394,0.82,0.1343,3,45,29,290,32,335
6545,2011-10-05,4,0,10,6,0,3,1,1,0.44,0.4394,0.82,0.1045,5,75,112,1120,117,1195
6546,2011-10-05,4,0,10,7,0,3,1,1,0.46,0.4545,0.77,0.1045,9,135,292,2920,301,3055
6547,2011-10-05,4,0,10,8,0,3,1,1,0.52,0.5,0.63,0.0,26,390,441,4410,467,4800
6548,2011-10-05,4,0,10,9,0,3,1,1,0.54,0.5152,0.6,0.2985,32,480,187,1870,219,2350
6549,2011-10-05,4,0,10,10,0,3,1,1,0.56,0.5303,0.56,0.3881,30,450,103,1030,133,1480
6550,2011-10-05,4,0,10,11,0,3,1,1,0.6,0.6212,0.46,0.2836,32,480,138,1380,170,1860
6551,2011-10-05,4,0,10,12,0,3,1,1,0.62,0.6212,0.43,0.3284,34,510,180,1800,214,2310
6552,2011-10-05,4,0,10,13,0,3,1,1,0.64,0.6212,0.41,0.2239,30,450,189,1890,219,2340
6553,2011-10-05,4,0,10,14,0,3,1,1,0.64,0.6212,0.41,0.2836,34,510,156,1560,190,2070
6554,2011-10-05,4,0,10,15,0,3,1,1,0.64,0.6212,0.47,0.2836,35,525,147,1470,182,1995
6555,2011-10-05,4,0,10,16,0,3,1,1,0.64,0.6212,0.47,0.3284,37,555,245,2450,282,3005
6556,2011-10-05,4,0,10,17,0,3,1,1,0.64,0.6212,0.47,0.2537,66,990,525,5250,591,6240
6557,2011-10-05,4,0,10,18,0,3,1,1,0.6,0.6212,0.53,0.1642,57,855,536,5360,593,6215
6558,2011-10-05,4,0,10,19,0,3,1,1,0.58,0.5455,0.56,0.1343,40,600,334,3340,374,3940
6559,2011-10-05,4,0,10,20,0,3,1,1,0.52,0.5,0.77,0.1642,18,270,228,2280,246,2550
6560,2011-10-05,4,0,10,21,0,3,1,1,0.5,0.4848,0.82,0.1045,28,420,173,1730,201,2150
6561,2011-10-05,4,0,10,22,0,3,1,1,0.52,0.5,0.72,0.0,20,300,134,1340,154,1640
6562,2011-10-05,4,0,10,23,0,3,1,1,0.5,0.4848,0.77,0.1045,9,135,64,640,73,775
6563,2011-10-06,4,0,10,0,0,4,1,1,0.5,0.4848,0.72,0.194,6,90,34,340,40,430
6564,2011-10-06,4,0,10,1,0,4,1,1,0.48,0.4697,0.63,0.194,5,75,17,170,22,245
6565,2011-10-06,4,0,10,2,0,4,1,1,0.46,0.4545,0.67,0.194,2,30,8,80,10,110
6566,2011-10-06,4,0,10,3,0,4,1,1,0.44,0.4394,0.67,0.2239,1,15,4,40,5,55
6567,2011-10-06,4,0,10,4,0,4,1,1,0.44,0.4394,0.62,0.2836,0,0,5,50,5,50
6568,2011-10-06,4,0,10,5,0,4,1,1,0.42,0.4242,0.62,0.194,0,0,24,240,24,240
6569,2011-10-06,4,0,10,6,0,4,1,1,0.4,0.4091,0.66,0.194,4,60,110,1100,114,1160
6570,2011-10-06,4,0,10,7,0,4,1,1,0.42,0.4242,0.62,0.194,15,225,287,2870,302,3095
6571,2011-10-06,4,0,10,8,0,4,1,1,0.44,0.4394,0.62,0.1642,20,300,437,4370,457,4670
6572,2011-10-06,4,0,10,9,0,4,1,1,0.46,0.4545,0.63,0.194,20,300,188,1880,208,2180
6573,2011-10-06,4,0,10,10,0,4,1,1,0.52,0.5,0.52,0.0,24,360,105,1050,129,1410
6574,2011-10-06,4,0,10,11,0,4,1,1,0.54,0.5152,0.49,0.0,29,435,115,1150,144,1585
6575,2011-10-06,4,0,10,12,0,4,1,1,0.56,0.5303,0.49,0.0896,46,690,180,1800,226,2490
6576,2011-10-06,4,0,10,13,0,4,1,1,0.56,0.5303,0.46,0.0896,33,495,158,1580,191,2075
6577,2011-10-06,4,0,10,14,0,4,1,1,0.58,0.5455,0.43,0.0896,56,840,139,1390,195,2230
6578,2011-10-06,4,0,10,15,0,4,1,1,0.58,0.5455,0.46,0.1343,62,930,157,1570,219,2500
6579,2011-10-06,4,0,10,16,0,4,1,1,0.58,0.5455,0.49,0.194,51,765,272,2720,323,3485
6580,2011-10-06,4,0,10,17,0,4,1,1,0.56,0.5303,0.52,0.1343,63,945,505,5050,568,5995
6581,2011-10-06,4,0,10,18,0,4,1,1,0.54,0.5152,0.64,0.0896,59,885,479,4790,538,5675
6582,2011-10-06,4,0,10,19,0,4,1,1,0.52,0.5,0.59,0.1045,38,570,305,3050,343,3620
6583,2011-10-06,4,0,10,20,0,4,1,1,0.5,0.4848,0.77,0.1045,29,435,231,2310,260,2745
6584,2011-10-06,4,0,10,21,0,4,1,1,0.46,0.4545,0.88,0.0896,34,510,161,1610,195,2120
6585,2011-10-06,4,0,10,22,0,4,1,1,0.46,0.4545,0.82,0.0,24,360,124,1240,148,1600
6586,2011-10-06,4,0,10,23,0,4,1,1,0.44,0.4394,0.88,0.0896,18,270,81,810,99,1080
6587,2011-10-07,4,0,10,0,0,5,1,1,0.44,0.4394,0.88,0.0,19,285,48,480,67,765
6588,2011-10-07,4,0,10,1,0,5,1,1,0.44,0.4394,0.88,0.0,3,45,25,250,28,295
6589,2011-10-07,4,0,10,2,0,5,1,1,0.42,0.4242,0.88,0.0,0,0,5,50,5,50
6590,2011-10-07,4,0,10,3,0,5,1,1,0.4,0.4091,0.87,0.0,1,15,9,90,10,105
6591,2011-10-07,4,0,10,4,0,5,1,1,0.4,0.4091,0.87,0.1045,0,0,5,50,5,50
6592,2011-10-07,4,0,10,5,0,5,1,1,0.42,0.4242,0.82,0.0,3,45,24,240,27,285
6593,2011-10-07,4,0,10,6,0,5,1,1,0.42,0.4242,0.88,0.0,3,45,84,840,87,885
6594,2011-10-07,4,0,10,7,0,5,1,1,0.42,0.4242,0.94,0.0,5,75,237,2370,242,2445
6595,2011-10-07,4,0,10,8,0,5,1,1,0.46,0.4545,0.82,0.0,31,465,386,3860,417,4325
6596,2011-10-07,4,0,10,9,0,5,1,1,0.48,0.4697,0.77,0.0,34,510,207,2070,241,2580
6597,2011-10-07,4,0,10,10,0,5,1,1,0.52,0.5,0.68,0.0896,48,720,126,1260,174,1980
6598,2011-10-07,4,0,10,11,0,5,1,1,0.56,0.5303,0.63,0.0,80,1200,150,1500,230,2700
6599,2011-10-07,4,0,10,12,0,5,1,1,0.6,0.6212,0.53,0.0,61,915,174,1740,235,2655
6600,2011-10-07,4,0,10,13,0,5,1,1,0.6,0.6212,0.46,0.0,95,1425,210,2100,305,3525
6601,2011-10-07,4,0,10,14,0,5,1,1,0.62,0.6212,0.5,0.0,77,1155,179,1790,256,2945
6602,2011-10-07,4,0,10,15,0,5,1,1,0.66,0.6212,0.41,0.0,68,1020,202,2020,270,3040
6603,2011-10-07,4,0,10,16,0,5,1,1,0.64,0.6212,0.44,0.0,73,1095,346,3460,419,4555
6604,2011-10-07,4,0,10,17,0,5,1,1,0.6,0.6212,0.56,0.2537,101,1515,462,4620,563,6135
6605,2011-10-07,4,0,10,18,0,5,1,1,0.56,0.5303,0.6,0.0896,94,1410,371,3710,465,5120
6606,2011-10-07,4,0,10,19,0,5,1,1,0.56,0.5303,0.52,0.0,51,765,243,2430,294,3195
6607,2011-10-07,4,0,10,20,0,5,1,1,0.54,0.5152,0.49,0.0,30,450,167,1670,197,2120
6608,2011-10-07,4,0,10,21,0,5,1,1,0.5,0.4848,0.68,0.0,22,330,144,1440,166,1770
6609,2011-10-07,4,0,10,22,0,5,1,1,0.5,0.4848,0.68,0.0,27,405,119,1190,146,1595
6610,2011-10-07,4,0,10,23,0,5,1,1,0.5,0.4848,0.63,0.0,23,345,113,1130,136,1475
6611,2011-10-08,4,0,10,0,0,6,0,1,0.48,0.4697,0.72,0.0,17,255,72,720,89,975
6612,2011-10-08,4,0,10,1,0,6,0,1,0.46,0.4545,0.82,0.0,14,210,51,510,65,720
6613,2011-10-08,4,0,10,2,0,6,0,1,0.46,0.4545,0.82,0.0,4,60,41,410,45,470
6614,2011-10-08,4,0,10,3,0,6,0,1,0.44,0.4394,0.88,0.0,4,60,16,160,20,220
6615,2011-10-08,4,0,10,4,0,6,0,1,0.42,0.4242,0.94,0.1343,3,45,7,70,10,115
6616,2011-10-08,4,0,10,5,0,6,0,1,0.42,0.4242,0.88,0.1045,1,15,7,70,8,85
6617,2011-10-08,4,0,10,6,0,6,0,1,0.42,0.4242,0.94,0.0,6,90,16,160,22,250
6618,2011-10-08,4,0,10,7,0,6,0,1,0.42,0.4242,0.94,0.0896,27,405,46,460,73,865
6619,2011-10-08,4,0,10,8,0,6,0,1,0.46,0.4545,0.82,0.0,14,210,89,890,103,1100
6620,2011-10-08,4,0,10,9,0,6,0,1,0.5,0.4848,0.77,0.0,54,810,163,1630,217,2440
6621,2011-10-08,4,0,10,10,0,6,0,1,0.52,0.5,0.77,0.0,120,1800,217,2170,337,3970
6622,2011-10-08,4,0,10,11,0,6,0,1,0.58,0.5455,0.56,0.0,176,2640,221,2210,397,4850
6623,2011-10-08,4,0,10,12,0,6,0,1,0.62,0.6212,0.35,0.0,191,2865,255,2550,446,5415
6624,2011-10-08,4,0,10,13,0,6,0,1,0.62,0.6212,0.46,0.1045,256,3840,229,2290,485,6130
6625,2011-10-08,4,0,10,14,0,6,0,1,0.62,0.6212,0.5,0.0896,251,3765,214,2140,465,5905
6626,2011-10-08,4,0,10,15,0,6,0,1,0.66,0.6212,0.39,0.0,262,3930,234,2340,496,6270
6627,2011-10-08,4,0,10,16,0,6,0,1,0.64,0.6212,0.44,0.0896,221,3315,230,2300,451,5615
6628,2011-10-08,4,0,10,17,0,6,0,1,0.62,0.6212,0.5,0.1343,174,2610,219,2190,393,4800
6629,2011-10-08,4,0,10,18,0,6,0,1,0.6,0.6212,0.46,0.1045,135,2025,224,2240,359,4265
6630,2011-10-08,4,0,10,19,0,6,0,1,0.54,0.5152,0.68,0.1343,76,1140,172,1720,248,2860
6631,2011-10-08,4,0,10,20,0,6,0,1,0.52,0.5,0.77,0.1045,78,1170,124,1240,202,2410
6632,2011-10-08,4,0,10,21,0,6,0,1,0.52,0.5,0.77,0.0,54,810,133,1330,187,2140
6633,2011-10-08,4,0,10,22,0,6,0,1,0.5,0.4848,0.77,0.0,45,675,104,1040,149,1715
6634,2011-10-08,4,0,10,23,0,6,0,1,0.48,0.4697,0.88,0.0,52,780,90,900,142,1680
6635,2011-10-09,4,0,10,0,0,0,0,1,0.46,0.4545,0.88,0.0896,46,690,83,830,129,1520
6636,2011-10-09,4,0,10,1,0,0,0,1,0.46,0.4545,0.88,0.0,15,225,63,630,78,855
6637,2011-10-09,4,0,10,2,0,0,0,1,0.46,0.4545,0.88,0.0,20,300,35,350,55,650
6638,2011-10-09,4,0,10,3,0,0,0,1,0.44,0.4394,0.88,0.0,10,150,20,200,30,350
6639,2011-10-09,4,0,10,4,0,0,0,1,0.44,0.4394,0.88,0.0,7,105,7,70,14,175
6640,2011-10-09,4,0,10,5,0,0,0,1,0.44,0.4394,0.88,0.0,1,15,14,140,15,155
6641,2011-10-09,4,0,10,6,0,0,0,1,0.44,0.4394,0.88,0.0,7,105,14,140,21,245
6642,2011-10-09,4,0,10,7,0,0,0,1,0.44,0.4394,0.86,0.0,18,270,26,260,44,530
6643,2011-10-09,4,0,10,8,0,0,0,1,0.46,0.4545,0.88,0.0,25,375,82,820,107,1195
6644,2011-10-09,4,0,10,9,0,0,0,1,0.5,0.4848,0.77,0.0,66,990,119,1190,185,2180
6645,2011-10-09,4,0,10,10,0,0,0,1,0.56,0.5303,0.68,0.0896,155,2325,210,2100,365,4425
6646,2011-10-09,4,0,10,11,0,0,0,1,0.62,0.6212,0.53,0.0896,189,2835,234,2340,423,5175
6647,2011-10-09,4,0,10,12,0,0,0,1,0.64,0.6212,0.44,0.0896,212,3180,243,2430,455,5610
6648,2011-10-09,4,0,10,13,0,0,0,1,0.66,0.6212,0.44,0.0896,225,3375,193,1930,418,5305
6649,2011-10-09,4,0,10,14,0,0,0,1,0.68,0.6364,0.47,0.1642,272,4080,228,2280,500,6360
6650,2011-10-09,4,0,10,15,0,0,0,1,0.68,0.6364,0.51,0.1642,198,2970,209,2090,407,5060
6651,2011-10-09,4,0,10,16,0,0,0,1,0.66,0.6212,0.5,0.1343,223,3345,247,2470,470,5815
6652,2011-10-09,4,0,10,17,0,0,0,1,0.62,0.6061,0.61,0.1045,208,3120,230,2300,438,5420
6653,2011-10-09,4,0,10,18,0,0,0,1,0.64,0.6212,0.5,0.1045,186,2790,228,2280,414,5070
6654,2011-10-09,4,0,10,19,0,0,0,1,0.56,0.5303,0.73,0.0896,116,1740,186,1860,302,3600
6655,2011-10-09,4,0,10,20,0,0,0,1,0.56,0.5303,0.73,0.1045,59,885,134,1340,193,2225
6656,2011-10-09,4,0,10,21,0,0,0,1,0.54,0.5152,0.83,0.1045,53,795,120,1200,173,1995
6657,2011-10-09,4,0,10,22,0,0,0,2,0.52,0.5,0.94,0.0,48,720,104,1040,152,1760
6658,2011-10-09,4,0,10,23,0,0,0,1,0.5,0.4848,0.88,0.1045,38,570,85,850,123,1420
6659,2011-10-10,4,0,10,0,1,1,0,1,0.5,0.4848,0.94,0.0,11,165,42,420,53,585
6660,2011-10-10,4,0,10,1,1,1,0,1,0.48,0.4697,0.88,0.0,4,60,30,300,34,360
6661,2011-10-10,4,0,10,2,1,1,0,1,0.48,0.4697,0.88,0.0,4,60,15,150,19,210
6662,2011-10-10,4,0,10,3,1,1,0,1,0.46,0.4545,0.88,0.0,2,30,9,90,11,120
6663,2011-10-10,4,0,10,4,1,1,0,1,0.46,0.4545,0.94,0.0,2,30,4,40,6,70
6664,2011-10-10,4,0,10,5,1,1,0,1,0.46,0.4545,0.94,0.0,2,30,19,190,21,220
6665,2011-10-10,4,0,10,6,1,1,0,1,0.44,0.4394,0.94,0.0,5,75,39,390,44,465
6666,2011-10-10,4,0,10,7,1,1,0,1,0.46,0.4545,0.88,0.0,12,180,102,1020,114,1200
6667,2011-10-10,4,0,10,8,1,1,0,1,0.52,0.5,0.83,0.0,27,405,227,2270,254,2675
6668,2011-10-10,4,0,10,9,1,1,0,1,0.54,0.5152,0.77,0.0,58,870,161,1610,219,2480
6669,2011-10-10,4,0,10,10,1,1,0,1,0.56,0.5303,0.73,0.1642,107,1605,158,1580,265,3185
6670,2011-10-10,4,0,10,11,1,1,0,1,0.62,0.6061,0.69,0.0896,139,2085,183,1830,322,3915
6671,2011-10-10,4,0,10,12,1,1,0,2,0.7,0.6515,0.48,0.0896,164,2460,201,2010,365,4470
6672,2011-10-10,4,0,10,13,1,1,0,1,0.72,0.6515,0.37,0.0,146,2190,219,2190,365,4380
6673,2011-10-10,4,0,10,14,1,1,0,1,0.74,0.6515,0.37,0.0,147,2205,223,2230,370,4435
6674,2011-10-10,4,0,10,15,1,1,0,2,0.72,0.6515,0.42,0.1045,130,1950,254,2540,384,4490
6675,2011-10-10,4,0,10,16,1,1,0,2,0.7,0.6364,0.45,0.0896,154,2310,248,2480,402,4790
6676,2011-10-10,4,0,10,17,1,1,0,2,0.66,0.6212,0.54,0.1045,125,1875,334,3340,459,5215
6677,2011-10-10,4,0,10,18,1,1,0,2,0.64,0.6212,0.53,0.0,108,1620,365,3650,473,5270
6678,2011-10-10,4,0,10,19,1,1,0,2,0.58,0.5455,0.78,0.0896,69,1035,267,2670,336,3705
6679,2011-10-10,4,0,10,20,1,1,0,1,0.6,0.5909,0.73,0.0,37,555,188,1880,225,2435
6680,2011-10-10,4,0,10,21,1,1,0,1,0.56,0.5303,0.88,0.0896,27,405,148,1480,175,1885
6681,2011-10-10,4,0,10,22,1,1,0,1,0.56,0.5303,0.88,0.0896,22,330,104,1040,126,1370
6682,2011-10-10,4,0,10,23,1,1,0,2,0.54,0.5152,0.88,0.1045,12,180,63,630,75,810
6683,2011-10-11,4,0,10,0,0,2,1,2,0.54,0.5152,0.88,0.0,14,210,16,160,30,370
6684,2011-10-11,4,0,10,1,0,2,1,2,0.52,0.5,0.94,0.0896,2,30,9,90,11,120
6685,2011-10-11,4,0,10,2,0,2,1,2,0.52,0.5,0.94,0.1343,1,15,4,40,5,55
6686,2011-10-11,4,0,10,3,0,2,1,2,0.52,0.5,0.88,0.1045,2,30,1,10,3,40
6687,2011-10-11,4,0,10,4,0,2,1,2,0.52,0.5,0.88,0.1343,0,0,5,50,5,50
6688,2011-10-11,4,0,10,5,0,2,1,2,0.52,0.5,0.88,0.0,0,0,20,200,20,200
6689,2011-10-11,4,0,10,6,0,2,1,1,0.52,0.5,0.83,0.0896,9,135,114,1140,123,1275
6690,2011-10-11,4,0,10,7,0,2,1,2,0.52,0.5,0.88,0.0896,19,285,333,3330,352,3615
6691,2011-10-11,4,0,10,8,0,2,1,2,0.56,0.5303,0.83,0.1045,31,465,375,3750,406,4215
6692,2011-10-11,4,0,10,9,0,2,1,2,0.6,0.5909,0.69,0.0,40,600,195,1950,235,2550
6693,2011-10-11,4,0,10,10,0,2,1,2,0.6,0.5909,0.69,0.1343,38,570,111,1110,149,1680
6694,2011-10-11,4,0,10,11,0,2,1,2,0.6,0.5909,0.73,0.1642,31,465,92,920,123,1385
6695,2011-10-11,4,0,10,12,0,2,1,2,0.6,0.5909,0.73,0.1642,51,765,130,1300,181,2065
6696,2011-10-11,4,0,10,13,0,2,1,2,0.6,0.5909,0.73,0.194,42,630,138,1380,180,2010
6697,2011-10-11,4,0,10,14,0,2,1,3,0.6,0.5909,0.73,0.1045,54,810,117,1170,171,1980
6698,2011-10-11,4,0,10,15,0,2,1,2,0.6,0.5758,0.78,0.1642,36,540,139,1390,175,1930
6699,2011-10-11,4,0,10,16,0,2,1,2,0.6,0.5909,0.73,0.1642,63,945,257,2570,320,3515
6700,2011-10-11,4,0,10,17,0,2,1,2,0.6,0.5758,0.78,0.2537,70,1050,534,5340,604,6390
6701,2011-10-11,4,0,10,18,0,2,1,2,0.6,0.5758,0.78,0.2239,46,690,493,4930,539,5620
6702,2011-10-11,4,0,10,19,0,2,1,2,0.58,0.5455,0.83,0.2239,33,495,285,2850,318,3345
6703,2011-10-11,4,0,10,20,0,2,1,2,0.58,0.5455,0.83,0.2239,31,465,203,2030,234,2495
6704,2011-10-11,4,0,10,21,0,2,1,2,0.58,0.5455,0.78,0.194,17,255,158,1580,175,1835
6705,2011-10-11,4,0,10,22,0,2,1,2,0.56,0.5303,0.83,0.194,27,405,120,1200,147,1605
6706,2011-10-11,4,0,10,23,0,2,1,2,0.56,0.5303,0.83,0.2836,10,150,47,470,57,620
6707,2011-10-12,4,0,10,0,0,3,1,2,0.56,0.5303,0.83,0.1343,2,30,23,230,25,260
6708,2011-10-12,4,0,10,1,0,3,1,3,0.56,0.5303,0.83,0.1343,2,30,8,80,10,110
6709,2011-10-12,4,0,10,2,0,3,1,2,0.56,0.5303,0.83,0.2836,0,0,2,20,2,20
6710,2011-10-12,4,0,10,3,0,3,1,3,0.54,0.5152,0.94,0.2985,0,0,2,20,2,20
6711,2011-10-12,4,0,10,4,0,3,1,3,0.54,0.5152,0.94,0.3881,1,15,6,60,7,75
6712,2011-10-12,4,0,10,5,0,3,1,2,0.54,0.5152,0.88,0.3284,0,0,22,220,22,220
6713,2011-10-12,4,0,10,6,0,3,1,2,0.54,0.5152,0.88,0.2537,5,75,107,1070,112,1145
6714,2011-10-12,4,0,10,7,0,3,1,2,0.54,0.5152,0.88,0.3881,15,225,244,2440,259,2665
6715,2011-10-12,4,0,10,8,0,3,1,2,0.54,0.5152,0.88,0.3881,27,405,377,3770,404,4175
6716,2011-10-12,4,0,10,9,0,3,1,2,0.54,0.5152,0.88,0.4478,14,210,183,1830,197,2040
6717,2011-10-12,4,0,10,10,0,3,1,2,0.54,0.5152,0.88,0.3881,15,225,98,980,113,1205
6718,2011-10-12,4,0,10,11,0,3,1,3,0.54,0.5152,0.94,0.3284,18,270,102,1020,120,1290
6719,2011-10-12,4,0,10,12,0,3,1,3,0.54,0.5152,0.88,0.3284,9,135,53,530,62,665
6720,2011-10-12,4,0,10,13,0,3,1,3,0.54,0.5152,0.88,0.2239,25,375,76,760,101,1135
6721,2011-10-12,4,0,10,14,0,3,1,3,0.54,0.5152,0.94,0.2836,8,120,70,700,78,820
6722,2011-10-12,4,0,10,15,0,3,1,3,0.54,0.5152,0.94,0.2537,3,45,42,420,45,465
6723,2011-10-12,4,0,10,16,0,3,1,2,0.56,0.5303,0.88,0.2239,5,75,50,500,55,575
6724,2011-10-12,4,0,10,17,0,3,1,3,0.54,0.5152,0.94,0.2239,16,240,235,2350,251,2590
6725,2011-10-12,4,0,10,18,0,3,1,3,0.54,0.5152,0.94,0.1343,11,165,161,1610,172,1775
6726,2011-10-12,4,0,10,19,0,3,1,3,0.54,0.5152,0.94,0.1343,7,105,102,1020,109,1125
6727,2011-10-12,4,0,10,20,0,3,1,3,0.54,0.5152,0.94,0.1045,9,135,81,810,90,945
6728,2011-10-12,4,0,10,21,0,3,1,3,0.54,0.5152,1.0,0.1045,9,135,74,740,83,875
6729,2011-10-12,4,0,10,22,0,3,1,3,0.54,0.5152,0.94,0.0896,3,45,40,400,43,445
6730,2011-10-12,4,0,10,23,0,3,1,3,0.54,0.5152,0.94,0.0896,13,195,41,410,54,605
6731,2011-10-13,4,0,10,0,0,4,1,2,0.54,0.5152,0.94,0.1343,1,15,14,140,15,155
6732,2011-10-13,4,0,10,1,0,4,1,2,0.54,0.5152,0.94,0.0,3,45,9,90,12,135
6733,2011-10-13,4,0,10,2,0,4,1,2,0.54,0.5152,0.94,0.0,0,0,4,40,4,40
6734,2011-10-13,4,0,10,3,0,4,1,2,0.54,0.5152,1.0,0.194,2,30,4,40,6,70
6735,2011-10-13,4,0,10,4,0,4,1,2,0.54,0.5152,1.0,0.1045,2,30,5,50,7,80
6736,2011-10-13,4,0,10,5,0,4,1,2,0.54,0.5152,1.0,0.1045,1,15,16,160,17,175
6737,2011-10-13,4,0,10,6,0,4,1,3,0.54,0.5152,1.0,0.0896,1,15,51,510,52,525
6738,2011-10-13,4,0,10,7,0,4,1,3,0.54,0.5152,1.0,0.1343,5,75,76,760,81,835
6739,2011-10-13,4,0,10,8,0,4,1,3,0.54,0.5152,1.0,0.0896,10,150,199,1990,209,2140
6740,2011-10-13,4,0,10,9,0,4,1,3,0.56,0.5303,1.0,0.1045,3,45,106,1060,109,1105
6741,2011-10-13,4,0,10,10,0,4,1,3,0.56,0.5303,1.0,0.1343,16,240,53,530,69,770
6742,2011-10-13,4,0,10,11,0,4,1,2,0.62,0.5758,0.83,0.0,8,120,76,760,84,880
6743,2011-10-13,4,0,10,12,0,4,1,2,0.62,0.5606,0.88,0.0,10,150,95,950,105,1100
6744,2011-10-13,4,0,10,13,0,4,1,2,0.64,0.5758,0.83,0.1642,20,300,142,1420,162,1720
6745,2011-10-13,4,0,10,14,0,4,1,1,0.66,0.6061,0.78,0.194,22,330,111,1110,133,1440
6746,2011-10-13,4,0,10,15,0,4,1,1,0.66,0.6061,0.78,0.194,27,405,128,1280,155,1685
6747,2011-10-13,4,0,10,16,0,4,1,1,0.66,0.6212,0.74,0.2239,36,540,240,2400,276,2940
6748,2011-10-13,4,0,10,17,0,4,1,3,0.62,0.5758,0.83,0.2537,47,705,432,4320,479,5025
6749,2011-10-13,4,0,10,18,0,4,1,3,0.62,0.5758,0.83,0.2537,20,300,248,2480,268,2780
6750,2011-10-13,4,0,10,19,0,4,1,2,0.62,0.5758,0.83,0.1642,18,270,187,1870,205,2140
6751,2011-10-13,4,0,10,20,0,4,1,1,0.62,0.5758,0.83,0.2836,15,225,166,1660,181,1885
6752,2011-10-13,4,0,10,21,0,4,1,1,0.62,0.5758,0.83,0.194,8,120,115,1150,123,1270
6753,2011-10-13,4,0,10,22,0,4,1,1,0.62,0.5758,0.83,0.194,13,195,101,1010,114,1205
6754,2011-10-13,4,0,10,23,0,4,1,2,0.58,0.5455,0.88,0.194,2,30,45,450,47,480
6755,2011-10-14,4,0,10,0,0,5,1,1,0.58,0.5455,0.94,0.0896,10,150,29,290,39,440
6756,2011-10-14,4,0,10,1,0,5,1,1,0.58,0.5455,0.94,0.1343,8,120,16,160,24,280
6757,2011-10-14,4,0,10,2,0,5,1,1,0.56,0.5303,0.94,0.1642,0,0,6,60,6,60
6758,2011-10-14,4,0,10,3,0,5,1,1,0.56,0.5303,0.94,0.1343,1,15,6,60,7,75
6759,2011-10-14,4,0,10,4,0,5,1,1,0.56,0.5303,0.94,0.194,0,0,8,80,8,80
6760,2011-10-14,4,0,10,5,0,5,1,2,0.56,0.5303,0.94,0.1642,0,0,17,170,17,170
6761,2011-10-14,4,0,10,6,0,5,1,3,0.56,0.5303,0.88,0.194,4,60,90,900,94,960
6762,2011-10-14,4,0,10,7,0,5,1,3,0.56,0.5303,0.88,0.194,10,150,137,1370,147,1520
6763,2011-10-14,4,0,10,8,0,5,1,2,0.56,0.5303,0.9,0.1642,23,345,186,1860,209,2205
6764,2011-10-14,4,0,10,9,0,5,1,2,0.56,0.5303,0.94,0.2239,16,240,164,1640,180,1880
6765,2011-10-14,4,0,10,10,0,5,1,3,0.54,0.5152,0.88,0.3582,17,255,108,1080,125,1335
6766,2011-10-14,4,0,10,11,0,5,1,3,0.52,0.5,0.88,0.1642,11,165,76,760,87,925
6767,2011-10-14,4,0,10,12,0,5,1,3,0.52,0.5,0.88,0.1642,13,195,62,620,75,815
6768,2011-10-14,4,0,10,13,0,5,1,1,0.56,0.5303,0.73,0.3582,18,270,114,1140,132,1410
6769,2011-10-14,4,0,10,14,0,5,1,1,0.62,0.6212,0.43,0.3582,37,555,119,1190,156,1745
6770,2011-10-14,4,0,10,15,0,5,1,1,0.62,0.6212,0.43,0.2836,61,915,169,1690,230,2605
6771,2011-10-14,4,0,10,16,0,5,1,1,0.6,0.6212,0.43,0.2239,80,1200,264,2640,344,3840
6772,2011-10-14,4,0,10,17,0,5,1,1,0.58,0.5455,0.46,0.4179,55,825,426,4260,481,5085
6773,2011-10-14,4,0,10,18,0,5,1,1,0.54,0.5152,0.39,0.2836,62,930,361,3610,423,4540
6774,2011-10-14,4,0,10,19,0,5,1,1,0.54,0.5152,0.39,0.3284,27,405,221,2210,248,2615
6775,2011-10-14,4,0,10,20,0,5,1,1,0.52,0.5,0.42,0.194,19,285,177,1770,196,2055
6776,2011-10-14,4,0,10,21,0,5,1,1,0.5,0.4848,0.45,0.194,22,330,156,1560,178,1890
6777,2011-10-14,4,0,10,22,0,5,1,1,0.46,0.4545,0.59,0.2239,20,300,123,1230,143,1530
6778,2011-10-14,4,0,10,23,0,5,1,1,0.46,0.4545,0.59,0.1642,15,225,80,800,95,1025
6779,2011-10-15,4,0,10,0,0,6,0,1,0.46,0.4545,0.55,0.1045,18,270,88,880,106,1150
6780,2011-10-15,4,0,10,1,0,6,0,1,0.46,0.4545,0.55,0.2537,9,135,64,640,73,775
6781,2011-10-15,4,0,10,2,0,6,0,1,0.46,0.4545,0.59,0.194,17,255,39,390,56,645
6782,2011-10-15,4,0,10,3,0,6,0,1,0.44,0.4394,0.62,0.194,5,75,18,180,23,255
6783,2011-10-15,4,0,10,4,0,6,0,1,0.42,0.4242,0.67,0.1343,0,0,6,60,6,60
6784,2011-10-15,4,0,10,5,0,6,0,1,0.42,0.4242,0.71,0.1642,1,15,6,60,7,75
6785,2011-10-15,4,0,10,6,0,6,0,1,0.4,0.4091,0.71,0.0,5,75,15,150,20,225
6786,2011-10-15,4,0,10,7,0,6,0,1,0.4,0.4091,0.76,0.1045,17,255,40,400,57,655
6787,2011-10-15,4,0,10,8,0,6,0,1,0.46,0.4545,0.59,0.2836,24,360,101,1010,125,1370
6788,2011-10-15,4,0,10,9,0,6,0,1,0.52,0.5,0.48,0.2985,50,750,157,1570,207,2320
6789,2011-10-15,4,0,10,10,0,6,0,1,0.54,0.5152,0.45,0.4478,115,1725,207,2070,322,3795
6790,2011-10-15,4,0,10,11,0,6,0,1,0.56,0.5303,0.4,0.3881,153,2295,221,2210,374,4505
6791,2011-10-15,4,0,10,12,0,6,0,1,0.58,0.5455,0.35,0.5522,195,2925,261,2610,456,5535
6792,2011-10-15,4,0,10,13,0,6,0,1,0.6,0.6212,0.35,0.4627,171,2565,223,2230,394,4795
6793,2011-10-15,4,0,10,14,0,6,0,1,0.6,0.6212,0.33,0.4627,242,3630,230,2300,472,5930
6794,2011-10-15,4,0,10,15,0,6,0,1,0.62,0.6212,0.31,0.4925,166,2490,211,2110,377,4600
6795,2011-10-15,4,0,10,16,0,6,0,1,0.62,0.6212,0.29,0.3881,179,2685,264,2640,443,5325
6796,2011-10-15,4,0,10,17,0,6,0,1,0.58,0.5455,0.32,0.2836,177,2655,264,2640,441,5295
6797,2011-10-15,4,0,10,18,0,6,0,1,0.54,0.5152,0.39,0.194,121,1815,251,2510,372,4325
6798,2011-10-15,4,0,10,19,0,6,0,1,0.5,0.4848,0.51,0.1343,61,915,177,1770,238,2685
6799,2011-10-15,4,0,10,20,0,6,0,1,0.5,0.4848,0.48,0.1343,42,630,137,1370,179,2000
6800,2011-10-15,4,0,10,21,0,6,0,1,0.5,0.4848,0.42,0.2239,53,795,115,1150,168,1945
6801,2011-10-15,4,0,10,22,0,6,0,1,0.5,0.4848,0.36,0.1343,45,675,121,1210,166,1885
6802,2011-10-15,4,0,10,23,0,6,0,1,0.48,0.4697,0.41,0.1642,33,495,102,1020,135,1515
6803,2011-10-16,4,0,10,0,0,0,0,1,0.46,0.4545,0.44,0.1343,22,330,85,850,107,1180
6804,2011-10-16,4,0,10,1,0,0,0,1,0.44,0.4394,0.47,0.1343,13,195,64,640,77,835
6805,2011-10-16,4,0,10,2,0,0,0,1,0.42,0.4242,0.54,0.1343,13,195,52,520,65,715
6806,2011-10-16,4,0,10,3,0,0,0,1,0.42,0.4242,0.54,0.1343,11,165,31,310,42,475
6807,2011-10-16,4,0,10,4,0,0,0,1,0.42,0.4242,0.54,0.194,5,75,7,70,12,145
6808,2011-10-16,4,0,10,5,0,0,0,1,0.42,0.4242,0.54,0.1642,1,15,6,60,7,75
6809,2011-10-16,4,0,10,6,0,0,0,1,0.38,0.3939,0.66,0.1642,3,45,7,70,10,115
6810,2011-10-16,4,0,10,7,0,0,0,1,0.4,0.4091,0.62,0.1343,9,135,39,390,48,525
6811,2011-10-16,4,0,10,8,0,0,0,1,0.44,0.4394,0.62,0.194,28,420,71,710,99,1130
6812,2011-10-16,4,0,10,9,0,0,0,1,0.5,0.4848,0.45,0.2239,39,585,151,1510,190,2095
6813,2011-10-16,4,0,10,10,0,0,0,1,0.54,0.5152,0.45,0.2537,121,1815,226,2260,347,4075
6814,2011-10-16,4,0,10,11,0,0,0,1,0.56,0.5303,0.35,0.2836,159,2385,218,2180,377,4565
6815,2011-10-16,4,0,10,12,0,0,0,1,0.58,0.5455,0.35,0.2537,167,2505,277,2770,444,5275
6816,2011-10-16,4,0,10,13,0,0,0,1,0.6,0.6212,0.35,0.2985,169,2535,269,2690,438,5225
6817,2011-10-16,4,0,10,14,0,0,0,1,0.6,0.6212,0.4,0.2985,204,3060,258,2580,462,5640
6818,2011-10-16,4,0,10,15,0,0,0,1,0.62,0.6212,0.35,0.3881,182,2730,230,2300,412,5030
6819,2011-10-16,4,0,10,16,0,0,0,1,0.6,0.6212,0.46,0.3881,177,2655,289,2890,466,5545
6820,2011-10-16,4,0,10,17,0,0,0,1,0.58,0.5455,0.49,0.4627,152,2280,253,2530,405,4810
6821,2011-10-16,4,0,10,18,0,0,0,1,0.56,0.5303,0.49,0.4478,102,1530,226,2260,328,3790
6822,2011-10-16,4,0,10,19,0,0,0,1,0.54,0.5152,0.52,0.3881,52,780,181,1810,233,2590
6823,2011-10-16,4,0,10,20,0,0,0,1,0.54,0.5152,0.52,0.4627,49,735,129,1290,178,2025
6824,2011-10-16,4,0,10,21,0,0,0,1,0.54,0.5152,0.52,0.3881,14,210,88,880,102,1090
6825,2011-10-16,4,0,10,22,0,0,0,1,0.56,0.5303,0.49,0.4179,42,630,88,880,130,1510
6826,2011-10-16,4,0,10,23,0,0,0,1,0.56,0.5303,0.52,0.4179,14,210,48,480,62,690
6827,2011-10-17,4,0,10,0,0,1,1,1,0.54,0.5152,0.56,0.3284,12,180,25,250,37,430
6828,2011-10-17,4,0,10,1,0,1,1,1,0.56,0.5303,0.54,0.3881,2,30,15,150,17,180
6829,2011-10-17,4,0,10,2,0,1,1,1,0.56,0.5303,0.54,0.3881,4,60,3,30,7,90
6830,2011-10-17,4,0,10,3,0,1,1,1,0.56,0.5303,0.49,0.194,0,0,2,20,2,20
6831,2011-10-17,4,0,10,4,0,1,1,1,0.52,0.5,0.59,0.1642,2,30,3,30,5,60
6832,2011-10-17,4,0,10,5,0,1,1,1,0.5,0.4848,0.63,0.2985,1,15,28,280,29,295
6833,2011-10-17,4,0,10,6,0,1,1,1,0.5,0.4848,0.55,0.2537,7,105,107,1070,114,1175
6834,2011-10-17,4,0,10,7,0,1,1,2,0.5,0.4848,0.55,0.1642,10,150,299,2990,309,3140
6835,2011-10-17,4,0,10,8,0,1,1,2,0.5,0.4848,0.51,0.2537,33,495,381,3810,414,4305
6836,2011-10-17,4,0,10,9,0,1,1,2,0.5,0.4848,0.45,0.2836,26,390,180,1800,206,2190
6837,2011-10-17,4,0,10,10,0,1,1,1,0.52,0.5,0.45,0.1642,43,645,92,920,135,1565
6838,2011-10-17,4,0,10,11,0,1,1,1,0.56,0.5303,0.43,0.0,35,525,131,1310,166,1835
6839,2011-10-17,4,0,10,12,0,1,1,1,0.56,0.5303,0.4,0.0896,39,585,166,1660,205,2245
6840,2011-10-17,4,0,10,13,0,1,1,1,0.56,0.5303,0.46,0.0896,49,735,156,1560,205,2295
6841,2011-10-17,4,0,10,14,0,1,1,1,0.58,0.5455,0.49,0.194,44,660,122,1220,166,1880
6842,2011-10-17,4,0,10,15,0,1,1,1,0.56,0.5303,0.6,0.2537,66,990,142,1420,208,2410
6843,2011-10-17,4,0,10,16,0,1,1,1,0.58,0.5455,0.56,0.2537,64,960,238,2380,302,3340
6844,2011-10-17,4,0,10,17,0,1,1,1,0.56,0.5303,0.64,0.1343,80,1200,540,5400,620,6600
6845,2011-10-17,4,0,10,18,0,1,1,1,0.56,0.5303,0.6,0.0,49,735,469,4690,518,5425
6846,2011-10-17,4,0,10,19,0,1,1,1,0.54,0.5152,0.68,0.1045,45,675,288,2880,333,3555
6847,2011-10-17,4,0,10,20,0,1,1,1,0.52,0.5,0.77,0.1045,40,600,189,1890,229,2490
6848,2011-10-17,4,0,10,21,0,1,1,1,0.5,0.4848,0.77,0.1045,36,540,141,1410,177,1950
6849,2011-10-17,4,0,10,22,0,1,1,1,0.5,0.4848,0.77,0.0,16,240,88,880,104,1120
6850,2011-10-17,4,0,10,23,0,1,1,2,0.48,0.4697,0.88,0.0,10,150,52,520,62,670
6851,2011-10-18,4,0,10,0,0,2,1,1,0.48,0.4697,0.82,0.0,8,120,23,230,31,350
6852,2011-10-18,4,0,10,1,0,2,1,2,0.46,0.4545,0.88,0.0,4,60,7,70,11,130
6853,2011-10-18,4,0,10,2,0,2,1,1,0.44,0.4394,0.94,0.0896,1,15,4,40,5,55
6854,2011-10-18,4,0,10,3,0,2,1,1,0.44,0.4394,0.94,0.0896,0,0,1,10,1,10
6855,2011-10-18,4,0,10,4,0,2,1,2,0.44,0.4394,0.94,0.1045,0,0,4,40,4,40
6856,2011-10-18,4,0,10,5,0,2,1,2,0.46,0.4545,0.88,0.0,2,30,19,190,21,220
6857,2011-10-18,4,0,10,6,0,2,1,1,0.46,0.4545,0.82,0.0896,4,60,105,1050,109,1110
6858,2011-10-18,4,0,10,7,0,2,1,1,0.46,0.4545,0.88,0.0896,15,225,326,3260,341,3485
6859,2011-10-18,4,0,10,8,0,2,1,1,0.5,0.4848,0.77,0.0896,25,375,474,4740,499,5115
6860,2011-10-18,4,0,10,9,0,2,1,2,0.52,0.5,0.77,0.0896,29,435,198,1980,227,2415
6861,2011-10-18,4,0,10,10,0,2,1,2,0.56,0.5303,0.68,0.0,27,405,75,750,102,1155
6862,2011-10-18,4,0,10,11,0,2,1,2,0.6,0.6212,0.49,0.1045,35,525,112,1120,147,1645
6863,2011-10-18,4,0,10,12,0,2,1,2,0.62,0.6212,0.43,0.0896,42,630,159,1590,201,2220
6864,2011-10-18,4,0,10,13,0,2,1,2,0.64,0.6212,0.38,0.194,48,720,171,1710,219,2430
6865,2011-10-18,4,0,10,14,0,2,1,2,0.62,0.6212,0.41,0.1642,32,480,137,1370,169,1850
6866,2011-10-18,4,0,10,15,0,2,1,1,0.62,0.6212,0.5,0.194,66,990,139,1390,205,2380
6867,2011-10-18,4,0,10,16,0,2,1,1,0.62,0.6212,0.57,0.2537,58,870,246,2460,304,3330
6868,2011-10-18,4,0,10,17,0,2,1,1,0.6,0.6061,0.6,0.1343,72,1080,553,5530,625,6610
6869,2011-10-18,4,0,10,18,0,2,1,1,0.56,0.5303,0.68,0.1045,58,870,512,5120,570,5990
6870,2011-10-18,4,0,10,19,0,2,1,1,0.56,0.5303,0.6,0.1045,31,465,286,2860,317,3325
6871,2011-10-18,4,0,10,20,0,2,1,1,0.54,0.5152,0.64,0.1642,23,345,204,2040,227,2385
6872,2011-10-18,4,0,10,21,0,2,1,2,0.54,0.5152,0.68,0.1343,28,420,178,1780,206,2200
6873,2011-10-18,4,0,10,22,0,2,1,2,0.52,0.5,0.77,0.1642,22,330,115,1150,137,1480
6874,2011-10-18,4,0,10,23,0,2,1,2,0.52,0.5,0.77,0.194,7,105,63,630,70,735
6875,2011-10-19,4,0,10,0,0,3,1,2,0.52,0.5,0.77,0.194,11,165,23,230,34,395
6876,2011-10-19,4,0,10,1,0,3,1,2,0.52,0.5,0.77,0.194,7,105,9,90,16,195
6877,2011-10-19,4,0,10,2,0,3,1,2,0.52,0.5,0.77,0.194,1,15,6,60,7,75
6878,2011-10-19,4,0,10,4,0,3,1,3,0.5,0.4848,0.94,0.194,0,0,3,30,3,30
6879,2011-10-19,4,0,10,5,0,3,1,3,0.5,0.4848,1.0,0.1045,0,0,3,30,3,30
6880,2011-10-19,4,0,10,6,0,3,1,3,0.52,0.5,0.83,0.2537,3,45,28,280,31,325
6881,2011-10-19,4,0,10,7,0,3,1,3,0.52,0.5,0.77,0.2537,1,15,67,670,68,685
6882,2011-10-19,4,0,10,8,0,3,1,3,0.54,0.5152,0.7,0.4925,10,150,200,2000,210,2150
6883,2011-10-19,4,0,10,9,0,3,1,3,0.52,0.5,0.88,0.4925,17,255,185,1850,202,2105
6884,2011-10-19,4,0,10,10,0,3,1,3,0.52,0.5,0.88,0.4925,14,210,109,1090,123,1300
6885,2011-10-19,4,0,10,11,0,3,1,3,0.52,0.5,0.94,0.2537,33,495,116,1160,149,1655
6886,2011-10-19,4,0,10,12,0,3,1,3,0.52,0.5,0.94,0.3284,13,195,117,1170,130,1365
6887,2011-10-19,4,0,10,13,0,3,1,2,0.54,0.5152,0.94,0.2836,20,300,86,860,106,1160
6888,2011-10-19,4,0,10,14,0,3,1,3,0.54,0.5152,0.94,0.1642,17,255,80,800,97,1055
6889,2011-10-19,4,0,10,15,0,3,1,3,0.54,0.5152,1.0,0.1343,21,315,99,990,120,1305
6890,2011-10-19,4,0,10,16,0,3,1,3,0.56,0.5303,0.94,0.1642,21,315,180,1800,201,2115
6891,2011-10-19,4,0,10,17,0,3,1,3,0.56,0.5303,0.94,0.1642,11,165,170,1700,181,1865
6892,2011-10-19,4,0,10,18,0,3,1,3,0.56,0.5303,1.0,0.1642,8,120,132,1320,140,1440
6893,2011-10-19,4,0,10,19,0,3,1,2,0.6,0.5455,0.88,0.1343,8,120,189,1890,197,2010
6894,2011-10-19,4,0,10,20,0,3,1,3,0.6,0.5152,0.94,0.0896,5,75,140,1400,145,1475
6895,2011-10-19,4,0,10,21,0,3,1,2,0.58,0.5455,0.94,0.1343,6,90,79,790,85,880
6896,2011-10-19,4,0,10,22,0,3,1,2,0.58,0.5455,0.94,0.3582,13,195,94,940,107,1135
6897,2011-10-19,4,0,10,23,0,3,1,2,0.58,0.5455,0.94,0.3582,14,210,55,550,69,760
6898,2011-10-20,4,0,10,0,0,4,1,1,0.56,0.5303,0.94,0.2985,4,60,22,220,26,280
6899,2011-10-20,4,0,10,1,0,4,1,1,0.56,0.5303,0.88,0.3582,4,60,11,110,15,170
6900,2011-10-20,4,0,10,2,0,4,1,1,0.56,0.5303,0.88,0.4478,0,0,4,40,4,40
6901,2011-10-20,4,0,10,3,0,4,1,1,0.5,0.4848,0.82,0.4627,0,0,1,10,1,10
6902,2011-10-20,4,0,10,4,0,4,1,1,0.5,0.4848,0.82,0.4627,2,30,6,60,8,90
6903,2011-10-20,4,0,10,5,0,4,1,1,0.48,0.4697,0.82,0.3582,2,30,24,240,26,270
6904,2011-10-20,4,0,10,6,0,4,1,1,0.44,0.4394,0.82,0.4179,5,75,87,870,92,945
6905,2011-10-20,4,0,10,7,0,4,1,1,0.42,0.4242,0.77,0.4478,15,225,303,3030,318,3255
6906,2011-10-20,4,0,10,8,0,4,1,1,0.44,0.4394,0.67,0.5224,17,255,409,4090,426,4345
6907,2011-10-20,4,0,10,9,0,4,1,1,0.44,0.4394,0.67,0.5821,26,390,197,1970,223,2360
6908,2011-10-20,4,0,10,10,0,4,1,1,0.46,0.4545,0.59,0.4478,25,375,105,1050,130,1425
6909,2011-10-20,4,0,10,11,0,4,1,1,0.48,0.4697,0.55,0.5224,30,450,99,990,129,1440
6910,2011-10-20,4,0,10,12,0,4,1,1,0.48,0.4697,0.48,0.5224,28,420,171,1710,199,2130
6911,2011-10-20,4,0,10,13,0,4,1,1,0.5,0.4848,0.45,0.5821,28,420,136,1360,164,1780
6912,2011-10-20,4,0,10,14,0,4,1,2,0.48,0.4697,0.48,0.5522,38,570,117,1170,155,1740
6913,2011-10-20,4,0,10,15,0,4,1,2,0.48,0.4697,0.51,0.4478,22,330,138,1380,160,1710
6914,2011-10-20,4,0,10,16,0,4,1,2,0.48,0.4697,0.51,0.4478,31,465,203,2030,234,2495
6915,2011-10-20,4,0,10,17,0,4,1,2,0.48,0.4697,0.48,0.3881,56,840,438,4380,494,5220
6916,2011-10-20,4,0,10,18,0,4,1,2,0.46,0.4545,0.51,0.2985,39,585,430,4300,469,4885
6917,2011-10-20,4,0,10,19,0,4,1,1,0.46,0.4545,0.51,0.3582,20,300,278,2780,298,3080
6918,2011-10-20,4,0,10,20,0,4,1,2,0.46,0.4545,0.51,0.3284,34,510,207,2070,241,2580
6919,2011-10-20,4,0,10,21,0,4,1,1,0.44,0.4394,0.51,0.2985,16,240,149,1490,165,1730
6920,2011-10-20,4,0,10,22,0,4,1,1,0.44,0.4394,0.51,0.3284,22,330,106,1060,128,1390
6921,2011-10-20,4,0,10,23,0,4,1,1,0.42,0.4242,0.58,0.2537,7,105,83,830,90,935
6922,2011-10-21,4,0,10,0,0,5,1,1,0.4,0.4091,0.62,0.2537,8,120,42,420,50,540
6923,2011-10-21,4,0,10,1,0,5,1,1,0.4,0.4091,0.62,0.2239,7,105,19,190,26,295
6924,2011-10-21,4,0,10,2,0,5,1,1,0.38,0.3939,0.66,0.1642,6,90,12,120,18,210
6925,2011-10-21,4,0,10,3,0,5,1,1,0.36,0.3485,0.71,0.1343,0,0,7,70,7,70
6926,2011-10-21,4,0,10,4,0,5,1,1,0.36,0.3485,0.71,0.1642,0,0,6,60,6,60
6927,2011-10-21,4,0,10,5,0,5,1,1,0.34,0.3333,0.76,0.194,0,0,31,310,31,310
6928,2011-10-21,4,0,10,6,0,5,1,1,0.36,0.3485,0.71,0.1642,7,105,78,780,85,885
6929,2011-10-21,4,0,10,7,0,5,1,1,0.36,0.3485,0.71,0.1642,5,75,228,2280,233,2355
6930,2011-10-21,4,0,10,8,0,5,1,1,0.4,0.4091,0.62,0.194,16,240,386,3860,402,4100
6931,2011-10-21,4,0,10,9,0,5,1,2,0.42,0.4242,0.58,0.1343,33,495,189,1890,222,2385
6932,2011-10-21,4,0,10,10,0,5,1,1,0.46,0.4545,0.51,0.1642,32,480,106,1060,138,1540
6933,2011-10-21,4,0,10,11,0,5,1,1,0.5,0.4848,0.45,0.2239,39,585,135,1350,174,1935
6934,2011-10-21,4,0,10,12,0,5,1,1,0.5,0.4848,0.45,0.2985,47,705,193,1930,240,2635
6935,2011-10-21,4,0,10,13,0,5,1,1,0.48,0.4697,0.48,0.3284,43,645,163,1630,206,2275
6936,2011-10-21,4,0,10,14,0,5,1,1,0.52,0.5,0.42,0.2985,67,1005,131,1310,198,2315
6937,2011-10-21,4,0,10,15,0,5,1,1,0.5,0.4848,0.45,0.2836,57,855,178,1780,235,2635
6938,2011-10-21,4,0,10,16,0,5,1,1,0.5,0.4848,0.45,0.2537,60,900,242,2420,302,3320
6939,2011-10-21,4,0,10,17,0,5,1,2,0.46,0.4545,0.51,0.2537,79,1185,445,4450,524,5635
6940,2011-10-21,4,0,10,18,0,5,1,2,0.44,0.4394,0.54,0.2537,43,645,354,3540,397,4185
6941,2011-10-21,4,0,10,19,0,5,1,2,0.44,0.4394,0.54,0.3881,25,375,228,2280,253,2655
6942,2011-10-21,4,0,10,20,0,5,1,2,0.44,0.4394,0.54,0.2239,29,435,155,1550,184,1985
6943,2011-10-21,4,0,10,21,0,5,1,1,0.42,0.4242,0.58,0.1642,31,465,112,1120,143,1585
6944,2011-10-21,4,0,10,22,0,5,1,1,0.42,0.4242,0.54,0.1642,24,360,89,890,113,1250
6945,2011-10-21,4,0,10,23,0,5,1,1,0.4,0.4091,0.62,0.2239,18,270,99,990,117,1260
6946,2011-10-22,4,0,10,0,0,6,0,1,0.4,0.4091,0.62,0.194,16,240,80,800,96,1040
6947,2011-10-22,4,0,10,1,0,6,0,1,0.4,0.4091,0.62,0.194,20,300,50,500,70,800
6948,2011-10-22,4,0,10,2,0,6,0,1,0.4,0.4091,0.62,0.2537,6,90,25,250,31,340
6949,2011-10-22,4,0,10,3,0,6,0,1,0.4,0.4091,0.62,0.1343,1,15,19,190,20,205
6950,2011-10-22,4,0,10,4,0,6,0,1,0.38,0.3939,0.66,0.0896,4,60,4,40,8,100
6951,2011-10-22,4,0,10,5,0,6,0,1,0.38,0.3939,0.66,0.0,1,15,7,70,8,85
6952,2011-10-22,4,0,10,6,0,6,0,1,0.36,0.3788,0.71,0.0,1,15,17,170,18,185
6953,2011-10-22,4,0,10,7,0,6,0,1,0.36,0.3636,0.76,0.1045,8,120,49,490,57,610
6954,2011-10-22,4,0,10,8,0,6,0,1,0.4,0.4091,0.71,0.0,26,390,88,880,114,1270
6955,2011-10-22,4,0,10,9,0,6,0,1,0.42,0.4242,0.67,0.0896,47,705,122,1220,169,1925
6956,2011-10-22,4,0,10,10,0,6,0,2,0.44,0.4394,0.62,0.1045,87,1305,149,1490,236,2795
6957,2011-10-22,4,0,10,11,0,6,0,2,0.44,0.4394,0.62,0.1045,110,1650,172,1720,282,3370
6958,2011-10-22,4,0,10,12,0,6,0,1,0.46,0.4545,0.55,0.0896,132,1980,211,2110,343,4090
6959,2011-10-22,4,0,10,13,0,6,0,1,0.5,0.4848,0.45,0.0,136,2040,186,1860,322,3900
6960,2011-10-22,4,0,10,14,0,6,0,2,0.48,0.4697,0.48,0.2239,133,1995,177,1770,310,3765
6961,2011-10-22,4,0,10,15,0,6,0,1,0.48,0.4697,0.51,0.2239,159,2385,223,2230,382,4615
6962,2011-10-22,4,0,10,16,0,6,0,1,0.5,0.4848,0.45,0.194,169,2535,190,1900,359,4435
6963,2011-10-22,4,0,10,17,0,6,0,1,0.46,0.4545,0.55,0.1343,143,2145,217,2170,360,4315
6964,2011-10-22,4,0,10,18,0,6,0,1,0.44,0.4394,0.54,0.0896,111,1665,224,2240,335,3905
6965,2011-10-22,4,0,10,19,0,6,0,1,0.44,0.4394,0.67,0.0,47,705,173,1730,220,2435
6966,2011-10-22,4,0,10,20,0,6,0,1,0.42,0.4242,0.67,0.0,48,720,111,1110,159,1830
6967,2011-10-22,4,0,10,21,0,6,0,1,0.4,0.4091,0.76,0.0,37,555,120,1200,157,1755
6968,2011-10-22,4,0,10,22,0,6,0,1,0.4,0.4091,0.76,0.0,30,450,114,1140,144,1590
6969,2011-10-22,4,0,10,23,0,6,0,1,0.38,0.3939,0.82,0.0,27,405,81,810,108,1215
6970,2011-10-23,4,0,10,0,0,0,0,1,0.36,0.3788,0.87,0.0,24,360,64,640,88,1000
6971,2011-10-23,4,0,10,1,0,0,0,1,0.36,0.3788,0.87,0.0,11,165,60,600,71,765
6972,2011-10-23,4,0,10,2,0,0,0,1,0.34,0.3485,0.87,0.0896,10,150,40,400,50,550
6973,2011-10-23,4,0,10,3,0,0,0,1,0.34,0.3636,0.87,0.0,15,225,31,310,46,535
6974,2011-10-23,4,0,10,4,0,0,0,1,0.34,0.3636,0.87,0.0,5,75,1,10,6,85
6975,2011-10-23,4,0,10,5,0,0,0,1,0.32,0.3485,0.87,0.0,1,15,2,20,3,35
6976,2011-10-23,4,0,10,6,0,0,0,1,0.32,0.3333,0.87,0.1045,0,0,12,120,12,120
6977,2011-10-23,4,0,10,7,0,0,0,1,0.34,0.3485,0.87,0.0896,3,45,18,180,21,225
6978,2011-10-23,4,0,10,8,0,0,0,1,0.36,0.3485,0.87,0.1343,32,480,56,560,88,1040
6979,2011-10-23,4,0,10,9,0,0,0,1,0.4,0.4091,0.76,0.0,48,720,95,950,143,1670
6980,2011-10-23,4,0,10,10,0,0,0,1,0.42,0.4242,0.71,0.0896,104,1560,185,1850,289,3410
6981,2011-10-23,4,0,10,11,0,0,0,1,0.46,0.4545,0.72,0.1642,131,1965,202,2020,333,3985
6982,2011-10-23,4,0,10,12,0,0,0,1,0.5,0.4848,0.59,0.2537,164,2460,249,2490,413,4950
6983,2011-10-23,4,0,10,13,0,0,0,1,0.52,0.5,0.55,0.194,160,2400,255,2550,415,4950
6984,2011-10-23,4,0,10,14,0,0,0,1,0.52,0.5,0.55,0.2239,192,2880,216,2160,408,5040
6985,2011-10-23,4,0,10,15,0,0,0,1,0.52,0.5,0.52,0.1642,171,2565,216,2160,387,4725
6986,2011-10-23,4,0,10,16,0,0,0,1,0.52,0.5,0.55,0.194,188,2820,217,2170,405,4990
6987,2011-10-23,4,0,10,17,0,0,0,1,0.5,0.4848,0.63,0.1343,120,1800,220,2200,340,4000
6988,2011-10-23,4,0,10,18,0,0,0,1,0.5,0.4848,0.63,0.1045,88,1320,196,1960,284,3280
6989,2011-10-23,4,0,10,19,0,0,0,1,0.46,0.4545,0.77,0.0,53,795,140,1400,193,2195
6990,2011-10-23,4,0,10,20,0,0,0,1,0.44,0.4394,0.72,0.0896,32,480,112,1120,144,1600
6991,2011-10-23,4,0,10,21,0,0,0,1,0.44,0.4394,0.72,0.0896,24,360,75,750,99,1110
6992,2011-10-23,4,0,10,22,0,0,0,1,0.42,0.4242,0.77,0.1045,25,375,69,690,94,1065
6993,2011-10-23,4,0,10,23,0,0,0,1,0.42,0.4242,0.77,0.1642,18,270,31,310,49,580
6994,2011-10-24,4,0,10,0,0,1,1,1,0.42,0.4242,0.77,0.0,6,90,26,260,32,350
6995,2011-10-24,4,0,10,1,0,1,1,1,0.4,0.4091,0.82,0.1343,7,105,8,80,15,185
6996,2011-10-24,4,0,10,2,0,1,1,1,0.4,0.4091,0.87,0.1045,1,15,6,60,7,75
6997,2011-10-24,4,0,10,3,0,1,1,1,0.4,0.4091,0.82,0.0896,1,15,3,30,4,45
6998,2011-10-24,4,0,10,4,0,1,1,1,0.4,0.4091,0.82,0.0,1,15,5,50,6,65
6999,2011-10-24,4,0,10,5,0,1,1,1,0.38,0.3939,0.87,0.0,2,30,19,190,21,220
7000,2011-10-24,4,0,10,6,0,1,1,1,0.4,0.4091,0.87,0.1045,3,45,83,830,86,875
7001,2011-10-24,4,0,10,7,0,1,1,2,0.38,0.3939,0.94,0.1045,11,165,274,2740,285,2905
7002,2011-10-24,4,0,10,8,0,1,1,2,0.42,0.4242,0.88,0.1642,20,300,378,3780,398,4080
7003,2011-10-24,4,0,10,9,0,1,1,2,0.44,0.4394,0.82,0.1642,29,435,166,1660,195,2095
7004,2011-10-24,4,0,10,10,0,1,1,2,0.46,0.4545,0.82,0.2537,47,705,82,820,129,1525
7005,2011-10-24,4,0,10,11,0,1,1,2,0.5,0.4848,0.72,0.1642,59,885,109,1090,168,1975
7006,2011-10-24,4,0,10,12,0,1,1,2,0.52,0.5,0.68,0.1045,64,960,156,1560,220,2520
7007,2011-10-24,4,0,10,13,0,1,1,2,0.54,0.5152,0.64,0.2239,60,900,138,1380,198,2280
7008,2011-10-24,4,0,10,14,0,1,1,2,0.54,0.5152,0.64,0.194,63,945,143,1430,206,2375
7009,2011-10-24,4,0,10,15,0,1,1,1,0.56,0.5303,0.6,0.1642,52,780,125,1250,177,2030
7010,2011-10-24,4,0,10,16,0,1,1,1,0.54,0.5152,0.64,0.194,68,1020,242,2420,310,3440
7011,2011-10-24,4,0,10,17,0,1,1,1,0.52,0.5,0.68,0.1343,87,1305,527,5270,614,6575
7012,2011-10-24,4,0,10,18,0,1,1,1,0.54,0.5152,0.6,0.0896,58,870,428,4280,486,5150
7013,2011-10-24,4,0,10,19,0,1,1,3,0.48,0.4697,0.82,0.0,25,375,212,2120,237,2495
7014,2011-10-24,4,0,10,20,0,1,1,1,0.48,0.4697,0.82,0.1045,11,165,118,1180,129,1345
7015,2011-10-24,4,0,10,21,0,1,1,1,0.46,0.4545,0.87,0.1045,12,180,114,1140,126,1320
7016,2011-10-24,4,0,10,22,0,1,1,1,0.48,0.4697,0.75,0.1642,3,45,76,760,79,805
7017,2011-10-24,4,0,10,23,0,1,1,1,0.46,0.4545,0.77,0.0896,9,135,50,500,59,635
7018,2011-10-25,4,0,10,0,0,2,1,1,0.44,0.4394,0.77,0.1343,4,60,26,260,30,320
7019,2011-10-25,4,0,10,1,0,2,1,1,0.44,0.4394,0.77,0.1343,5,75,6,60,11,135
7020,2011-10-25,4,0,10,2,0,2,1,1,0.42,0.4242,0.82,0.1343,2,30,3,30,5,60
7021,2011-10-25,4,0,10,3,0,2,1,1,0.4,0.4091,0.87,0.0,1,15,3,30,4,45
7022,2011-10-25,4,0,10,4,0,2,1,1,0.38,0.3939,0.87,0.1343,0,0,5,50,5,50
7023,2011-10-25,4,0,10,5,0,2,1,1,0.38,0.3939,0.87,0.1343,0,0,24,240,24,240
7024,2011-10-25,4,0,10,6,0,2,1,1,0.38,0.3939,0.82,0.1045,3,45,95,950,98,995
7025,2011-10-25,4,0,10,7,0,2,1,1,0.4,0.4091,0.76,0.194,15,225,299,2990,314,3215
7026,2011-10-25,4,0,10,8,0,2,1,1,0.44,0.4394,0.72,0.0,25,375,383,3830,408,4205
7027,2011-10-25,4,0,10,9,0,2,1,1,0.48,0.4697,0.55,0.2239,29,435,194,1940,223,2375
7028,2011-10-25,4,0,10,10,0,2,1,1,0.5,0.4848,0.51,0.2537,26,390,102,1020,128,1410
7029,2011-10-25,4,0,10,11,0,2,1,1,0.52,0.5,0.48,0.2836,46,690,120,1200,166,1890
7030,2011-10-25,4,0,10,12,0,2,1,1,0.54,0.5152,0.39,0.3582,35,525,165,1650,200,2175
7031,2011-10-25,4,0,10,13,0,2,1,1,0.56,0.5303,0.37,0.3881,37,555,161,1610,198,2165
7032,2011-10-25,4,0,10,14,0,2,1,1,0.56,0.5303,0.4,0.2537,66,990,134,1340,200,2330
7033,2011-10-25,4,0,10,15,0,2,1,1,0.56,0.5303,0.37,0.1045,63,945,171,1710,234,2655
7034,2011-10-25,4,0,10,16,0,2,1,1,0.56,0.5303,0.37,0.194,52,780,233,2330,285,3110
7035,2011-10-25,4,0,10,17,0,2,1,1,0.56,0.5303,0.37,0.1045,68,1020,517,5170,585,6190
7036,2011-10-25,4,0,10,18,0,2,1,1,0.52,0.5,0.42,0.1045,65,975,453,4530,518,5505
7037,2011-10-25,4,0,10,19,0,2,1,1,0.48,0.4697,0.67,0.194,44,660,294,2940,338,3600
7038,2011-10-25,4,0,10,20,0,2,1,1,0.46,0.4545,0.67,0.1045,40,600,208,2080,248,2680
7039,2011-10-25,4,0,10,21,0,2,1,1,0.44,0.4394,0.72,0.1343,32,480,169,1690,201,2170
7040,2011-10-25,4,0,10,22,0,2,1,1,0.46,0.4545,0.67,0.194,22,330,148,1480,170,1810
7041,2011-10-25,4,0,10,23,0,2,1,1,0.44,0.4394,0.72,0.1343,15,225,79,790,94,1015
7042,2011-10-26,4,0,10,0,0,3,1,1,0.44,0.4394,0.72,0.194,4,60,28,280,32,340
7043,2011-10-26,4,0,10,1,0,3,1,1,0.44,0.4394,0.67,0.2537,3,45,9,90,12,135
7044,2011-10-26,4,0,10,2,0,3,1,1,0.44,0.4394,0.67,0.1642,2,30,1,10,3,40
7045,2011-10-26,4,0,10,3,0,3,1,1,0.44,0.4394,0.67,0.2239,0,0,3,30,3,30
7046,2011-10-26,4,0,10,4,0,3,1,1,0.42,0.4242,0.71,0.2537,0,0,5,50,5,50
7047,2011-10-26,4,0,10,5,0,3,1,1,0.42,0.4242,0.71,0.2239,0,0,21,210,21,210
7048,2011-10-26,4,0,10,6,0,3,1,1,0.42,0.4242,0.71,0.2239,0,0,92,920,92,920
7049,2011-10-26,4,0,10,7,0,3,1,1,0.42,0.4242,0.71,0.1642,15,225,284,2840,299,3065
7050,2011-10-26,4,0,10,8,0,3,1,2,0.44,0.4394,0.67,0.194,26,390,438,4380,464,4770
7051,2011-10-26,4,0,10,9,0,3,1,2,0.48,0.4697,0.63,0.2239,14,210,226,2260,240,2470
7052,2011-10-26,4,0,10,10,0,3,1,2,0.52,0.5,0.62,0.2537,26,390,105,1050,131,1440
7053,2011-10-26,4,0,10,11,0,3,1,1,0.52,0.5,0.59,0.3284,23,345,132,1320,155,1665
7054,2011-10-26,4,0,10,12,0,3,1,3,0.58,0.5455,0.53,0.2239,39,585,155,1550,194,2135
7055,2011-10-26,4,0,10,13,0,3,1,3,0.56,0.5303,0.6,0.1045,20,300,62,620,82,920
7056,2011-10-26,4,0,10,14,0,3,1,2,0.52,0.5,0.77,0.0,14,210,52,520,66,730
7057,2011-10-26,4,0,10,15,0,3,1,2,0.52,0.5,0.77,0.0,11,165,59,590,70,755
7058,2011-10-26,4,0,10,16,0,3,1,2,0.52,0.5,0.77,0.0896,17,255,196,1960,213,2215
7059,2011-10-26,4,0,10,17,0,3,1,2,0.52,0.5,0.77,0.1045,40,600,414,4140,454,4740
7060,2011-10-26,4,0,10,18,0,3,1,1,0.52,0.5,0.77,0.1642,55,825,398,3980,453,4805
7061,2011-10-26,4,0,10,19,0,3,1,1,0.5,0.4848,0.82,0.0,25,375,306,3060,331,3435
7062,2011-10-26,4,0,10,20,0,3,1,1,0.5,0.4848,0.88,0.0,27,405,180,1800,207,2205
7063,2011-10-26,4,0,10,21,0,3,1,2,0.52,0.5,0.77,0.0,17,255,140,1400,157,1655
7064,2011-10-26,4,0,10,22,0,3,1,2,0.48,0.4697,0.88,0.0896,23,345,112,1120,135,1465
7065,2011-10-26,4,0,10,23,0,3,1,2,0.48,0.4697,0.88,0.0896,3,45,72,720,75,765
7066,2011-10-27,4,0,10,0,0,4,1,1,0.46,0.4545,0.94,0.0,3,45,23,230,26,275
7067,2011-10-27,4,0,10,1,0,4,1,1,0.46,0.4545,0.94,0.0,2,30,9,90,11,120
7068,2011-10-27,4,0,10,2,0,4,1,3,0.46,0.4545,0.94,0.0,3,45,5,50,8,95
7069,2011-10-27,4,0,10,3,0,4,1,3,0.46,0.4545,0.94,0.0,1,15,3,30,4,45
7070,2011-10-27,4,0,10,4,0,4,1,3,0.48,0.4697,0.88,0.0,1,15,3,30,4,45
7071,2011-10-27,4,0,10,5,0,4,1,3,0.48,0.4697,0.88,0.0896,1,15,14,140,15,155
7072,2011-10-27,4,0,10,6,0,4,1,3,0.5,0.4848,0.82,0.0,4,60,42,420,46,480
7073,2011-10-27,4,0,10,7,0,4,1,2,0.46,0.4545,0.94,0.0896,9,135,128,1280,137,1415
7074,2011-10-27,4,0,10,8,0,4,1,3,0.48,0.4697,0.88,0.194,12,180,304,3040,316,3220
7075,2011-10-27,4,0,10,9,0,4,1,2,0.5,0.4848,0.82,0.1642,16,240,155,1550,171,1790
7076,2011-10-27,4,0,10,10,0,4,1,3,0.5,0.4848,0.88,0.194,10,150,52,520,62,670
7077,2011-10-27,4,0,10,11,0,4,1,3,0.5,0.4848,0.88,0.1343,8,120,44,440,52,560
7078,2011-10-27,4,0,10,12,0,4,1,3,0.5,0.4848,0.88,0.1343,8,120,45,450,53,570
7079,2011-10-27,4,0,10,13,0,4,1,2,0.5,0.4848,0.88,0.1642,10,150,64,640,74,790
7080,2011-10-27,4,0,10,14,0,4,1,2,0.52,0.5,0.83,0.0,16,240,76,760,92,1000
7081,2011-10-27,4,0,10,15,0,4,1,2,0.52,0.5,0.83,0.1045,12,180,95,950,107,1130
7082,2011-10-27,4,0,10,16,0,4,1,2,0.56,0.5303,0.73,0.1642,14,210,193,1930,207,2140
7083,2011-10-27,4,0,10,17,0,4,1,2,0.5,0.4848,0.72,0.4627,31,465,291,2910,322,3375
7084,2011-10-27,4,0,10,18,0,4,1,2,0.48,0.4697,0.67,0.4627,14,210,226,2260,240,2470
7085,2011-10-27,4,0,10,19,0,4,1,2,0.44,0.4394,0.67,0.4627,19,285,200,2000,219,2285
7086,2011-10-27,4,0,10,20,0,4,1,1,0.42,0.4242,0.67,0.4925,11,165,171,1710,182,1875
7087,2011-10-27,4,0,10,21,0,4,1,1,0.4,0.4091,0.62,0.5224,13,195,119,1190,132,1385
7088,2011-10-27,4,0,10,22,0,4,1,1,0.36,0.3182,0.66,0.4925,14,210,97,970,111,1180
7089,2011-10-27,4,0,10,23,0,4,1,1,0.34,0.303,0.61,0.4179,8,120,60,600,68,720
7090,2011-10-28,4,0,10,0,0,5,1,1,0.34,0.3182,0.66,0.2537,4,60,40,400,44,460
7091,2011-10-28,4,0,10,1,0,5,1,1,0.32,0.303,0.66,0.2537,7,105,9,90,16,195
7092,2011-10-28,4,0,10,2,0,5,1,1,0.32,0.303,0.66,0.2836,1,15,3,30,4,45
7093,2011-10-28,4,0,10,3,0,5,1,1,0.3,0.2879,0.7,0.2836,4,60,4,40,8,100
7094,2011-10-28,4,0,10,4,0,5,1,1,0.3,0.2879,0.65,0.2836,5,75,5,50,10,125
7095,2011-10-28,4,0,10,5,0,5,1,2,0.3,0.2879,0.61,0.2537,0,0,25,250,25,250
7096,2011-10-28,4,0,10,6,0,5,1,1,0.28,0.2727,0.65,0.2537,1,15,74,740,75,755
7097,2011-10-28,4,0,10,7,0,5,1,1,0.28,0.2727,0.65,0.2537,6,90,199,1990,205,2080
7098,2011-10-28,4,0,10,8,0,5,1,1,0.3,0.2879,0.61,0.2836,13,195,361,3610,374,3805
7099,2011-10-28,4,0,10,9,0,5,1,1,0.32,0.303,0.57,0.2239,19,285,210,2100,229,2385
7100,2011-10-28,4,0,10,10,0,5,1,1,0.34,0.3182,0.57,0.2239,28,420,102,1020,130,1440
7101,2011-10-28,4,0,10,11,0,5,1,1,0.36,0.3485,0.5,0.2239,40,600,128,1280,168,1880
7102,2011-10-28,4,0,10,12,0,5,1,2,0.38,0.3939,0.4,0.1642,46,690,167,1670,213,2360
7103,2011-10-28,4,0,10,13,0,5,1,2,0.38,0.3939,0.42,0.2239,43,645,185,1850,228,2495
7104,2011-10-28,4,0,10,14,0,5,1,2,0.36,0.3485,0.46,0.194,33,495,152,1520,185,2015
7105,2011-10-28,4,0,10,15,0,5,1,2,0.36,0.3333,0.43,0.2537,44,660,171,1710,215,2370
7106,2011-10-28,4,0,10,16,0,5,1,2,0.36,0.3485,0.46,0.1642,46,690,262,2620,308,3310
7107,2011-10-28,4,0,10,17,0,5,1,2,0.36,0.3485,0.5,0.1343,35,525,411,4110,446,4635
7108,2011-10-28,4,0,10,18,0,5,1,2,0.36,0.3485,0.53,0.1642,36,540,332,3320,368,3860
7109,2011-10-28,4,0,10,19,0,5,1,2,0.36,0.3485,0.5,0.1343,16,240,188,1880,204,2120
7110,2011-10-28,4,0,10,20,0,5,1,3,0.34,0.3182,0.61,0.2239,12,180,131,1310,143,1490
7111,2011-10-28,4,0,10,21,0,5,1,3,0.32,0.3182,0.7,0.1642,5,75,69,690,74,765
7112,2011-10-28,4,0,10,22,0,5,1,3,0.3,0.2879,0.75,0.2836,4,60,32,320,36,380
7113,2011-10-28,4,0,10,23,0,5,1,3,0.3,0.2727,0.81,0.3284,8,120,31,310,39,430
7114,2011-10-29,4,0,10,0,0,6,0,3,0.28,0.2576,0.87,0.2985,0,0,19,190,19,190
7115,2011-10-29,4,0,10,1,0,6,0,3,0.3,0.2727,0.87,0.2985,0,0,18,180,18,180
7116,2011-10-29,4,0,10,2,0,6,0,3,0.3,0.2727,0.87,0.2985,1,15,16,160,17,175
7117,2011-10-29,4,0,10,3,0,6,0,3,0.3,0.2727,0.81,0.4179,0,0,8,80,8,80
7118,2011-10-29,4,0,10,4,0,6,0,3,0.3,0.2727,0.81,0.4179,0,0,1,10,1,10
7119,2011-10-29,4,0,10,5,0,6,0,3,0.26,0.2273,0.93,0.3582,0,0,1,10,1,10
7120,2011-10-29,4,0,10,6,0,6,0,3,0.26,0.2273,0.87,0.3582,4,60,1,10,5,70
7121,2011-10-29,4,0,10,7,0,6,0,3,0.26,0.2273,0.87,0.3582,1,15,6,60,7,75
7122,2011-10-29,4,0,10,8,0,6,0,3,0.28,0.2576,0.87,0.3582,4,60,16,160,20,220
7123,2011-10-29,4,0,10,9,0,6,0,3,0.28,0.2576,0.87,0.3582,1,15,19,190,20,205
7124,2011-10-29,4,0,10,10,0,6,0,3,0.26,0.2273,0.93,0.3284,0,0,12,120,12,120
7125,2011-10-29,4,0,10,11,0,6,0,3,0.26,0.2273,0.93,0.3881,1,15,26,260,27,275
7126,2011-10-29,4,0,10,12,0,6,0,3,0.24,0.197,0.87,0.4925,6,90,44,440,50,530
7127,2011-10-29,4,0,10,13,0,6,0,3,0.24,0.197,0.87,0.5224,0,0,30,300,30,300
7128,2011-10-29,4,0,10,14,0,6,0,3,0.24,0.197,0.87,0.4478,0,0,29,290,29,290
7129,2011-10-29,4,0,10,15,0,6,0,3,0.22,0.2121,0.93,0.2537,3,45,38,380,41,425
7130,2011-10-29,4,0,10,16,0,6,0,3,0.22,0.197,0.93,0.3284,3,45,19,190,22,235
7131,2011-10-29,4,0,10,17,0,6,0,3,0.22,0.197,0.93,0.3284,3,45,28,280,31,325
7132,2011-10-29,4,0,10,18,0,6,0,3,0.22,0.197,0.93,0.3284,6,90,37,370,43,460
7133,2011-10-29,4,0,10,19,0,6,0,1,0.24,0.2121,0.87,0.3582,3,45,36,360,39,405
7134,2011-10-29,4,0,10,20,0,6,0,1,0.24,0.2121,0.87,0.3582,7,105,40,400,47,505
7135,2011-10-29,4,0,10,21,0,6,0,1,0.24,0.2121,0.87,0.3582,1,15,49,490,50,505
7136,2011-10-29,4,0,10,22,0,6,0,1,0.22,0.2121,0.87,0.2239,10,150,44,440,54,590
7137,2011-10-29,4,0,10,23,0,6,0,1,0.22,0.2273,0.87,0.194,3,45,33,330,36,375
7138,2011-10-30,4,0,10,0,0,0,0,1,0.22,0.2121,0.87,0.2239,7,105,47,470,54,575
7139,2011-10-30,4,0,10,1,0,0,0,1,0.22,0.2121,0.87,0.2537,9,135,34,340,43,475
7140,2011-10-30,4,0,10,2,0,0,0,1,0.22,0.2121,0.87,0.2836,7,105,43,430,50,535
7141,2011-10-30,4,0,10,3,0,0,0,1,0.24,0.2121,0.75,0.3582,7,105,26,260,33,365
7142,2011-10-30,4,0,10,4,0,0,0,1,0.22,0.197,0.8,0.3284,1,15,10,100,11,115
7143,2011-10-30,4,0,10,5,0,0,0,1,0.24,0.2121,0.75,0.2985,0,0,4,40,4,40
7144,2011-10-30,4,0,10,6,0,0,0,1,0.24,0.2273,0.75,0.2537,2,30,8,80,10,110
7145,2011-10-30,4,0,10,7,0,0,0,1,0.24,0.2879,0.75,0.0,7,105,15,150,22,255
7146,2011-10-30,4,0,10,8,0,0,0,1,0.26,0.2576,0.7,0.2239,20,300,60,600,80,900
7147,2011-10-30,4,0,10,9,0,0,0,1,0.3,0.2879,0.65,0.2537,55,825,92,920,147,1745
7148,2011-10-30,4,0,10,10,0,0,0,1,0.32,0.3333,0.61,0.0896,53,795,125,1250,178,2045
7149,2011-10-30,4,0,10,11,0,0,0,1,0.36,0.3485,0.53,0.2239,58,870,182,1820,240,2690
7150,2011-10-30,4,0,10,12,0,0,0,1,0.38,0.3939,0.5,0.194,85,1275,229,2290,314,3565
7151,2011-10-30,4,0,10,13,0,0,0,1,0.4,0.4091,0.43,0.2239,113,1695,232,2320,345,4015
7152,2011-10-30,4,0,10,14,0,0,0,1,0.42,0.4242,0.38,0.194,91,1365,209,2090,300,3455
7153,2011-10-30,4,0,10,15,0,0,0,1,0.42,0.4242,0.35,0.1642,88,1320,202,2020,290,3340
7154,2011-10-30,4,0,10,16,0,0,0,1,0.42,0.4242,0.32,0.1343,107,1605,213,2130,320,3735
7155,2011-10-30,4,0,10,17,0,0,0,1,0.4,0.4091,0.35,0.1045,54,810,191,1910,245,2720
7156,2011-10-30,4,0,10,18,0,0,0,1,0.36,0.3485,0.4,0.1343,51,765,162,1620,213,2385
7157,2011-10-30,4,0,10,19,0,0,0,1,0.56,0.5303,0.49,0.2985,28,420,125,1250,153,1670
7158,2011-10-30,4,0,10,20,0,0,0,1,0.34,0.3636,0.57,0.0,18,270,74,740,92,1010
7159,2011-10-30,4,0,10,21,0,0,0,1,0.32,0.3485,0.66,0.0,4,60,75,750,79,810
7160,2011-10-30,4,0,10,22,0,0,0,1,0.3,0.3333,0.75,0.0,13,195,58,580,71,775
7161,2011-10-30,4,0,10,23,0,0,0,1,0.26,0.303,0.87,0.0,7,105,30,300,37,405
7162,2011-10-31,4,0,10,0,0,1,1,1,0.26,0.303,0.87,0.0,3,45,20,200,23,245
7163,2011-10-31,4,0,10,1,0,1,1,1,0.26,0.303,0.81,0.0,5,75,8,80,13,155
7164,2011-10-31,4,0,10,2,0,1,1,1,0.24,0.2879,0.87,0.0,0,0,3,30,3,30
7165,2011-10-31,4,0,10,3,0,1,1,1,0.24,0.2576,0.87,0.1045,0,0,3,30,3,30
7166,2011-10-31,4,0,10,4,0,1,1,1,0.24,0.2879,0.87,0.0,1,15,5,50,6,65
7167,2011-10-31,4,0,10,5,0,1,1,1,0.22,0.2727,0.93,0.0,0,0,18,180,18,180
7168,2011-10-31,4,0,10,6,0,1,1,1,0.24,0.2879,0.87,0.0,4,60,82,820,86,880
7169,2011-10-31,4,0,10,7,0,1,1,1,0.24,0.2879,0.93,0.0,11,165,216,2160,227,2325
7170,2011-10-31,4,0,10,8,0,1,1,2,0.28,0.3182,0.87,0.0,17,255,355,3550,372,3805
7171,2011-10-31,4,0,10,9,0,1,1,2,0.32,0.3182,0.76,0.1642,14,210,197,1970,211,2180
7172,2011-10-31,4,0,10,10,0,1,1,2,0.36,0.3485,0.57,0.1642,18,270,87,870,105,1140
7173,2011-10-31,4,0,10,11,0,1,1,1,0.4,0.4091,0.5,0.1343,31,465,97,970,128,1435
7174,2011-10-31,4,0,10,12,0,1,1,1,0.42,0.4242,0.44,0.2239,30,450,140,1400,170,1850
7175,2011-10-31,4,0,10,13,0,1,1,2,0.44,0.4394,0.44,0.2239,24,360,128,1280,152,1640
7176,2011-10-31,4,0,10,14,0,1,1,2,0.44,0.4394,0.47,0.2239,22,330,119,1190,141,1520
7177,2011-10-31,4,0,10,15,0,1,1,1,0.44,0.4394,0.47,0.1642,27,405,141,1410,168,1815
7178,2011-10-31,4,0,10,16,0,1,1,1,0.42,0.4242,0.54,0.1642,30,450,242,2420,272,2870
7179,2011-10-31,4,0,10,17,0,1,1,1,0.42,0.4242,0.54,0.1343,44,660,442,4420,486,5080
7180,2011-10-31,4,0,10,18,0,1,1,1,0.4,0.4091,0.66,0.0896,30,450,392,3920,422,4370
7181,2011-10-31,4,0,10,19,0,1,1,1,0.4,0.4091,0.66,0.0896,12,180,226,2260,238,2440
7182,2011-10-31,4,0,10,20,0,1,1,1,0.4,0.4091,0.66,0.0896,18,270,154,1540,172,1810
7183,2011-10-31,4,0,10,21,0,1,1,2,0.36,0.3485,0.76,0.194,7,105,109,1090,116,1195
7184,2011-10-31,4,0,10,22,0,1,1,2,0.36,0.3485,0.76,0.194,8,120,77,770,85,890
7185,2011-10-31,4,0,10,23,0,1,1,2,0.36,0.3485,0.76,0.194,6,90,46,460,52,550
7186,2011-11-01,4,0,11,0,0,2,1,2,0.36,0.3485,0.87,0.1642,3,45,18,180,21,225
7187,2011-11-01,4,0,11,1,0,2,1,1,0.36,0.3485,0.81,0.1343,3,45,8,80,11,125
7188,2011-11-01,4,0,11,2,0,2,1,2,0.36,0.3485,0.81,0.1642,1,15,3,30,4,45
7189,2011-11-01,4,0,11,3,0,2,1,2,0.36,0.3485,0.81,0.1343,1,15,5,50,6,65
7190,2011-11-01,4,0,11,4,0,2,1,1,0.34,0.3182,0.81,0.2239,1,15,7,70,8,85
7191,2011-11-01,4,0,11,5,0,2,1,1,0.32,0.3182,0.81,0.194,0,0,18,180,18,180
7192,2011-11-01,4,0,11,6,0,2,1,1,0.32,0.3182,0.81,0.194,3,45,90,900,93,945
7193,2011-11-01,4,0,11,7,0,2,1,1,0.34,0.3333,0.76,0.194,8,120,246,2460,254,2580
7194,2011-11-01,4,0,11,8,0,2,1,1,0.36,0.3333,0.71,0.2537,17,255,402,4020,419,4275
7195,2011-11-01,4,0,11,9,0,2,1,1,0.4,0.4091,0.66,0.1642,16,240,206,2060,222,2300
7196,2011-11-01,4,0,11,10,0,2,1,1,0.44,0.4394,0.62,0.1343,21,315,114,1140,135,1455
7197,2011-11-01,4,0,11,11,0,2,1,1,0.46,0.4545,0.63,0.1045,16,240,101,1010,117,1250
7198,2011-11-01,4,0,11,12,0,2,1,1,0.5,0.4848,0.48,0.0896,23,345,153,1530,176,1875
7199,2011-11-01,4,0,11,13,0,2,1,1,0.48,0.4697,0.55,0.194,20,300,147,1470,167,1770
7200,2011-11-01,4,0,11,14,0,2,1,1,0.5,0.4848,0.48,0.2537,32,480,118,1180,150,1660
7201,2011-11-01,4,0,11,15,0,2,1,1,0.5,0.4848,0.45,0.1343,38,570,148,1480,186,2050
7202,2011-11-01,4,0,11,16,0,2,1,1,0.48,0.4697,0.44,0.1642,46,690,252,2520,298,3210
7203,2011-11-01,4,0,11,17,0,2,1,1,0.44,0.4394,0.54,0.1642,36,540,470,4700,506,5240
7204,2011-11-01,4,0,11,18,0,2,1,1,0.42,0.4242,0.58,0.1045,39,585,421,4210,460,4795
7205,2011-11-01,4,0,11,19,0,2,1,1,0.42,0.4242,0.58,0.0896,39,585,274,2740,313,3325
7206,2011-11-01,4,0,11,20,0,2,1,1,0.4,0.4091,0.71,0.0,18,270,191,1910,209,2180
7207,2011-11-01,4,0,11,21,0,2,1,1,0.36,0.3788,0.81,0.0,13,195,114,1140,127,1335
7208,2011-11-01,4,0,11,22,0,2,1,1,0.36,0.3788,0.81,0.0,5,75,91,910,96,985
7209,2011-11-01,4,0,11,23,0,2,1,1,0.34,0.3636,0.87,0.0,11,165,61,610,72,775
7210,2011-11-02,4,0,11,0,0,3,1,1,0.32,0.3485,0.87,0.0,0,0,19,190,19,190
7211,2011-11-02,4,0,11,1,0,3,1,1,0.3,0.3333,0.87,0.0,2,30,8,80,10,110
7212,2011-11-02,4,0,11,2,0,3,1,1,0.3,0.3333,0.87,0.0,0,0,2,20,2,20
7213,2011-11-02,4,0,11,3,0,3,1,1,0.3,0.3333,0.75,0.0,0,0,2,20,2,20
7214,2011-11-02,4,0,11,4,0,3,1,1,0.3,0.3333,0.87,0.0,0,0,4,40,4,40
7215,2011-11-02,4,0,11,5,0,3,1,1,0.3,0.3333,0.81,0.0,0,0,27,270,27,270
7216,2011-11-02,4,0,11,6,0,3,1,1,0.3,0.3333,0.81,0.0,1,15,91,910,92,925
7217,2011-11-02,4,0,11,7,0,3,1,1,0.3,0.3333,0.81,0.0,11,165,240,2400,251,2565
7218,2011-11-02,4,0,11,8,0,3,1,1,0.32,0.3485,0.87,0.0,20,300,452,4520,472,4820
7219,2011-11-02,4,0,11,9,0,3,1,1,0.34,0.3636,0.87,0.0,15,225,213,2130,228,2355
7220,2011-11-02,4,0,11,10,0,3,1,1,0.4,0.4091,0.71,0.0896,25,375,108,1080,133,1455
7221,2011-11-02,4,0,11,11,0,3,1,1,0.42,0.4242,0.71,0.1343,27,405,117,1170,144,1575
7222,2011-11-02,4,0,11,12,0,3,1,1,0.46,0.4545,0.55,0.1642,32,480,157,1570,189,2050
7223,2011-11-02,4,0,11,13,0,3,1,1,0.48,0.4697,0.48,0.1642,22,330,139,1390,161,1720
7224,2011-11-02,4,0,11,14,0,3,1,1,0.5,0.4848,0.45,0.1642,40,600,132,1320,172,1920
7225,2011-11-02,4,0,11,15,0,3,1,1,0.48,0.4697,0.51,0.1642,26,390,161,1610,187,2000
7226,2011-11-02,4,0,11,16,0,3,1,1,0.48,0.4697,0.51,0.1045,35,525,231,2310,266,2835
7227,2011-11-02,4,0,11,17,0,3,1,1,0.44,0.4394,0.62,0.194,30,450,523,5230,553,5680
7228,2011-11-02,4,0,11,18,0,3,1,1,0.42,0.4242,0.71,0.1642,31,465,448,4480,479,4945
7229,2011-11-02,4,0,11,19,0,3,1,1,0.4,0.4091,0.76,0.1343,25,375,257,2570,282,2945
7230,2011-11-02,4,0,11,20,0,3,1,1,0.4,0.4091,0.66,0.1343,5,75,177,1770,182,1845
7231,2011-11-02,4,0,11,21,0,3,1,1,0.38,0.3939,0.71,0.1343,13,195,155,1550,168,1745
7232,2011-11-02,4,0,11,22,0,3,1,1,0.36,0.3485,0.71,0.1343,7,105,99,990,106,1095
7233,2011-11-02,4,0,11,23,0,3,1,1,0.36,0.3636,0.76,0.0896,3,45,54,540,57,585
7234,2011-11-03,4,0,11,0,0,4,1,1,0.36,0.3636,0.76,0.0896,3,45,28,280,31,325
7235,2011-11-03,4,0,11,1,0,4,1,1,0.34,0.3333,0.81,0.1343,3,45,12,120,15,165
7236,2011-11-03,4,0,11,2,0,4,1,1,0.34,0.3333,0.76,0.1343,2,30,5,50,7,80
7237,2011-11-03,4,0,11,3,0,4,1,1,0.34,0.3333,0.81,0.1343,1,15,4,40,5,55
7238,2011-11-03,4,0,11,4,0,4,1,1,0.32,0.3333,0.81,0.0896,1,15,3,30,4,45
7239,2011-11-03,4,0,11,5,0,4,1,1,0.32,0.3333,0.81,0.1343,1,15,27,270,28,285
7240,2011-11-03,4,0,11,6,0,4,1,1,0.34,0.3333,0.76,0.194,3,45,96,960,99,1005
7241,2011-11-03,4,0,11,7,0,4,1,2,0.32,0.3333,0.81,0.0896,12,180,280,2800,292,2980
7242,2011-11-03,4,0,11,8,0,4,1,2,0.34,0.3485,0.81,0.0896,8,120,394,3940,402,4060
7243,2011-11-03,4,0,11,9,0,4,1,2,0.36,0.3485,0.81,0.194,9,135,155,1550,164,1685
7244,2011-11-03,4,0,11,10,0,4,1,2,0.4,0.4091,0.76,0.194,12,180,98,980,110,1160
7245,2011-11-03,4,0,11,11,0,4,1,1,0.44,0.4394,0.67,0.194,12,180,108,1080,120,1260
7246,2011-11-03,4,0,11,12,0,4,1,1,0.5,0.4848,0.51,0.194,17,255,162,1620,179,1875
7247,2011-11-03,4,0,11,13,0,4,1,2,0.52,0.5,0.48,0.2537,19,285,150,1500,169,1785
7248,2011-11-03,4,0,11,14,0,4,1,1,0.52,0.5,0.52,0.1642,32,480,120,1200,152,1680
7249,2011-11-03,4,0,11,15,0,4,1,1,0.52,0.5,0.52,0.1642,24,360,138,1380,162,1740
7250,2011-11-03,4,0,11,16,0,4,1,1,0.52,0.5,0.48,0.194,33,495,234,2340,267,2835
7251,2011-11-03,4,0,11,17,0,4,1,1,0.48,0.4697,0.55,0.0896,33,495,465,4650,498,5145
7252,2011-11-03,4,0,11,18,0,4,1,1,0.46,0.4545,0.63,0.1343,24,360,409,4090,433,4450
7253,2011-11-03,4,0,11,19,0,4,1,1,0.44,0.4394,0.67,0.0896,18,270,234,2340,252,2610
7254,2011-11-03,4,0,11,20,0,4,1,1,0.42,0.4242,0.71,0.1045,11,165,198,1980,209,2145
7255,2011-11-03,4,0,11,21,0,4,1,1,0.4,0.4091,0.76,0.1343,4,60,140,1400,144,1460
7256,2011-11-03,4,0,11,22,0,4,1,1,0.4,0.4091,0.82,0.0,21,315,116,1160,137,1475
7257,2011-11-03,4,0,11,23,0,4,1,1,0.4,0.4091,0.82,0.0896,15,225,80,800,95,1025
7258,2011-11-04,4,0,11,0,0,5,1,2,0.4,0.4091,0.82,0.0,11,165,32,320,43,485
7259,2011-11-04,4,0,11,1,0,5,1,2,0.4,0.4091,0.82,0.0,1,15,16,160,17,175
7260,2011-11-04,4,0,11,2,0,5,1,2,0.4,0.4091,0.76,0.0,2,30,8,80,10,110
7261,2011-11-04,4,0,11,3,0,5,1,2,0.38,0.3939,0.87,0.1642,1,15,7,70,8,85
7262,2011-11-04,4,0,11,4,0,5,1,2,0.38,0.3939,0.87,0.0896,1,15,6,60,7,75
7263,2011-11-04,4,0,11,5,0,5,1,2,0.38,0.3939,0.87,0.0,0,0,23,230,23,230
7264,2011-11-04,4,0,11,6,0,5,1,2,0.38,0.3939,0.87,0.0896,2,30,64,640,66,670
7265,2011-11-04,4,0,11,7,0,5,1,2,0.4,0.4091,0.86,0.2239,10,150,235,2350,245,2500
7266,2011-11-04,4,0,11,8,0,5,1,2,0.4,0.4091,0.87,0.3582,8,120,387,3870,395,3990
7267,2011-11-04,4,0,11,9,0,5,1,2,0.42,0.4242,0.71,0.4627,15,225,239,2390,254,2615
7268,2011-11-04,4,0,11,10,0,5,1,2,0.42,0.4242,0.71,0.3284,19,285,115,1150,134,1435
7269,2011-11-04,4,0,11,11,0,5,1,2,0.44,0.4394,0.67,0.4478,34,510,128,1280,162,1790
7270,2011-11-04,4,0,11,12,0,5,1,2,0.48,0.4697,0.55,0.4925,44,660,153,1530,197,2190
7271,2011-11-04,4,0,11,13,0,5,1,1,0.44,0.4394,0.51,0.4179,33,495,161,1610,194,2105
7272,2011-11-04,4,0,11,14,0,5,1,1,0.44,0.4394,0.47,0.2985,54,810,147,1470,201,2280
7273,2011-11-04,4,0,11,15,0,5,1,1,0.46,0.4545,0.44,0.3881,45,675,192,1920,237,2595
7274,2011-11-04,4,0,11,16,0,5,1,1,0.46,0.4545,0.36,0.3881,53,795,237,2370,290,3165
7275,2011-11-04,4,0,11,17,0,5,1,1,0.42,0.4242,0.38,0.3582,42,630,438,4380,480,5010
7276,2011-11-04,4,0,11,18,0,5,1,1,0.42,0.4242,0.32,0.4627,35,525,339,3390,374,3915
7277,2011-11-04,4,0,11,19,0,5,1,1,0.4,0.4091,0.37,0.3582,14,210,182,1820,196,2030
7278,2011-11-04,4,0,11,20,0,5,1,1,0.36,0.3333,0.43,0.2836,15,225,171,1710,186,1935
7279,2011-11-04,4,0,11,21,0,5,1,1,0.34,0.3182,0.46,0.2537,8,120,115,1150,123,1270
7280,2011-11-04,4,0,11,22,0,5,1,1,0.34,0.303,0.46,0.3284,6,90,109,1090,115,1180
7281,2011-11-04,4,0,11,23,0,5,1,1,0.32,0.303,0.49,0.3284,17,255,72,720,89,975
7282,2011-11-05,4,0,11,0,0,6,0,1,0.32,0.2879,0.45,0.3582,4,60,48,480,52,540
7283,2011-11-05,4,0,11,1,0,6,0,1,0.32,0.303,0.45,0.2985,5,75,57,570,62,645
7284,2011-11-05,4,0,11,2,0,6,0,1,0.3,0.2727,0.52,0.3284,7,105,24,240,31,345
7285,2011-11-05,4,0,11,3,0,6,0,1,0.3,0.2727,0.52,0.2985,0,0,8,80,8,80
7286,2011-11-05,4,0,11,4,0,6,0,1,0.28,0.2576,0.56,0.3284,3,45,5,50,8,95
7287,2011-11-05,4,0,11,5,0,6,0,1,0.26,0.2273,0.6,0.3284,0,0,2,20,2,20
7288,2011-11-05,4,0,11,6,0,6,0,1,0.26,0.2424,0.6,0.2537,3,45,20,200,23,245
7289,2011-11-05,4,0,11,7,0,6,0,1,0.26,0.2424,0.6,0.2836,3,45,31,310,34,355
7290,2011-11-05,4,0,11,8,0,6,0,1,0.28,0.2576,0.56,0.3284,4,60,80,800,84,860
7291,2011-11-05,4,0,11,9,0,6,0,1,0.3,0.2727,0.56,0.2985,30,450,111,1110,141,1560
7292,2011-11-05,4,0,11,10,0,6,0,1,0.32,0.303,0.53,0.2537,56,840,171,1710,227,2550
7293,2011-11-05,4,0,11,11,0,6,0,1,0.36,0.3636,0.46,0.1045,69,1035,169,1690,238,2725
7294,2011-11-05,4,0,11,12,0,6,0,1,0.36,0.3485,0.46,0.1642,137,2055,235,2350,372,4405
7295,2011-11-05,4,0,11,13,0,6,0,1,0.4,0.4091,0.37,0.1045,148,2220,207,2070,355,4290
7296,2011-11-05,4,0,11,14,0,6,0,1,0.42,0.4242,0.35,0.1343,159,2385,227,2270,386,4655
7297,2011-11-05,4,0,11,15,0,6,0,1,0.4,0.4091,0.37,0.194,141,2115,202,2020,343,4135
7298,2011-11-05,4,0,11,16,0,6,0,1,0.4,0.4091,0.4,0.2239,128,1920,207,2070,335,3990
7299,2011-11-05,4,0,11,17,0,6,0,1,0.38,0.3939,0.4,0.1642,100,1500,234,2340,334,3840
7300,2011-11-05,4,0,11,18,0,6,0,1,0.36,0.3636,0.5,0.0896,52,780,185,1850,237,2630
7301,2011-11-05,4,0,11,19,0,6,0,1,0.34,0.3636,0.53,0.0,45,675,159,1590,204,2265
7302,2011-11-05,4,0,11,20,0,6,0,1,0.32,0.3485,0.66,0.0,29,435,136,1360,165,1795
7303,2011-11-05,4,0,11,21,0,6,0,1,0.32,0.3485,0.66,0.0,19,285,99,990,118,1275
7304,2011-11-05,4,0,11,22,0,6,0,1,0.3,0.3333,0.65,0.0,10,150,72,720,82,870
7305,2011-11-05,4,0,11,23,0,6,0,1,0.28,0.3182,0.7,0.0,4,60,81,810,85,870
7306,2011-11-06,4,0,11,0,0,0,0,1,0.28,0.3182,0.75,0.0,10,150,65,650,75,800
7307,2011-11-06,4,0,11,1,0,0,0,1,0.26,0.303,0.81,0.0,11,165,104,1040,115,1205
7308,2011-11-06,4,0,11,2,0,0,0,1,0.26,0.303,0.81,0.0,6,90,23,230,29,320
7309,2011-11-06,4,0,11,3,0,0,0,1,0.24,0.2879,0.87,0.0,5,75,4,40,9,115
7310,2011-11-06,4,0,11,4,0,0,0,1,0.24,0.2879,0.87,0.0,0,0,6,60,6,60
7311,2011-11-06,4,0,11,5,0,0,0,1,0.24,0.2424,0.87,0.1343,0,0,5,50,5,50
7312,2011-11-06,4,0,11,6,0,0,0,1,0.26,0.2879,0.81,0.0896,5,75,11,110,16,185
7313,2011-11-06,4,0,11,7,0,0,0,1,0.26,0.2727,0.87,0.1045,4,60,24,240,28,300
7314,2011-11-06,4,0,11,8,0,0,0,2,0.28,0.303,0.87,0.0896,19,285,71,710,90,995
7315,2011-11-06,4,0,11,9,0,0,0,2,0.3,0.3182,0.75,0.0896,36,540,134,1340,170,1880
7316,2011-11-06,4,0,11,10,0,0,0,1,0.36,0.3636,0.66,0.0896,76,1140,186,1860,262,3000
7317,2011-11-06,4,0,11,11,0,0,0,1,0.42,0.4242,0.58,0.0896,104,1560,216,2160,320,3720
7318,2011-11-06,4,0,11,12,0,0,0,1,0.44,0.4394,0.54,0.0,120,1800,226,2260,346,4060
7319,2011-11-06,4,0,11,13,0,0,0,1,0.46,0.4545,0.51,0.1642,105,1575,209,2090,314,3665
7320,2011-11-06,4,0,11,14,0,0,0,1,0.46,0.4545,0.55,0.194,101,1515,219,2190,320,3705
7321,2011-11-06,4,0,11,15,0,0,0,1,0.48,0.4697,0.51,0.194,96,1440,210,2100,306,3540
7322,2011-11-06,4,0,11,16,0,0,0,1,0.46,0.4545,0.55,0.2239,84,1260,263,2630,347,3890
7323,2011-11-06,4,0,11,17,0,0,0,1,0.44,0.4394,0.62,0.1642,71,1065,185,1850,256,2915
7324,2011-11-06,4,0,11,18,0,0,0,1,0.42,0.4242,0.71,0.1045,39,585,146,1460,185,2045
7325,2011-11-06,4,0,11,19,0,0,0,1,0.38,0.3939,0.76,0.194,21,315,130,1300,151,1615
7326,2011-11-06,4,0,11,20,0,0,0,1,0.36,0.3636,0.81,0.1045,16,240,100,1000,116,1240
7327,2011-11-06,4,0,11,21,0,0,0,1,0.36,0.3636,0.81,0.0896,11,165,77,770,88,935
7328,2011-11-06,4,0,11,22,0,0,0,1,0.36,0.3788,0.87,0.0,5,75,40,400,45,475
7329,2011-11-06,4,0,11,23,0,0,0,1,0.34,0.3485,0.87,0.0896,7,105,43,430,50,535
7330,2011-11-07,4,0,11,0,0,1,1,1,0.34,0.3636,0.87,0.0,1,15,14,140,15,155
7331,2011-11-07,4,0,11,1,0,1,1,1,0.34,0.3636,0.87,0.0,2,30,6,60,8,90
7332,2011-11-07,4,0,11,2,0,1,1,1,0.32,0.3485,0.93,0.0,0,0,2,20,2,20
7333,2011-11-07,4,0,11,3,0,1,1,1,0.32,0.3485,0.93,0.0,0,0,3,30,3,30
7334,2011-11-07,4,0,11,4,0,1,1,1,0.32,0.3485,0.93,0.0,2,30,4,40,6,70
7335,2011-11-07,4,0,11,5,0,1,1,1,0.3,0.3333,0.93,0.0,1,15,25,250,26,265
7336,2011-11-07,4,0,11,6,0,1,1,2,0.28,0.3182,0.93,0.0,2,30,97,970,99,1000
7337,2011-11-07,4,0,11,7,0,1,1,2,0.28,0.3182,0.93,0.0,6,90,305,3050,311,3140
7338,2011-11-07,4,0,11,8,0,1,1,2,0.3,0.3182,1.0,0.0896,13,195,397,3970,410,4165
7339,2011-11-07,4,0,11,9,0,1,1,2,0.34,0.3333,1.0,0.1343,18,270,156,1560,174,1830
7340,2011-11-07,4,0,11,10,0,1,1,1,0.36,0.3485,0.93,0.1343,28,420,95,950,123,1370
7341,2011-11-07,4,0,11,11,0,1,1,1,0.42,0.4242,0.77,0.1045,28,420,100,1000,128,1420
7342,2011-11-07,4,0,11,12,0,1,1,1,0.46,0.4545,0.67,0.0,21,315,158,1580,179,1895
7343,2011-11-07,4,0,11,13,0,1,1,1,0.54,0.5152,0.49,0.0896,32,480,157,1570,189,2050
7344,2011-11-07,4,0,11,14,0,1,1,1,0.56,0.5303,0.37,0.1642,30,450,115,1150,145,1600
7345,2011-11-07,4,0,11,15,0,1,1,1,0.56,0.5303,0.37,0.1045,38,570,132,1320,170,1890
7346,2011-11-07,4,0,11,16,0,1,1,1,0.52,0.5,0.45,0.0,40,600,255,2550,295,3150
7347,2011-11-07,4,0,11,17,0,1,1,1,0.5,0.4848,0.45,0.1642,39,585,489,4890,528,5475
7348,2011-11-07,4,0,11,18,0,1,1,1,0.46,0.4545,0.59,0.1045,18,270,407,4070,425,4340
7349,2011-11-07,4,0,11,19,0,1,1,1,0.46,0.4545,0.59,0.0,20,300,280,2800,300,3100
7350,2011-11-07,4,0,11,20,0,1,1,1,0.4,0.4091,0.71,0.0,17,255,187,1870,204,2125
7351,2011-11-07,4,0,11,21,0,1,1,1,0.38,0.3939,0.82,0.1045,10,150,129,1290,139,1440
7352,2011-11-07,4,0,11,22,0,1,1,1,0.36,0.3636,0.81,0.0896,6,90,102,1020,108,1110
7353,2011-11-07,4,0,11,23,0,1,1,1,0.36,0.3636,0.87,0.0896,1,15,47,470,48,485
7354,2011-11-08,4,0,11,0,0,2,1,1,0.34,0.3485,0.87,0.0896,0,0,18,180,18,180
7355,2011-11-08,4,0,11,1,0,2,1,1,0.32,0.3333,0.93,0.1045,3,45,8,80,11,125
7356,2011-11-08,4,0,11,2,0,2,1,1,0.32,0.3485,0.87,0.0,0,0,1,10,1,10
7357,2011-11-08,4,0,11,3,0,2,1,1,0.32,0.3485,0.87,0.0,0,0,3,30,3,30
7358,2011-11-08,4,0,11,4,0,2,1,1,0.3,0.3333,0.87,0.0,0,0,4,40,4,40
7359,2011-11-08,4,0,11,5,0,2,1,1,0.3,0.3182,0.87,0.0896,1,15,17,170,18,185
7360,2011-11-08,4,0,11,6,0,2,1,1,0.3,0.3333,0.87,0.0,3,45,96,960,99,1005
7361,2011-11-08,4,0,11,7,0,2,1,1,0.3,0.3182,0.87,0.1045,7,105,316,3160,323,3265
7362,2011-11-08,4,0,11,8,0,2,1,1,0.32,0.3333,0.93,0.1045,11,165,455,4550,466,4715
7363,2011-11-08,4,0,11,9,0,2,1,1,0.36,0.3788,0.87,0.0,14,210,177,1770,191,1980
7364,2011-11-08,4,0,11,10,0,2,1,1,0.42,0.4242,0.71,0.0896,25,375,104,1040,129,1415
7365,2011-11-08,4,0,11,11,0,2,1,1,0.46,0.4545,0.63,0.1343,21,315,126,1260,147,1575
7366,2011-11-08,4,0,11,12,0,2,1,1,0.52,0.5,0.52,0.1343,28,420,175,1750,203,2170
7367,2011-11-08,4,0,11,13,0,2,1,1,0.54,0.5152,0.49,0.1642,31,465,165,1650,196,2115
7368,2011-11-08,4,0,11,14,0,2,1,1,0.56,0.5303,0.46,0.1045,32,480,129,1290,161,1770
7369,2011-11-08,4,0,11,15,0,2,1,1,0.58,0.5455,0.46,0.1045,33,495,155,1550,188,2045
7370,2011-11-08,4,0,11,16,0,2,1,1,0.56,0.5303,0.46,0.1343,39,585,250,2500,289,3085
7371,2011-11-08,4,0,11,17,0,2,1,1,0.52,0.5,0.43,0.1642,40,600,459,4590,499,5190
7372,2011-11-08,4,0,11,18,0,2,1,1,0.48,0.4697,0.55,0.1343,30,450,432,4320,462,4770
7373,2011-11-08,4,0,11,19,0,2,1,1,0.46,0.4545,0.59,0.0,14,210,264,2640,278,2850
7374,2011-11-08,4,0,11,20,0,2,1,1,0.4,0.4091,0.76,0.0,12,180,169,1690,181,1870
7375,2011-11-08,4,0,11,21,0,2,1,1,0.4,0.4091,0.76,0.0,16,240,166,1660,182,1900
7376,2011-11-08,4,0,11,22,0,2,1,1,0.36,0.3788,0.87,0.0,13,195,95,950,108,1145
7377,2011-11-08,4,0,11,23,0,2,1,1,0.36,0.3788,0.81,0.0,3,45,45,450,48,495
7378,2011-11-09,4,0,11,0,0,3,1,1,0.36,0.3788,0.87,0.0,0,0,13,130,13,130
7379,2011-11-09,4,0,11,1,0,3,1,1,0.34,0.3636,0.87,0.0,0,0,10,100,10,100
7380,2011-11-09,4,0,11,2,0,3,1,1,0.32,0.3485,0.93,0.0,0,0,5,50,5,50
7381,2011-11-09,4,0,11,3,0,3,1,1,0.32,0.3485,0.93,0.0,0,0,4,40,4,40
7382,2011-11-09,4,0,11,4,0,3,1,1,0.32,0.3485,0.87,0.0,0,0,4,40,4,40
7383,2011-11-09,4,0,11,5,0,3,1,1,0.3,0.3333,0.87,0.0,0,0,28,280,28,280
7384,2011-11-09,4,0,11,6,0,3,1,1,0.3,0.3333,0.87,0.0,0,0,98,980,98,980
7385,2011-11-09,4,0,11,7,0,3,1,1,0.3,0.3333,0.87,0.0,0,0,300,3000,300,3000
7386,2011-11-09,4,0,11,8,0,3,1,1,0.32,0.3485,0.93,0.0,19,285,437,4370,456,4655
7387,2011-11-09,4,0,11,9,0,3,1,1,0.34,0.3636,0.93,0.0,22,330,197,1970,219,2300
7388,2011-11-09,4,0,11,10,0,3,1,1,0.4,0.4091,0.76,0.1045,16,240,89,890,105,1130
7389,2011-11-09,4,0,11,11,0,3,1,1,0.46,0.4545,0.67,0.1642,21,315,131,1310,152,1625
7390,2011-11-09,4,0,11,12,0,3,1,1,0.5,0.4848,0.51,0.1642,24,360,156,1560,180,1920
7391,2011-11-09,4,0,11,13,0,3,1,1,0.5,0.4848,0.51,0.1642,31,465,136,1360,167,1825
7392,2011-11-09,4,0,11,14,0,3,1,1,0.52,0.5,0.48,0.1642,26,390,153,1530,179,1920
7393,2011-11-09,4,0,11,15,0,3,1,1,0.52,0.5,0.45,0.2239,21,315,130,1300,151,1615
7394,2011-11-09,4,0,11,16,0,3,1,1,0.52,0.5,0.48,0.194,24,360,257,2570,281,2930
7395,2011-11-09,4,0,11,17,0,3,1,1,0.46,0.4545,0.63,0.1045,27,405,458,4580,485,4985
7396,2011-11-09,4,0,11,18,0,3,1,1,0.44,0.4394,0.67,0.1045,21,315,387,3870,408,4185
7397,2011-11-09,4,0,11,19,0,3,1,1,0.44,0.4394,0.72,0.1045,12,180,292,2920,304,3100
7398,2011-11-09,4,0,11,20,0,3,1,1,0.44,0.4394,0.77,0.0,18,270,201,2010,219,2280
7399,2011-11-09,4,0,11,21,0,3,1,1,0.4,0.4091,0.87,0.0,9,135,152,1520,161,1655
7400,2011-11-09,4,0,11,22,0,3,1,1,0.4,0.4091,0.87,0.0,9,135,105,1050,114,1185
7401,2011-11-09,4,0,11,23,0,3,1,1,0.38,0.3939,0.87,0.0,5,75,61,610,66,685
7402,2011-11-10,4,0,11,0,0,4,1,1,0.4,0.4091,0.87,0.0,0,0,24,240,24,240
7403,2011-11-10,4,0,11,1,0,4,1,2,0.4,0.4091,0.87,0.0,1,15,10,100,11,115
7404,2011-11-10,4,0,11,2,0,4,1,2,0.38,0.3939,0.94,0.0,0,0,5,50,5,50
7405,2011-11-10,4,0,11,3,0,4,1,1,0.38,0.3939,0.94,0.0896,0,0,11,110,11,110
7406,2011-11-10,4,0,11,4,0,4,1,1,0.38,0.3939,0.94,0.0896,1,15,2,20,3,35
7407,2011-11-10,4,0,11,5,0,4,1,2,0.36,0.3485,1.0,0.1343,1,15,22,220,23,235
7408,2011-11-10,4,0,11,6,0,4,1,2,0.36,0.3485,1.0,0.1343,4,60,110,1100,114,1160
7409,2011-11-10,4,0,11,7,0,4,1,2,0.38,0.3939,0.94,0.1642,6,90,266,2660,272,2750
7410,2011-11-10,4,0,11,8,0,4,1,2,0.4,0.4091,0.94,0.0896,18,270,418,4180,436,4450
7411,2011-11-10,4,0,11,9,0,4,1,2,0.42,0.4242,0.94,0.1045,23,345,188,1880,211,2225
7412,2011-11-10,4,0,11,10,0,4,1,2,0.44,0.4394,0.88,0.2239,17,255,100,1000,117,1255
7413,2011-11-10,4,0,11,11,0,4,1,2,0.46,0.4545,0.67,0.3881,9,135,99,990,108,1125
7414,2011-11-10,4,0,11,12,0,4,1,2,0.42,0.4242,0.67,0.3582,18,270,149,1490,167,1760
7415,2011-11-10,4,0,11,13,0,4,1,3,0.36,0.3333,0.81,0.3582,9,135,87,870,96,1005
7416,2011-11-10,4,0,11,14,0,4,1,3,0.36,0.3333,0.87,0.2836,6,90,58,580,64,670
7417,2011-11-10,4,0,11,15,0,4,1,3,0.36,0.3333,0.81,0.2985,5,75,57,570,62,645
7418,2011-11-10,4,0,11,16,0,4,1,3,0.36,0.3485,0.81,0.2239,6,90,67,670,73,760
7419,2011-11-10,4,0,11,17,0,4,1,3,0.36,0.3485,0.81,0.2239,9,135,168,1680,177,1815
7420,2011-11-10,4,0,11,18,0,4,1,2,0.36,0.3485,0.81,0.1642,10,150,263,2630,273,2780
7421,2011-11-10,4,0,11,19,0,4,1,2,0.36,0.3485,0.71,0.2239,19,285,192,1920,211,2205
7422,2011-11-10,4,0,11,20,0,4,1,2,0.36,0.3333,0.62,0.2836,8,120,160,1600,168,1720
7423,2011-11-10,4,0,11,21,0,4,1,1,0.36,0.3333,0.57,0.2537,6,90,130,1300,136,1390
7424,2011-11-10,4,0,11,22,0,4,1,1,0.36,0.3333,0.53,0.2836,5,75,84,840,89,915
7425,2011-11-10,4,0,11,23,0,4,1,2,0.34,0.3333,0.57,0.1642,9,135,73,730,82,865
7426,2011-11-11,4,0,11,0,1,5,0,1,0.34,0.3182,0.53,0.2537,10,150,56,560,66,710
7427,2011-11-11,4,0,11,1,1,5,0,1,0.32,0.303,0.57,0.3284,3,45,16,160,19,205
7428,2011-11-11,4,0,11,2,1,5,0,1,0.32,0.2879,0.57,0.2836,1,15,10,100,11,115
7429,2011-11-11,4,0,11,3,1,5,0,1,0.3,0.2879,0.61,0.194,0,0,6,60,6,60
7430,2011-11-11,4,0,11,4,1,5,0,1,0.3,0.2879,0.61,0.194,0,0,8,80,8,80
7431,2011-11-11,4,0,11,5,1,5,0,1,0.3,0.2879,0.49,0.2537,0,0,13,130,13,130
7432,2011-11-11,4,0,11,6,1,5,0,1,0.28,0.2576,0.45,0.3284,0,0,46,460,46,460
7433,2011-11-11,4,0,11,7,1,5,0,1,0.28,0.2727,0.45,0.2537,5,75,116,1160,121,1235
7434,2011-11-11,4,0,11,8,1,5,0,1,0.3,0.2727,0.42,0.3582,9,135,249,2490,258,2625
7435,2011-11-11,4,0,11,9,1,5,0,1,0.32,0.2879,0.45,0.4478,15,225,186,1860,201,2085
7436,2011-11-11,4,0,11,10,1,5,0,1,0.32,0.2727,0.42,0.5522,38,570,162,1620,200,2190
7437,2011-11-11,4,0,11,11,1,5,0,1,0.34,0.2879,0.42,0.4925,20,300,150,1500,170,1800
7438,2011-11-11,4,0,11,12,1,5,0,1,0.34,0.2879,0.42,0.4627,41,615,198,1980,239,2595
7439,2011-11-11,4,0,11,13,1,5,0,1,0.38,0.3939,0.37,0.5522,57,855,179,1790,236,2645
7440,2011-11-11,4,0,11,14,1,5,0,1,0.38,0.3939,0.37,0.4627,64,960,183,1830,247,2790
7441,2011-11-11,4,0,11,15,1,5,0,1,0.36,0.3333,0.37,0.4179,29,435,187,1870,216,2305
7442,2011-11-11,4,0,11,16,1,5,0,1,0.36,0.3333,0.34,0.3284,49,735,189,1890,238,2625
7443,2011-11-11,4,0,11,17,1,5,0,1,0.34,0.303,0.39,0.3284,24,360,286,2860,310,3220
7444,2011-11-11,4,0,11,18,1,5,0,1,0.34,0.3182,0.39,0.2537,23,345,185,1850,208,2195
7445,2011-11-11,4,0,11,19,1,5,0,1,0.32,0.3182,0.39,0.1642,17,255,182,1820,199,2075
7446,2011-11-11,4,0,11,20,1,5,0,1,0.32,0.3182,0.39,0.194,12,180,97,970,109,1150
7447,2011-11-11,4,0,11,21,1,5,0,1,0.3,0.303,0.45,0.1642,4,60,79,790,83,850
7448,2011-11-11,4,0,11,22,1,5,0,1,0.32,0.3182,0.39,0.194,13,195,78,780,91,975
7449,2011-11-11,4,0,11,23,1,5,0,1,0.3,0.3182,0.45,0.0896,6,90,67,670,73,760
7450,2011-11-12,4,0,11,0,0,6,0,1,0.24,0.2424,0.6,0.1343,12,180,52,520,64,700
7451,2011-11-12,4,0,11,1,0,6,0,1,0.24,0.2424,0.6,0.1343,9,135,45,450,54,585
7452,2011-11-12,4,0,11,2,0,6,0,1,0.24,0.2576,0.65,0.0896,7,105,39,390,46,495
7453,2011-11-12,4,0,11,3,0,6,0,1,0.24,0.2424,0.7,0.1343,4,60,13,130,17,190
7454,2011-11-12,4,0,11,4,0,6,0,1,0.2,0.2121,0.8,0.1343,0,0,7,70,7,70
7455,2011-11-12,4,0,11,5,0,6,0,1,0.22,0.2576,0.75,0.0896,1,15,3,30,4,45
7456,2011-11-12,4,0,11,6,0,6,0,1,0.22,0.2273,0.75,0.1642,0,0,7,70,7,70
7457,2011-11-12,4,0,11,7,0,6,0,1,0.22,0.2273,0.75,0.194,3,45,24,240,27,285
7458,2011-11-12,4,0,11,8,0,6,0,1,0.26,0.2576,0.7,0.194,14,210,87,870,101,1080
7459,2011-11-12,4,0,11,9,0,6,0,1,0.3,0.303,0.61,0.1642,18,270,142,1420,160,1690
7460,2011-11-12,4,0,11,10,0,6,0,1,0.34,0.3182,0.61,0.2836,62,930,170,1700,232,2630
7461,2011-11-12,4,0,11,11,0,6,0,1,0.38,0.3939,0.54,0.2836,102,1530,213,2130,315,3660
7462,2011-11-12,4,0,11,12,0,6,0,1,0.44,0.4394,0.44,0.2836,142,2130,224,2240,366,4370
7463,2011-11-12,4,0,11,13,0,6,0,1,0.48,0.4697,0.36,0.2836,128,1920,225,2250,353,4170
7464,2011-11-12,4,0,11,14,0,6,0,1,0.5,0.4848,0.36,0.2985,191,2865,244,2440,435,5305
7465,2011-11-12,4,0,11,15,0,6,0,1,0.52,0.5,0.29,0.2836,165,2475,221,2210,386,4685
7466,2011-11-12,4,0,11,16,0,6,0,1,0.52,0.5,0.32,0.2537,137,2055,224,2240,361,4295
7467,2011-11-12,4,0,11,17,0,6,0,1,0.5,0.4848,0.34,0.2537,92,1380,193,1930,285,3310
7468,2011-11-12,4,0,11,18,0,6,0,1,0.42,0.4242,0.58,0.194,53,795,150,1500,203,2295
7469,2011-11-12,4,0,11,19,0,6,0,1,0.42,0.4242,0.5,0.2537,32,480,139,1390,171,1870
7470,2011-11-12,4,0,11,20,0,6,0,1,0.42,0.4242,0.5,0.2836,31,465,101,1010,132,1475
7471,2011-11-12,4,0,11,21,0,6,0,1,0.42,0.4242,0.47,0.2836,19,285,103,1030,122,1315
7472,2011-11-12,4,0,11,22,0,6,0,1,0.42,0.4242,0.47,0.2537,30,450,88,880,118,1330
7473,2011-11-12,4,0,11,23,0,6,0,1,0.4,0.4091,0.58,0.1642,23,345,78,780,101,1125
7474,2011-11-13,4,0,11,0,0,0,0,2,0.4,0.4091,0.58,0.194,12,180,61,610,73,790
7475,2011-11-13,4,0,11,1,0,0,0,2,0.36,0.3485,0.66,0.194,13,195,58,580,71,775
7476,2011-11-13,4,0,11,2,0,0,0,1,0.36,0.3636,0.57,0.1045,9,135,48,480,57,615
7477,2011-11-13,4,0,11,3,0,0,0,2,0.36,0.3485,0.62,0.1343,8,120,20,200,28,320
7478,2011-11-13,4,0,11,4,0,0,0,2,0.36,0.3485,0.62,0.1343,1,15,5,50,6,65
7479,2011-11-13,4,0,11,5,0,0,0,1,0.34,0.3333,0.61,0.1642,2,30,3,30,5,60
7480,2011-11-13,4,0,11,6,0,0,0,1,0.34,0.3333,0.66,0.1343,5,75,18,180,23,255
7481,2011-11-13,4,0,11,7,0,0,0,1,0.34,0.3182,0.66,0.2239,13,195,30,300,43,495
7482,2011-11-13,4,0,11,8,0,0,0,1,0.34,0.3485,0.66,0.0896,24,360,55,550,79,910
7483,2011-11-13,4,0,11,9,0,0,0,1,0.4,0.4091,0.54,0.2836,38,570,97,970,135,1540
7484,2011-11-13,4,0,11,10,0,0,0,1,0.44,0.4394,0.44,0.3284,63,945,178,1780,241,2725
7485,2011-11-13,4,0,11,11,0,0,0,1,0.46,0.4545,0.4,0.4179,108,1620,187,1870,295,3490
7486,2011-11-13,4,0,11,12,0,0,0,2,0.52,0.5,0.29,0.4179,112,1680,242,2420,354,4100
7487,2011-11-13,4,0,11,13,0,0,0,2,0.52,0.5,0.29,0.4179,105,1575,234,2340,339,3915
7488,2011-11-13,4,0,11,14,0,0,0,2,0.54,0.5152,0.28,0.4925,108,1620,263,2630,371,4250
7489,2011-11-13,4,0,11,15,0,0,0,2,0.5,0.4848,0.42,0.3284,89,1335,221,2210,310,3545
7490,2011-11-13,4,0,11,16,0,0,0,2,0.54,0.5152,0.28,0.3881,93,1395,226,2260,319,3655
7491,2011-11-13,4,0,11,17,0,0,0,1,0.52,0.5,0.27,0.3284,44,660,187,1870,231,2530
7492,2011-11-13,4,0,11,18,0,0,0,1,0.52,0.5,0.27,0.3284,35,525,155,1550,190,2075
7493,2011-11-13,4,0,11,19,0,0,0,1,0.5,0.4848,0.29,0.3582,36,540,121,1210,157,1750
7494,2011-11-13,4,0,11,20,0,0,0,1,0.5,0.4848,0.31,0.3582,24,360,115,1150,139,1510
7495,2011-11-13,4,0,11,21,0,0,0,1,0.48,0.4697,0.36,0.2537,19,285,76,760,95,1045
7496,2011-11-13,4,0,11,22,0,0,0,1,0.48,0.4697,0.41,0.3881,25,375,64,640,89,1015
7497,2011-11-13,4,0,11,23,0,0,0,1,0.46,0.4545,0.51,0.2985,18,270,49,490,67,760
7498,2011-11-14,4,0,11,0,0,1,1,1,0.46,0.4545,0.59,0.2836,8,120,22,220,30,340
7499,2011-11-14,4,0,11,1,0,1,1,1,0.46,0.4545,0.63,0.2985,5,75,6,60,11,135
7500,2011-11-14,4,0,11,2,0,1,1,1,0.46,0.4545,0.63,0.3582,7,105,10,100,17,205
7501,2011-11-14,4,0,11,3,0,1,1,1,0.44,0.4394,0.67,0.2836,4,60,3,30,7,90
7502,2011-11-14,4,0,11,4,0,1,1,1,0.44,0.4394,0.67,0.2239,0,0,5,50,5,50
7503,2011-11-14,4,0,11,5,0,1,1,2,0.44,0.4394,0.67,0.2537,0,0,19,190,19,190
7504,2011-11-14,4,0,11,6,0,1,1,2,0.44,0.4394,0.72,0.2239,10,150,104,1040,114,1190
7505,2011-11-14,4,0,11,7,0,1,1,1,0.44,0.4394,0.72,0.2537,11,165,311,3110,322,3275
7506,2011-11-14,4,0,11,8,0,1,1,2,0.46,0.4545,0.67,0.194,27,405,425,4250,452,4655
7507,2011-11-14,4,0,11,9,0,1,1,2,0.48,0.4697,0.67,0.3284,29,435,204,2040,233,2475
7508,2011-11-14,4,0,11,10,0,1,1,2,0.5,0.4848,0.63,0.2836,26,390,85,850,111,1240
7509,2011-11-14,4,0,11,11,0,1,1,2,0.54,0.5152,0.6,0.2836,22,330,106,1060,128,1390
7510,2011-11-14,4,0,11,12,0,1,1,1,0.56,0.5303,0.56,0.2985,36,540,166,1660,202,2200
7511,2011-11-14,4,0,11,13,0,1,1,1,0.6,0.6212,0.49,0.3881,50,750,153,1530,203,2280
7512,2011-11-14,4,0,11,14,0,1,1,1,0.62,0.6212,0.46,0.4478,47,705,138,1380,185,2085
7513,2011-11-14,4,0,11,15,0,1,1,1,0.64,0.6212,0.44,0.3284,53,795,142,1420,195,2215
7514,2011-11-14,4,0,11,16,0,1,1,1,0.62,0.6212,0.46,0.4179,51,765,264,2640,315,3405
7515,2011-11-14,4,0,11,17,0,1,1,1,0.62,0.6212,0.46,0.2537,55,825,464,4640,519,5465
7516,2011-11-14,4,0,11,18,0,1,1,1,0.56,0.5303,0.56,0.2836,29,435,460,4600,489,5035
7517,2011-11-14,4,0,11,19,0,1,1,1,0.6,0.6212,0.53,0.2985,28,420,274,2740,302,3160
7518,2011-11-14,4,0,11,20,0,1,1,1,0.6,0.6212,0.53,0.3582,30,450,210,2100,240,2550
7519,2011-11-14,4,0,11,21,0,1,1,1,0.6,0.6212,0.53,0.3582,37,555,176,1760,213,2315
7520,2011-11-14,4,0,11,22,0,1,1,1,0.58,0.5455,0.56,0.3582,17,255,96,960,113,1215
7521,2011-11-14,4,0,11,23,0,1,1,1,0.56,0.5303,0.64,0.2985,13,195,48,480,61,675
7522,2011-11-15,4,0,11,0,0,2,1,1,0.56,0.5303,0.64,0.3582,7,105,15,150,22,255
7523,2011-11-15,4,0,11,1,0,2,1,1,0.56,0.5303,0.6,0.2985,5,75,5,50,10,125
7524,2011-11-15,4,0,11,2,0,2,1,1,0.56,0.5303,0.64,0.2537,7,105,8,80,15,185
7525,2011-11-15,4,0,11,3,0,2,1,2,0.54,0.5152,0.68,0.3284,0,0,4,40,4,40
7526,2011-11-15,4,0,11,4,0,2,1,1,0.56,0.5303,0.64,0.2985,1,15,6,60,7,75
7527,2011-11-15,4,0,11,5,0,2,1,1,0.54,0.5152,0.68,0.2836,2,30,26,260,28,290
7528,2011-11-15,4,0,11,6,0,2,1,2,0.56,0.5303,0.64,0.0896,4,60,104,1040,108,1100
7529,2011-11-15,4,0,11,7,0,2,1,2,0.54,0.5152,0.68,0.1642,21,315,298,2980,319,3295
7530,2011-11-15,4,0,11,8,0,2,1,2,0.54,0.5152,0.68,0.1045,27,405,453,4530,480,4935
7531,2011-11-15,4,0,11,9,0,2,1,2,0.56,0.5303,0.64,0.0896,26,390,174,1740,200,2130
7532,2011-11-15,4,0,11,10,0,2,1,2,0.56,0.5303,0.64,0.2836,23,345,115,1150,138,1495
7533,2011-11-15,4,0,11,11,0,2,1,2,0.56,0.5303,0.64,0.194,18,270,116,1160,134,1430
7534,2011-11-15,4,0,11,12,0,2,1,2,0.54,0.5152,0.68,0.0,28,420,148,1480,176,1900
7535,2011-11-15,4,0,11,13,0,2,1,3,0.54,0.5152,0.6,0.2239,21,315,132,1320,153,1635
7536,2011-11-15,4,0,11,14,0,2,1,2,0.54,0.5152,0.6,0.2836,27,405,120,1200,147,1605
7537,2011-11-15,4,0,11,15,0,2,1,2,0.54,0.5152,0.6,0.1343,36,540,155,1550,191,2090
7538,2011-11-15,4,0,11,16,0,2,1,2,0.52,0.5,0.68,0.1343,31,465,240,2400,271,2865
7539,2011-11-15,4,0,11,17,0,2,1,2,0.5,0.4848,0.72,0.194,29,435,422,4220,451,4655
7540,2011-11-15,4,0,11,18,0,2,1,2,0.5,0.4848,0.72,0.2836,27,405,414,4140,441,4545
7541,2011-11-15,4,0,11,19,0,2,1,2,0.5,0.4848,0.72,0.3582,27,405,259,2590,286,2995
7542,2011-11-15,4,0,11,20,0,2,1,2,0.48,0.4697,0.82,0.1343,26,390,212,2120,238,2510
7543,2011-11-15,4,0,11,21,0,2,1,2,0.5,0.4848,0.77,0.0896,23,345,145,1450,168,1795
7544,2011-11-15,4,0,11,22,0,2,1,2,0.46,0.4545,0.88,0.1045,19,285,109,1090,128,1375
7545,2011-11-15,4,0,11,23,0,2,1,2,0.46,0.4545,0.94,0.1045,14,210,66,660,80,870
7546,2011-11-16,4,0,11,0,0,3,1,2,0.46,0.4545,0.94,0.0,5,75,26,260,31,335
7547,2011-11-16,4,0,11,1,0,3,1,3,0.46,0.4545,0.94,0.0896,0,0,5,50,5,50
7548,2011-11-16,4,0,11,2,0,3,1,2,0.46,0.4545,0.94,0.1045,4,60,6,60,10,120
7549,2011-11-16,4,0,11,3,0,3,1,2,0.46,0.4545,0.94,0.1045,2,30,3,30,5,60
7550,2011-11-16,4,0,11,4,0,3,1,2,0.44,0.4394,1.0,0.2239,1,15,3,30,4,45
7551,2011-11-16,4,0,11,5,0,3,1,3,0.46,0.4545,0.94,0.1045,0,0,13,130,13,130
7552,2011-11-16,4,0,11,6,0,3,1,2,0.46,0.4545,0.94,0.0896,4,60,52,520,56,580
7553,2011-11-16,4,0,11,7,0,3,1,3,0.46,0.4545,0.94,0.0,7,105,130,1300,137,1405
7554,2011-11-16,4,0,11,8,0,3,1,3,0.46,0.4545,0.94,0.0,9,135,223,2230,232,2365
7555,2011-11-16,4,0,11,9,0,3,1,3,0.46,0.4545,0.94,0.0,5,75,77,770,82,845
7556,2011-11-16,4,0,11,10,0,3,1,3,0.46,0.4545,0.94,0.0,4,60,32,320,36,380
7557,2011-11-16,4,0,11,11,0,3,1,3,0.46,0.4545,0.94,0.0896,7,105,53,530,60,635
7558,2011-11-16,4,0,11,12,0,3,1,3,0.46,0.4545,1.0,0.0,5,75,49,490,54,565
7559,2011-11-16,4,0,11,13,0,3,1,3,0.46,0.4545,0.94,0.1343,6,90,52,520,58,610
7560,2011-11-16,4,0,11,14,0,3,1,2,0.46,0.4545,1.0,0.1343,12,180,49,490,61,670
7561,2011-11-16,4,0,11,15,0,3,1,3,0.48,0.4697,0.94,0.1045,16,240,50,500,66,740
7562,2011-11-16,4,0,11,16,0,3,1,3,0.48,0.4697,0.94,0.1045,13,195,110,1100,123,1295
7563,2011-11-16,4,0,11,17,0,3,1,2,0.48,0.4697,0.88,0.194,17,255,216,2160,233,2415
7564,2011-11-16,4,0,11,18,0,3,1,3,0.46,0.4545,0.88,0.3881,13,195,176,1760,189,1955
7565,2011-11-16,4,0,11,19,0,3,1,3,0.46,0.4545,0.88,0.3881,3,45,108,1080,111,1125
7566,2011-11-16,4,0,11,20,0,3,1,3,0.44,0.4394,0.88,0.3881,5,75,94,940,99,1015
7567,2011-11-16,4,0,11,21,0,3,1,3,0.44,0.4394,0.88,0.2836,3,45,72,720,75,765
7568,2011-11-16,4,0,11,22,0,3,1,3,0.42,0.4242,0.88,0.2239,1,15,45,450,46,465
7569,2011-11-16,4,0,11,23,0,3,1,3,0.42,0.4242,0.88,0.1343,3,45,28,280,31,325
7570,2011-11-17,4,0,11,0,0,4,1,2,0.42,0.4242,0.88,0.2537,2,30,22,220,24,250
7571,2011-11-17,4,0,11,1,0,4,1,2,0.42,0.4242,0.82,0.1642,0,0,5,50,5,50
7572,2011-11-17,4,0,11,2,0,4,1,2,0.42,0.4242,0.82,0.2239,0,0,5,50,5,50
7573,2011-11-17,4,0,11,3,0,4,1,2,0.42,0.4242,0.77,0.3284,0,0,3,30,3,30
7574,2011-11-17,4,0,11,4,0,4,1,2,0.4,0.4091,0.62,0.4179,1,15,3,30,4,45
7575,2011-11-17,4,0,11,5,0,4,1,3,0.34,0.303,0.71,0.3284,1,15,21,210,22,225
7576,2011-11-17,4,0,11,6,0,4,1,3,0.36,0.3485,0.57,0.2239,3,45,72,720,75,765
7577,2011-11-17,4,0,11,7,0,4,1,3,0.34,0.3182,0.61,0.2836,4,60,164,1640,168,1700
7578,2011-11-17,4,0,11,8,0,4,1,3,0.34,0.303,0.61,0.2985,12,180,343,3430,355,3610
7579,2011-11-17,4,0,11,9,0,4,1,2,0.34,0.303,0.61,0.3284,14,210,184,1840,198,2050
7580,2011-11-17,4,0,11,10,0,4,1,2,0.34,0.303,0.61,0.3284,7,105,74,740,81,845
7581,2011-11-17,4,0,11,11,0,4,1,3,0.32,0.303,0.66,0.3284,4,60,93,930,97,990
7582,2011-11-17,4,0,11,12,0,4,1,2,0.34,0.303,0.53,0.2985,6,90,115,1150,121,1240
7583,2011-11-17,4,0,11,13,0,4,1,2,0.34,0.303,0.49,0.4478,15,225,109,1090,124,1315
7584,2011-11-17,4,0,11,14,0,4,1,2,0.34,0.303,0.49,0.3881,5,75,105,1050,110,1125
7585,2011-11-17,4,0,11,15,0,4,1,2,0.34,0.303,0.49,0.4478,10,150,106,1060,116,1210
7586,2011-11-17,4,0,11,16,0,4,1,1,0.32,0.2879,0.39,0.4179,8,120,187,1870,195,1990
7587,2011-11-17,4,0,11,17,0,4,1,1,0.32,0.2879,0.42,0.3881,20,300,379,3790,399,4090
7588,2011-11-17,4,0,11,18,0,4,1,1,0.32,0.3182,0.39,0.194,9,135,298,2980,307,3115
7589,2011-11-17,4,0,11,19,0,4,1,1,0.3,0.2879,0.45,0.2239,7,105,210,2100,217,2205
7590,2011-11-17,4,0,11,20,0,4,1,1,0.3,0.2879,0.42,0.2836,7,105,162,1620,169,1725
7591,2011-11-17,4,0,11,21,0,4,1,1,0.3,0.2879,0.42,0.2537,3,45,113,1130,116,1175
7592,2011-11-17,4,0,11,22,0,4,1,1,0.26,0.2424,0.52,0.2537,1,15,83,830,84,845
7593,2011-11-17,4,0,11,23,0,4,1,1,0.26,0.2576,0.52,0.2239,0,0,58,580,58,580
7594,2011-11-18,4,0,11,0,0,5,1,1,0.26,0.2576,0.48,0.1642,2,30,28,280,30,310
7595,2011-11-18,4,0,11,1,0,5,1,1,0.26,0.2273,0.44,0.3284,0,0,10,100,10,100
7596,2011-11-18,4,0,11,2,0,5,1,1,0.24,0.2273,0.44,0.2239,2,30,8,80,10,110
7597,2011-11-18,4,0,11,3,0,5,1,1,0.24,0.2121,0.41,0.2836,0,0,2,20,2,20
7598,2011-11-18,4,0,11,4,0,5,1,1,0.22,0.2273,0.44,0.1642,0,0,5,50,5,50
7599,2011-11-18,4,0,11,5,0,5,1,1,0.22,0.2273,0.44,0.1343,0,0,22,220,22,220
7600,2011-11-18,4,0,11,6,0,5,1,1,0.22,0.2576,0.44,0.0896,1,15,70,700,71,715
7601,2011-11-18,4,0,11,7,0,5,1,1,0.22,0.2273,0.44,0.1642,5,75,211,2110,216,2185
7602,2011-11-18,4,0,11,8,0,5,1,1,0.22,0.2273,0.44,0.194,6,90,369,3690,375,3780
7603,2011-11-18,4,0,11,9,0,5,1,1,0.26,0.2576,0.41,0.194,6,90,207,2070,213,2160
7604,2011-11-18,4,0,11,10,0,5,1,1,0.26,0.2424,0.41,0.2836,10,150,105,1050,115,1200
7605,2011-11-18,4,0,11,11,0,5,1,1,0.3,0.303,0.36,0.1343,18,270,122,1220,140,1490
7606,2011-11-18,4,0,11,12,0,5,1,1,0.32,0.3333,0.33,0.0,22,330,143,1430,165,1760
7607,2011-11-18,4,0,11,13,0,5,1,1,0.34,0.3182,0.31,0.2239,31,465,146,1460,177,1925
7608,2011-11-18,4,0,11,14,0,5,1,1,0.34,0.3333,0.31,0.1343,31,465,123,1230,154,1695
7609,2011-11-18,4,0,11,15,0,5,1,1,0.34,0.3333,0.29,0.1343,27,405,151,1510,178,1915
7610,2011-11-18,4,0,11,16,0,5,1,1,0.34,0.3333,0.29,0.1343,19,285,190,1900,209,2185
7611,2011-11-18,4,0,11,17,0,5,1,1,0.32,0.3333,0.31,0.1343,17,255,361,3610,378,3865
7612,2011-11-18,4,0,11,18,0,5,1,1,0.3,0.303,0.36,0.1642,16,240,312,3120,328,3360
7613,2011-11-18,4,0,11,19,0,5,1,1,0.28,0.2727,0.41,0.1642,7,105,183,1830,190,1935
7614,2011-11-18,4,0,11,20,0,5,1,1,0.28,0.2727,0.48,0.194,8,120,129,1290,137,1410
7615,2011-11-18,4,0,11,21,0,5,1,1,0.28,0.2727,0.48,0.1642,3,45,108,1080,111,1125
7616,2011-11-18,4,0,11,22,0,5,1,1,0.26,0.2727,0.52,0.1045,9,135,88,880,97,1015
7617,2011-11-18,4,0,11,23,0,5,1,1,0.26,0.2727,0.6,0.1343,5,75,54,540,59,615
7618,2011-11-19,4,0,11,0,0,6,0,1,0.26,0.2576,0.56,0.194,4,60,49,490,53,550
7619,2011-11-19,4,0,11,1,0,6,0,1,0.26,0.2273,0.52,0.2985,1,15,34,340,35,355
7620,2011-11-19,4,0,11,2,0,6,0,1,0.24,0.2424,0.56,0.1642,12,180,34,340,46,520
7621,2011-11-19,4,0,11,3,0,6,0,1,0.26,0.2424,0.48,0.2537,4,60,11,110,15,170
7622,2011-11-19,4,0,11,4,0,6,0,1,0.26,0.2273,0.48,0.3284,4,60,4,40,8,100
7623,2011-11-19,4,0,11,5,0,6,0,1,0.24,0.2273,0.56,0.2537,0,0,2,20,2,20
7624,2011-11-19,4,0,11,6,0,6,0,1,0.24,0.2121,0.6,0.3284,2,30,10,100,12,130
7625,2011-11-19,4,0,11,7,0,6,0,1,0.24,0.2273,0.6,0.2537,3,45,38,380,41,425
7626,2011-11-19,4,0,11,8,0,6,0,1,0.26,0.2424,0.56,0.2537,12,180,80,800,92,980
7627,2011-11-19,4,0,11,9,0,6,0,1,0.28,0.2576,0.52,0.2985,12,180,130,1300,142,1480
7628,2011-11-19,4,0,11,10,0,6,0,1,0.32,0.303,0.45,0.2537,35,525,165,1650,200,2175
7629,2011-11-19,4,0,11,11,0,6,0,1,0.36,0.3788,0.4,0.0,50,750,183,1830,233,2580
7630,2011-11-19,4,0,11,12,0,6,0,1,0.4,0.4091,0.35,0.2836,93,1395,218,2180,311,3575
7631,2011-11-19,4,0,11,13,0,6,0,1,0.42,0.4242,0.3,0.2836,118,1770,245,2450,363,4220
7632,2011-11-19,4,0,11,14,0,6,0,1,0.42,0.4242,0.32,0.2985,121,1815,228,2280,349,4095
7633,2011-11-19,4,0,11,15,0,6,0,1,0.42,0.4242,0.41,0.194,120,1800,262,2620,382,4420
7634,2011-11-19,4,0,11,16,0,6,0,1,0.42,0.4242,0.38,0.2985,99,1485,188,1880,287,3365
7635,2011-11-19,4,0,11,17,0,6,0,1,0.4,0.4091,0.4,0.194,61,915,171,1710,232,2625
7636,2011-11-19,4,0,11,18,0,6,0,1,0.38,0.3939,0.46,0.1343,36,540,172,1720,208,2260
7637,2011-11-19,4,0,11,19,0,6,0,2,0.34,0.3333,0.71,0.1343,33,495,149,1490,182,1985
7638,2011-11-19,4,0,11,20,0,6,0,2,0.36,0.3636,0.57,0.1045,48,720,115,1150,163,1870
7639,2011-11-19,4,0,11,21,0,6,0,2,0.36,0.3485,0.62,0.194,29,435,79,790,108,1225
7640,2011-11-19,4,0,11,22,0,6,0,2,0.38,0.3939,0.62,0.1642,26,390,80,800,106,1190
7641,2011-11-19,4,0,11,23,0,6,0,1,0.38,0.3939,0.62,0.2239,20,300,73,730,93,1030
7642,2011-11-20,4,0,11,0,0,0,0,1,0.38,0.3939,0.66,0.1642,14,210,79,790,93,1000
7643,2011-11-20,4,0,11,1,0,0,0,1,0.4,0.4091,0.62,0.2537,11,165,73,730,84,895
7644,2011-11-20,4,0,11,2,0,0,0,1,0.4,0.4091,0.62,0.2836,12,180,44,440,56,620
7645,2011-11-20,4,0,11,3,0,0,0,2,0.4,0.4091,0.66,0.2836,6,90,31,310,37,400
7646,2011-11-20,4,0,11,4,0,0,0,2,0.4,0.4091,0.71,0.2836,2,30,10,100,12,130
7647,2011-11-20,4,0,11,5,0,0,0,2,0.42,0.4242,0.67,0.2836,0,0,4,40,4,40
7648,2011-11-20,4,0,11,6,0,0,0,2,0.42,0.4242,0.67,0.2537,3,45,6,60,9,105
7649,2011-11-20,4,0,11,7,0,0,0,1,0.42,0.4242,0.67,0.2239,4,60,19,190,23,250
7650,2011-11-20,4,0,11,8,0,0,0,2,0.42,0.4242,0.71,0.2836,13,195,52,520,65,715
7651,2011-11-20,4,0,11,9,0,0,0,1,0.44,0.4394,0.72,0.1642,29,435,109,1090,138,1525
7652,2011-11-20,4,0,11,10,0,0,0,2,0.44,0.4394,0.72,0.1045,46,690,183,1830,229,2520
7653,2011-11-20,4,0,11,11,0,0,0,2,0.5,0.4848,0.63,0.1045,74,1110,212,2120,286,3230
7654,2011-11-20,4,0,11,12,0,0,0,2,0.5,0.4848,0.63,0.1343,70,1050,234,2340,304,3390
7655,2011-11-20,4,0,11,13,0,0,0,2,0.54,0.5152,0.6,0.194,84,1260,285,2850,369,4110
7656,2011-11-20,4,0,11,14,0,0,0,1,0.52,0.5,0.63,0.2537,113,1695,250,2500,363,4195
7657,2011-11-20,4,0,11,15,0,0,0,2,0.52,0.5,0.68,0.194,109,1635,242,2420,351,4055
7658,2011-11-20,4,0,11,16,0,0,0,2,0.52,0.5,0.63,0.1343,81,1215,225,2250,306,3465
7659,2011-11-20,4,0,11,17,0,0,0,2,0.52,0.5,0.63,0.194,35,525,168,1680,203,2205
7660,2011-11-20,4,0,11,18,0,0,0,2,0.54,0.5152,0.64,0.194,22,330,123,1230,145,1560
7661,2011-11-20,4,0,11,19,0,0,0,2,0.5,0.4848,0.72,0.1045,17,255,140,1400,157,1655
7662,2011-11-20,4,0,11,20,0,0,0,2,0.52,0.5,0.68,0.1045,23,345,90,900,113,1245
7663,2011-11-20,4,0,11,21,0,0,0,2,0.48,0.4697,0.77,0.0896,11,165,94,940,105,1105
7664,2011-11-20,4,0,11,22,0,0,0,3,0.46,0.4545,0.88,0.0896,5,75,35,350,40,425
7665,2011-11-20,4,0,11,23,0,0,0,3,0.46,0.4545,0.88,0.0896,3,45,25,250,28,295
7666,2011-11-21,4,0,11,0,0,1,1,2,0.46,0.4545,0.94,0.0,4,60,13,130,17,190
7667,2011-11-21,4,0,11,1,0,1,1,3,0.46,0.4545,0.94,0.194,4,60,8,80,12,140
7668,2011-11-21,4,0,11,2,0,1,1,3,0.44,0.4394,1.0,0.194,1,15,2,20,3,35
7669,2011-11-21,4,0,11,3,0,1,1,3,0.44,0.4394,1.0,0.1343,0,0,4,40,4,40
7670,2011-11-21,4,0,11,4,0,1,1,3,0.44,0.4394,1.0,0.1343,0,0,5,50,5,50
7671,2011-11-21,4,0,11,5,0,1,1,2,0.44,0.4394,1.0,0.0,0,0,20,200,20,200
7672,2011-11-21,4,0,11,6,0,1,1,2,0.42,0.4242,1.0,0.0,0,0,76,760,76,760
7673,2011-11-21,4,0,11,7,0,1,1,2,0.46,0.4545,0.94,0.1642,17,255,229,2290,246,2545
7674,2011-11-21,4,0,11,8,0,1,1,2,0.46,0.4545,0.94,0.0,13,195,378,3780,391,3975
7675,2011-11-21,4,0,11,9,0,1,1,2,0.48,0.4697,0.94,0.1045,15,225,222,2220,237,2445
7676,2011-11-21,4,0,11,10,0,1,1,2,0.52,0.5,0.83,0.0,25,375,110,1100,135,1475
7677,2011-11-21,4,0,11,11,0,1,1,2,0.52,0.5,0.83,0.1045,16,240,112,1120,128,1360
7678,2011-11-21,4,0,11,12,0,1,1,2,0.5,0.4848,0.77,0.1343,24,360,138,1380,162,1740
7679,2011-11-21,4,0,11,13,0,1,1,2,0.5,0.4848,0.77,0.1343,13,195,121,1210,134,1405
7680,2011-11-21,4,0,11,14,0,1,1,2,0.48,0.4697,0.82,0.194,14,210,121,1210,135,1420
7681,2011-11-21,4,0,11,15,0,1,1,3,0.44,0.4394,0.94,0.2239,15,225,93,930,108,1155
7682,2011-11-21,4,0,11,16,0,1,1,3,0.44,0.4394,0.94,0.2239,13,195,95,950,108,1145
7683,2011-11-21,4,0,11,17,0,1,1,3,0.42,0.4242,0.94,0.2985,10,150,200,2000,210,2150
7684,2011-11-21,4,0,11,18,0,1,1,3,0.42,0.4242,0.88,0.194,8,120,184,1840,192,1960
7685,2011-11-21,4,0,11,19,0,1,1,3,0.4,0.4091,0.94,0.194,2,30,135,1350,137,1380
7686,2011-11-21,4,0,11,20,0,1,1,3,0.4,0.4091,0.87,0.2239,5,75,75,750,80,825
7687,2011-11-21,4,0,11,21,0,1,1,3,0.4,0.4091,0.87,0.1642,11,165,103,1030,114,1195
7688,2011-11-21,4,0,11,22,0,1,1,3,0.4,0.4091,0.87,0.1343,6,90,72,720,78,810
7689,2011-11-21,4,0,11,23,0,1,1,3,0.4,0.4091,0.87,0.1642,4,60,29,290,33,350
7690,2011-11-22,4,0,11,0,0,2,1,3,0.38,0.3939,0.94,0.1045,0,0,14,140,14,140
7691,2011-11-22,4,0,11,1,0,2,1,3,0.4,0.4091,0.94,0.1343,1,15,5,50,6,65
7692,2011-11-22,4,0,11,2,0,2,1,3,0.38,0.3939,1.0,0.1045,2,30,4,40,6,70
7693,2011-11-22,4,0,11,3,0,2,1,3,0.38,0.3939,1.0,0.1045,1,15,2,20,3,35
7694,2011-11-22,4,0,11,4,0,2,1,3,0.38,0.3939,0.94,0.1642,0,0,7,70,7,70
7695,2011-11-22,4,0,11,5,0,2,1,3,0.38,0.3939,0.94,0.1642,1,15,17,170,18,185
7696,2011-11-22,4,0,11,6,0,2,1,2,0.38,0.3939,0.94,0.1045,1,15,63,630,64,645
7697,2011-11-22,4,0,11,7,0,2,1,3,0.38,0.3939,0.94,0.2239,2,30,119,1190,121,1220
7698,2011-11-22,4,0,11,8,0,2,1,3,0.38,0.3939,0.94,0.2239,5,75,185,1850,190,1925
7699,2011-11-22,4,0,11,9,0,2,1,3,0.4,0.4091,0.94,0.0,2,30,147,1470,149,1500
7700,2011-11-22,4,0,11,10,0,2,1,3,0.4,0.4091,0.94,0.0,6,90,46,460,52,550
7701,2011-11-22,4,0,11,11,0,2,1,3,0.4,0.4091,0.94,0.1343,4,60,28,280,32,340
7702,2011-11-22,4,0,11,12,0,2,1,3,0.4,0.4091,1.0,0.0896,3,45,18,180,21,225
7703,2011-11-22,4,0,11,13,0,2,1,3,0.42,0.4242,1.0,0.0896,4,60,22,220,26,280
7704,2011-11-22,4,0,11,14,0,2,1,3,0.42,0.4242,1.0,0.0896,4,60,31,310,35,370
7705,2011-11-22,4,0,11,15,0,2,1,3,0.44,0.4394,0.94,0.0,2,30,32,320,34,350
7706,2011-11-22,4,0,11,16,0,2,1,3,0.44,0.4394,0.94,0.0,3,45,59,590,62,635
7707,2011-11-22,4,0,11,17,0,2,1,3,0.44,0.4394,1.0,0.0896,4,60,161,1610,165,1670
7708,2011-11-22,4,0,11,18,0,2,1,3,0.44,0.4394,1.0,0.0,0,0,148,1480,148,1480
7709,2011-11-22,4,0,11,19,0,2,1,3,0.46,0.4545,0.94,0.1045,5,75,106,1060,111,1135
7710,2011-11-22,4,0,11,20,0,2,1,2,0.46,0.4545,1.0,0.2239,6,90,121,1210,127,1300
7711,2011-11-22,4,0,11,21,0,2,1,2,0.46,0.4545,1.0,0.2537,4,60,86,860,90,920
7712,2011-11-22,4,0,11,22,0,2,1,2,0.5,0.4848,0.94,0.194,6,90,81,810,87,900
7713,2011-11-22,4,0,11,23,0,2,1,2,0.48,0.4697,0.94,0.2537,3,45,36,360,39,405
7714,2011-11-23,4,0,11,0,0,3,1,2,0.48,0.4697,0.94,0.2537,2,30,14,140,16,170
7715,2011-11-23,4,0,11,1,0,3,1,2,0.48,0.4697,0.94,0.2985,0,0,8,80,8,80
7716,2011-11-23,4,0,11,2,0,3,1,3,0.5,0.4848,0.94,0.3582,1,15,5,50,6,65
7717,2011-11-23,4,0,11,3,0,3,1,3,0.5,0.4848,0.94,0.3582,1,15,2,20,3,35
7718,2011-11-23,4,0,11,4,0,3,1,3,0.52,0.5,0.88,0.3582,0,0,5,50,5,50
7719,2011-11-23,4,0,11,5,0,3,1,2,0.46,0.4545,0.94,0.194,1,15,16,160,17,175
7720,2011-11-23,4,0,11,6,0,3,1,2,0.44,0.4394,1.0,0.0,1,15,68,680,69,695
7721,2011-11-23,4,0,11,7,0,3,1,2,0.46,0.4545,1.0,0.0896,2,30,154,1540,156,1570
7722,2011-11-23,4,0,11,8,0,3,1,2,0.48,0.4697,0.94,0.1045,7,105,316,3160,323,3265
7723,2011-11-23,4,0,11,9,0,3,1,2,0.52,0.5,0.94,0.194,3,45,164,1640,167,1685
7724,2011-11-23,4,0,11,10,0,3,1,2,0.52,0.5,0.94,0.194,6,90,70,700,76,790
7725,2011-11-23,4,0,11,11,0,3,1,2,0.5,0.4848,0.72,0.4179,9,135,107,1070,116,1205
7726,2011-11-23,4,0,11,12,0,3,1,1,0.48,0.4697,0.55,0.4179,9,135,151,1510,160,1645
7727,2011-11-23,4,0,11,13,0,3,1,2,0.44,0.4394,0.54,0.4925,12,180,162,1620,174,1800
7728,2011-11-23,4,0,11,14,0,3,1,1,0.42,0.4242,0.54,0.4627,13,195,200,2000,213,2195
7729,2011-11-23,4,0,11,15,0,3,1,2,0.42,0.4242,0.54,0.4478,13,195,194,1940,207,2135
7730,2011-11-23,4,0,11,16,0,3,1,2,0.4,0.4091,0.62,0.4627,4,60,169,1690,173,1750
7731,2011-11-23,4,0,11,17,0,3,1,3,0.38,0.3939,0.71,0.3881,7,105,156,1560,163,1665
7732,2011-11-23,4,0,11,18,0,3,1,2,0.4,0.4091,0.58,0.5224,7,105,138,1380,145,1485
7733,2011-11-23,4,0,11,19,0,3,1,1,0.38,0.3939,0.58,0.3881,6,90,116,1160,122,1250
7734,2011-11-23,4,0,11,20,0,3,1,1,0.36,0.3333,0.62,0.3881,1,15,67,670,68,685
7735,2011-11-23,4,0,11,21,0,3,1,1,0.36,0.3182,0.57,0.4627,0,0,66,660,66,660
7736,2011-11-23,4,0,11,22,0,3,1,1,0.34,0.303,0.61,0.4478,3,45,59,590,62,635
7737,2011-11-23,4,0,11,23,0,3,1,1,0.34,0.303,0.61,0.3582,4,60,47,470,51,530
7738,2011-11-24,4,0,11,0,1,4,0,1,0.32,0.303,0.57,0.2239,1,15,22,220,23,235
7739,2011-11-24,4,0,11,1,1,4,0,1,0.32,0.2879,0.57,0.4179,1,15,23,230,24,245
7740,2011-11-24,4,0,11,2,1,4,0,1,0.3,0.2879,0.61,0.2836,3,45,19,190,22,235
7741,2011-11-24,4,0,11,3,1,4,0,1,0.28,0.2879,0.65,0.1343,1,15,4,40,5,55
7742,2011-11-24,4,0,11,4,1,4,0,1,0.3,0.3182,0.61,0.0896,1,15,1,10,2,25
7743,2011-11-24,4,0,11,5,1,4,0,1,0.3,0.3182,0.61,0.1045,1,15,10,100,11,115
7744,2011-11-24,4,0,11,6,1,4,0,1,0.3,0.3182,0.61,0.0896,1,15,5,50,6,65
7745,2011-11-24,4,0,11,7,1,4,0,1,0.26,0.2727,0.75,0.1045,9,135,31,310,40,445
7746,2011-11-24,4,0,11,8,1,4,0,1,0.3,0.3182,0.65,0.0896,4,60,42,420,46,480
7747,2011-11-24,4,0,11,9,1,4,0,1,0.34,0.3485,0.61,0.0,13,195,68,680,81,875
7748,2011-11-24,4,0,11,10,1,4,0,1,0.36,0.3788,0.57,0.0,34,510,64,640,98,1150
7749,2011-11-24,4,0,11,11,1,4,0,1,0.42,0.4242,0.41,0.2985,52,780,90,900,142,1680
7750,2011-11-24,4,0,11,12,1,4,0,1,0.46,0.4545,0.36,0.2239,62,930,88,880,150,1810
7751,2011-11-24,4,0,11,13,1,4,0,1,0.48,0.4697,0.33,0.2239,84,1260,91,910,175,2170
7752,2011-11-24,4,0,11,14,1,4,0,1,0.5,0.4848,0.31,0.2985,74,1110,94,940,168,2050
7753,2011-11-24,4,0,11,15,1,4,0,1,0.5,0.4848,0.31,0.2537,78,1170,71,710,149,1880
7754,2011-11-24,4,0,11,16,1,4,0,1,0.5,0.4848,0.34,0.2836,48,720,66,660,114,1380
7755,2011-11-24,4,0,11,17,1,4,0,1,0.48,0.4697,0.33,0.1045,34,510,40,400,74,910
7756,2011-11-24,4,0,11,18,1,4,0,1,0.42,0.4242,0.5,0.0896,13,195,24,240,37,435
7757,2011-11-24,4,0,11,19,1,4,0,1,0.4,0.4091,0.54,0.1045,15,225,13,130,28,355
7758,2011-11-24,4,0,11,20,1,4,0,1,0.36,0.3485,0.76,0.1642,14,210,17,170,31,380
7759,2011-11-24,4,0,11,21,1,4,0,1,0.36,0.3485,0.71,0.1642,7,105,19,190,26,295
7760,2011-11-24,4,0,11,22,1,4,0,1,0.36,0.3485,0.71,0.1642,8,120,14,140,22,260
7761,2011-11-24,4,0,11,23,1,4,0,1,0.34,0.3485,0.76,0.1045,2,30,19,190,21,220
7762,2011-11-25,4,0,11,0,0,5,1,1,0.34,0.3333,0.76,0.1642,7,105,22,220,29,325
7763,2011-11-25,4,0,11,1,0,5,1,1,0.34,0.3636,0.76,0.0,2,30,12,120,14,150
7764,2011-11-25,4,0,11,2,0,5,1,1,0.28,0.2879,0.81,0.1045,4,60,6,60,10,120
7765,2011-11-25,4,0,11,3,0,5,1,1,0.28,0.2879,0.75,0.1045,0,0,2,20,2,20
7766,2011-11-25,4,0,11,4,0,5,1,1,0.3,0.3182,0.75,0.1045,4,60,3,30,7,90
7767,2011-11-25,4,0,11,5,0,5,1,1,0.28,0.3182,0.75,0.0,2,30,3,30,5,60
7768,2011-11-25,4,0,11,6,0,5,1,1,0.26,0.2727,0.81,0.1045,4,60,9,90,13,150
7769,2011-11-25,4,0,11,7,0,5,1,1,0.26,0.303,0.81,0.0,4,60,31,310,35,370
7770,2011-11-25,4,0,11,8,0,5,1,1,0.26,0.2727,0.81,0.1343,6,90,68,680,74,770
7771,2011-11-25,4,0,11,9,0,5,1,1,0.32,0.3485,0.76,0.0,25,375,70,700,95,1075
7772,2011-11-25,4,0,11,10,0,5,1,1,0.36,0.3485,0.71,0.1642,60,900,82,820,142,1720
7773,2011-11-25,4,0,11,11,0,5,1,1,0.4,0.4091,0.66,0.1045,99,1485,127,1270,226,2755
7774,2011-11-25,4,0,11,12,0,5,1,1,0.46,0.4545,0.51,0.1045,126,1890,146,1460,272,3350
7775,2011-11-25,4,0,11,13,0,5,1,1,0.5,0.4848,0.45,0.2239,143,2145,140,1400,283,3545
7776,2011-11-25,4,0,11,14,0,5,1,1,0.52,0.5,0.39,0.2239,122,1830,150,1500,272,3330
7777,2011-11-25,4,0,11,15,0,5,1,1,0.52,0.5,0.36,0.194,165,2475,145,1450,310,3925
7778,2011-11-25,4,0,11,16,0,5,1,1,0.5,0.4848,0.39,0.1642,122,1830,139,1390,261,3220
7779,2011-11-25,4,0,11,17,0,5,1,1,0.5,0.4848,0.34,0.1045,57,855,127,1270,184,2125
7780,2011-11-25,4,0,11,18,0,5,1,1,0.46,0.4545,0.44,0.0896,45,675,108,1080,153,1755
7781,2011-11-25,4,0,11,19,0,5,1,1,0.42,0.4242,0.67,0.0,38,570,96,960,134,1530
7782,2011-11-25,4,0,11,20,0,5,1,1,0.4,0.4091,0.58,0.0896,19,285,76,760,95,1045
7783,2011-11-25,4,0,11,21,0,5,1,1,0.36,0.3788,0.71,0.0,24,360,61,610,85,970
7784,2011-11-25,4,0,11,22,0,5,1,1,0.34,0.3485,0.71,0.0896,12,180,46,460,58,640
7785,2011-11-25,4,0,11,23,0,5,1,1,0.34,0.3485,0.76,0.1045,5,75,28,280,33,355
7786,2011-11-26,4,0,11,0,0,6,0,1,0.34,0.3485,0.76,0.1045,9,135,38,380,47,515
7787,2011-11-26,4,0,11,1,0,6,0,1,0.32,0.3333,0.76,0.0896,5,75,24,240,29,315
7788,2011-11-26,4,0,11,2,0,6,0,1,0.3,0.3182,0.81,0.1045,3,45,20,200,23,245
7789,2011-11-26,4,0,11,3,0,6,0,1,0.3,0.3333,0.81,0.0,8,120,9,90,17,210
7790,2011-11-26,4,0,11,4,0,6,0,1,0.3,0.3333,0.81,0.0,0,0,4,40,4,40
7791,2011-11-26,4,0,11,5,0,6,0,1,0.3,0.3182,0.75,0.1045,0,0,3,30,3,30
7792,2011-11-26,4,0,11,6,0,6,0,2,0.3,0.3182,0.75,0.0896,2,30,8,80,10,110
7793,2011-11-26,4,0,11,7,0,6,0,1,0.26,0.2727,0.87,0.1045,4,60,13,130,17,190
7794,2011-11-26,4,0,11,8,0,6,0,1,0.32,0.3333,0.76,0.0896,10,150,50,500,60,650
7795,2011-11-26,4,0,11,9,0,6,0,1,0.34,0.3485,0.76,0.0896,16,240,67,670,83,910
7796,2011-11-26,4,0,11,10,0,6,0,1,0.36,0.3788,0.81,0.0,57,855,84,840,141,1695
7797,2011-11-26,4,0,11,11,0,6,0,1,0.4,0.4091,0.62,0.1045,107,1605,123,1230,230,2835
7798,2011-11-26,4,0,11,12,0,6,0,1,0.44,0.4394,0.51,0.0,137,2055,172,1720,309,3775
7799,2011-11-26,4,0,11,13,0,6,0,1,0.48,0.4697,0.44,0.0,177,2655,148,1480,325,4135
7800,2011-11-26,4,0,11,14,0,6,0,2,0.48,0.4697,0.48,0.1343,141,2115,158,1580,299,3695
7801,2011-11-26,4,0,11,15,0,6,0,2,0.5,0.4848,0.42,0.1045,154,2310,160,1600,314,3910
7802,2011-11-26,4,0,11,16,0,6,0,2,0.46,0.4545,0.47,0.1343,137,2055,138,1380,275,3435
7803,2011-11-26,4,0,11,17,0,6,0,2,0.46,0.4545,0.47,0.1343,62,930,122,1220,184,2150
7804,2011-11-26,4,0,11,18,0,6,0,2,0.42,0.4242,0.62,0.1642,67,1005,118,1180,185,2185
7805,2011-11-26,4,0,11,19,0,6,0,2,0.4,0.4091,0.71,0.0896,46,690,100,1000,146,1690
7806,2011-11-26,4,0,11,20,0,6,0,2,0.42,0.4242,0.58,0.0,55,825,86,860,141,1685
7807,2011-11-26,4,0,11,21,0,6,0,2,0.38,0.3939,0.82,0.0,20,300,72,720,92,1020
7808,2011-11-26,4,0,11,22,0,6,0,2,0.38,0.3939,0.76,0.0,14,210,51,510,65,720
7809,2011-11-26,4,0,11,23,0,6,0,1,0.36,0.3788,0.81,0.0,18,270,51,510,69,780
7810,2011-11-27,4,0,11,0,0,0,0,1,0.36,0.3788,0.81,0.0,7,105,39,390,46,495
7811,2011-11-27,4,0,11,1,0,0,0,1,0.36,0.3788,0.81,0.0,9,135,35,350,44,485
7812,2011-11-27,4,0,11,2,0,0,0,1,0.34,0.3636,0.81,0.0,9,135,22,220,31,355
7813,2011-11-27,4,0,11,3,0,0,0,1,0.34,0.3636,0.87,0.0,9,135,8,80,17,215
7814,2011-11-27,4,0,11,4,0,0,0,1,0.34,0.3485,0.87,0.1045,0,0,4,40,4,40
7815,2011-11-27,4,0,11,5,0,0,0,1,0.36,0.3485,0.87,0.194,0,0,5,50,5,50
7816,2011-11-27,4,0,11,6,0,0,0,1,0.38,0.3939,0.82,0.1642,0,0,9,90,9,90
7817,2011-11-27,4,0,11,7,0,0,0,1,0.38,0.3939,0.87,0.2239,12,180,11,110,23,290
7818,2011-11-27,4,0,11,8,0,0,0,1,0.4,0.4091,0.82,0.2985,6,90,36,360,42,450
7819,2011-11-27,4,0,11,9,0,0,0,1,0.46,0.4545,0.72,0.2836,21,315,90,900,111,1215
7820,2011-11-27,4,0,11,10,0,0,0,1,0.46,0.4545,0.72,0.2836,58,870,131,1310,189,2180
7821,2011-11-27,4,0,11,11,0,0,0,1,0.5,0.4848,0.63,0.3582,83,1245,157,1570,240,2815
7822,2011-11-27,4,0,11,12,0,0,0,1,0.54,0.5152,0.56,0.2836,63,945,193,1930,256,2875
7823,2011-11-27,4,0,11,13,0,0,0,1,0.54,0.5152,0.6,0.194,97,1455,216,2160,313,3615
7824,2011-11-27,4,0,11,14,0,0,0,1,0.62,0.6212,0.43,0.4627,113,1695,200,2000,313,3695
7825,2011-11-27,4,0,11,15,0,0,0,1,0.62,0.6212,0.43,0.2836,96,1440,221,2210,317,3650
7826,2011-11-27,4,0,11,16,0,0,0,1,0.56,0.5303,0.52,0.2537,94,1410,229,2290,323,3700
7827,2011-11-27,4,0,11,17,0,0,0,1,0.54,0.5152,0.56,0.194,37,555,167,1670,204,2225
7828,2011-11-27,4,0,11,18,0,0,0,1,0.5,0.4848,0.63,0.1642,25,375,130,1300,155,1675
7829,2011-11-27,4,0,11,19,0,0,0,1,0.48,0.4697,0.67,0.2239,30,450,109,1090,139,1540
7830,2011-11-27,4,0,11,20,0,0,0,1,0.5,0.4848,0.63,0.2537,10,150,94,940,104,1090
7831,2011-11-27,4,0,11,21,0,0,0,1,0.48,0.4697,0.67,0.2836,13,195,75,750,88,945
7832,2011-11-27,4,0,11,22,0,0,0,1,0.48,0.4697,0.72,0.2537,13,195,53,530,66,725
7833,2011-11-27,4,0,11,23,0,0,0,1,0.48,0.4697,0.72,0.2537,5,75,27,270,32,345
7834,2011-11-28,4,0,11,0,0,1,1,1,0.46,0.4545,0.77,0.2836,6,90,10,100,16,190
7835,2011-11-28,4,0,11,1,0,1,1,1,0.46,0.4545,0.77,0.2985,1,15,12,120,13,135
7836,2011-11-28,4,0,11,3,0,1,1,1,0.44,0.4394,0.88,0.2239,1,15,4,40,5,55
7837,2011-11-28,4,0,11,4,0,1,1,1,0.44,0.4394,0.82,0.0896,0,0,4,40,4,40
7838,2011-11-28,4,0,11,5,0,1,1,1,0.4,0.4091,0.87,0.0,0,0,34,340,34,340
7839,2011-11-28,4,0,11,6,0,1,1,1,0.42,0.4242,0.82,0.0896,6,90,98,980,104,1070
7840,2011-11-28,4,0,11,7,0,1,1,1,0.42,0.4242,0.88,0.0,7,105,270,2700,277,2805
7841,2011-11-28,4,0,11,8,0,1,1,2,0.42,0.4242,0.94,0.0,13,195,394,3940,407,4135
7842,2011-11-28,4,0,11,9,0,1,1,2,0.44,0.4394,0.88,0.2239,17,255,191,1910,208,2165
7843,2011-11-28,4,0,11,10,0,1,1,2,0.48,0.4697,0.77,0.1343,21,315,86,860,107,1175
7844,2011-11-28,4,0,11,11,0,1,1,2,0.52,0.5,0.68,0.1045,11,165,107,1070,118,1235
7845,2011-11-28,4,0,11,12,0,1,1,1,0.56,0.5303,0.6,0.1045,13,195,165,1650,178,1845
7846,2011-11-28,4,0,11,13,0,1,1,2,0.58,0.5455,0.56,0.0,25,375,137,1370,162,1745
7847,2011-11-28,4,0,11,14,0,1,1,1,0.6,0.6212,0.56,0.0,14,210,129,1290,143,1500
7848,2011-11-28,4,0,11,15,0,1,1,1,0.58,0.5455,0.6,0.1642,18,270,132,1320,150,1590
7849,2011-11-28,4,0,11,16,0,1,1,1,0.56,0.5303,0.6,0.194,24,360,240,2400,264,2760
7850,2011-11-28,4,0,11,17,0,1,1,1,0.58,0.5455,0.56,0.194,24,360,444,4440,468,4800
7851,2011-11-28,4,0,11,18,0,1,1,1,0.56,0.5303,0.64,0.2239,20,300,396,3960,416,4260
7852,2011-11-28,4,0,11,19,0,1,1,1,0.54,0.5152,0.73,0.2239,4,60,260,2600,264,2660
7853,2011-11-28,4,0,11,20,0,1,1,2,0.54,0.5152,0.73,0.2537,12,180,206,2060,218,2240
7854,2011-11-28,4,0,11,21,0,1,1,2,0.54,0.5152,0.77,0.2239,4,60,152,1520,156,1580
7855,2011-11-28,4,0,11,22,0,1,1,2,0.52,0.5,0.83,0.1045,7,105,102,1020,109,1125
7856,2011-11-28,4,0,11,23,0,1,1,2,0.52,0.5,0.83,0.1343,5,75,41,410,46,485
7857,2011-11-29,4,0,11,0,0,2,1,1,0.52,0.5,0.83,0.0,4,60,18,180,22,240
7858,2011-11-29,4,0,11,1,0,2,1,1,0.52,0.5,0.83,0.0896,1,15,16,160,17,175
7859,2011-11-29,4,0,11,2,0,2,1,2,0.5,0.4848,0.88,0.0,0,0,5,50,5,50
7860,2011-11-29,4,0,11,3,0,2,1,2,0.5,0.4848,0.88,0.0,0,0,2,20,2,20
7861,2011-11-29,4,0,11,4,0,2,1,2,0.52,0.5,0.83,0.3284,1,15,5,50,6,65
7862,2011-11-29,4,0,11,5,0,2,1,1,0.5,0.4848,0.88,0.2836,1,15,21,210,22,225
7863,2011-11-29,4,0,11,6,0,2,1,1,0.52,0.5,0.83,0.2836,1,15,88,880,89,895
7864,2011-11-29,4,0,11,7,0,2,1,1,0.52,0.5,0.77,0.2239,12,180,330,3300,342,3480
7865,2011-11-29,4,0,11,8,0,2,1,1,0.54,0.5152,0.77,0.2836,9,135,440,4400,449,4535
7866,2011-11-29,4,0,11,9,0,2,1,3,0.56,0.5303,0.73,0.4179,5,75,197,1970,202,2045
7867,2011-11-29,4,0,11,10,0,2,1,3,0.56,0.5303,0.73,0.4179,2,30,34,340,36,370
7868,2011-11-29,4,0,11,11,0,2,1,3,0.5,0.4848,0.88,0.2985,1,15,10,100,11,115
7869,2011-11-29,4,0,11,12,0,2,1,3,0.42,0.4242,0.82,0.4179,1,15,17,170,18,185
7870,2011-11-29,4,0,11,13,0,2,1,3,0.42,0.4242,0.77,0.2836,0,0,22,220,22,220
7871,2011-11-29,4,0,11,14,0,2,1,3,0.4,0.4091,0.94,0.194,1,15,35,350,36,365
7872,2011-11-29,4,0,11,15,0,2,1,3,0.4,0.4091,0.87,0.3284,5,75,60,600,65,675
7873,2011-11-29,4,0,11,16,0,2,1,3,0.4,0.4091,0.87,0.2239,5,75,146,1460,151,1535
7874,2011-11-29,4,0,11,17,0,2,1,2,0.4,0.4091,0.87,0.2985,8,120,346,3460,354,3580
7875,2011-11-29,4,0,11,18,0,2,1,2,0.4,0.4091,0.82,0.2985,11,165,347,3470,358,3635
7876,2011-11-29,4,0,11,19,0,2,1,2,0.4,0.4091,0.82,0.3284,6,90,244,2440,250,2530
7877,2011-11-29,4,0,11,20,0,2,1,2,0.38,0.3939,0.87,0.2537,8,120,176,1760,184,1880
7878,2011-11-29,4,0,11,21,0,2,1,2,0.38,0.3939,0.87,0.2537,9,135,116,1160,125,1295
7879,2011-11-29,4,0,11,22,0,2,1,1,0.38,0.3939,0.82,0.2985,5,75,90,900,95,975
7880,2011-11-29,4,0,11,23,0,2,1,1,0.36,0.3333,0.76,0.3881,0,0,53,530,53,530
7881,2011-11-30,4,0,11,0,0,3,1,1,0.36,0.3333,0.62,0.4179,1,15,23,230,24,245
7882,2011-11-30,4,0,11,1,0,3,1,1,0.34,0.303,0.66,0.3284,0,0,8,80,8,80
7883,2011-11-30,4,0,11,2,0,3,1,1,0.32,0.3182,0.7,0.1642,0,0,5,50,5,50
7884,2011-11-30,4,0,11,3,0,3,1,1,0.32,0.3182,0.7,0.1642,0,0,1,10,1,10
7885,2011-11-30,4,0,11,4,0,3,1,1,0.3,0.2879,0.75,0.2239,0,0,5,50,5,50
7886,2011-11-30,4,0,11,5,0,3,1,1,0.28,0.2727,0.81,0.194,1,15,21,210,22,225
7887,2011-11-30,4,0,11,6,0,3,1,1,0.26,0.2727,0.87,0.1045,3,45,100,1000,103,1045
7888,2011-11-30,4,0,11,7,0,3,1,1,0.26,0.2727,0.81,0.1045,9,135,276,2760,285,2895
7889,2011-11-30,4,0,11,8,0,3,1,1,0.28,0.2727,0.81,0.194,13,195,465,4650,478,4845
7890,2011-11-30,4,0,11,9,0,3,1,1,0.3,0.2879,0.75,0.2836,7,105,186,1860,193,1965
7891,2011-11-30,4,0,11,10,0,3,1,1,0.34,0.3182,0.66,0.2239,15,225,95,950,110,1175
7892,2011-11-30,4,0,11,11,0,3,1,1,0.38,0.3939,0.54,0.2985,10,150,112,1120,122,1270
7893,2011-11-30,4,0,11,12,0,3,1,2,0.36,0.3333,0.53,0.2836,12,180,148,1480,160,1660
7894,2011-11-30,4,0,11,13,0,3,1,2,0.38,0.3939,0.43,0.3582,16,240,131,1310,147,1550
7895,2011-11-30,4,0,11,14,0,3,1,2,0.38,0.3939,0.43,0.3582,13,195,99,990,112,1185
7896,2011-11-30,4,0,11,15,0,3,1,1,0.36,0.3333,0.46,0.3284,11,165,104,1040,115,1205
7897,2011-11-30,4,0,11,16,0,3,1,1,0.36,0.3333,0.46,0.2836,27,405,199,1990,226,2395
7898,2011-11-30,4,0,11,17,0,3,1,2,0.34,0.303,0.49,0.3284,15,225,365,3650,380,3875
7899,2011-11-30,4,0,11,18,0,3,1,1,0.34,0.303,0.49,0.3284,7,105,369,3690,376,3795
7900,2011-11-30,4,0,11,19,0,3,1,2,0.32,0.303,0.57,0.2836,6,90,273,2730,279,2820
7901,2011-11-30,4,0,11,20,0,3,1,2,0.32,0.303,0.57,0.2836,6,90,184,1840,190,1930
7902,2011-11-30,4,0,11,21,0,3,1,1,0.32,0.2879,0.53,0.3881,7,105,128,1280,135,1385
7903,2011-11-30,4,0,11,22,0,3,1,1,0.3,0.2727,0.56,0.2985,5,75,82,820,87,895
7904,2011-11-30,4,0,11,23,0,3,1,1,0.28,0.2576,0.52,0.2836,4,60,46,460,50,520
7905,2011-12-01,4,0,12,0,0,4,1,1,0.28,0.2576,0.52,0.3284,1,15,19,190,20,205
7906,2011-12-01,4,0,12,1,0,4,1,1,0.26,0.2424,0.6,0.2836,1,15,9,90,10,105
7907,2011-12-01,4,0,12,2,0,4,1,1,0.26,0.2273,0.56,0.2985,1,15,8,80,9,95
7908,2011-12-01,4,0,12,3,0,4,1,1,0.26,0.2424,0.56,0.2537,1,15,6,60,7,75
7909,2011-12-01,4,0,12,4,0,4,1,1,0.26,0.2424,0.56,0.2836,0,0,1,10,1,10
7910,2011-12-01,4,0,12,5,0,4,1,1,0.26,0.2424,0.56,0.2537,1,15,23,230,24,245
7911,2011-12-01,4,0,12,6,0,4,1,1,0.24,0.2121,0.65,0.2836,5,75,92,920,97,995
7912,2011-12-01,4,0,12,7,0,4,1,1,0.24,0.2121,0.65,0.3582,11,165,265,2650,276,2815
7913,2011-12-01,4,0,12,8,0,4,1,1,0.26,0.2273,0.6,0.3284,15,225,462,4620,477,4845
7914,2011-12-01,4,0,12,9,0,4,1,1,0.3,0.2727,0.52,0.3284,9,135,215,2150,224,2285
7915,2011-12-01,4,0,12,10,0,4,1,1,0.32,0.303,0.53,0.2985,7,105,86,860,93,965
7916,2011-12-01,4,0,12,11,0,4,1,1,0.34,0.3182,0.49,0.2537,7,105,95,950,102,1055
7917,2011-12-01,4,0,12,12,0,4,1,1,0.36,0.3485,0.46,0.2239,9,135,139,1390,148,1525
7918,2011-12-01,4,0,12,13,0,4,1,1,0.4,0.4091,0.4,0.2239,17,255,137,1370,154,1625
7919,2011-12-01,4,0,12,14,0,4,1,1,0.4,0.4091,0.4,0.2239,20,300,130,1300,150,1600
7920,2011-12-01,4,0,12,15,0,4,1,1,0.4,0.4091,0.4,0.2239,10,150,144,1440,154,1590
7921,2011-12-01,4,0,12,16,0,4,1,1,0.4,0.4091,0.4,0.194,9,135,192,1920,201,2055
7922,2011-12-01,4,0,12,17,0,4,1,1,0.36,0.3485,0.46,0.1343,9,135,409,4090,418,4225
7923,2011-12-01,4,0,12,18,0,4,1,1,0.36,0.3636,0.43,0.1045,12,180,393,3930,405,4110
7924,2011-12-01,4,0,12,19,0,4,1,1,0.34,0.3485,0.46,0.1045,9,135,219,2190,228,2325
7925,2011-12-01,4,0,12,20,0,4,1,1,0.34,0.3485,0.46,0.1045,12,180,178,1780,190,1960
7926,2011-12-01,4,0,12,21,0,4,1,1,0.3,0.3182,0.61,0.1045,8,120,154,1540,162,1660
7927,2011-12-01,4,0,12,22,0,4,1,1,0.3,0.3333,0.61,0.0,5,75,99,990,104,1065
7928,2011-12-01,4,0,12,23,0,4,1,1,0.26,0.2879,0.7,0.0896,3,45,70,700,73,745
7929,2011-12-02,4,0,12,0,0,5,1,1,0.26,0.2879,0.7,0.0896,6,90,32,320,38,410
7930,2011-12-02,4,0,12,1,0,5,1,1,0.24,0.2879,0.75,0.0,1,15,14,140,15,155
7931,2011-12-02,4,0,12,2,0,5,1,1,0.24,0.2879,0.75,0.0,0,0,10,100,10,100
7932,2011-12-02,4,0,12,3,0,5,1,1,0.22,0.2727,0.8,0.0,0,0,1,10,1,10
7933,2011-12-02,4,0,12,4,0,5,1,1,0.22,0.2727,0.8,0.0,0,0,3,30,3,30
7934,2011-12-02,4,0,12,5,0,5,1,1,0.22,0.2576,0.8,0.0896,0,0,23,230,23,230
7935,2011-12-02,4,0,12,6,0,5,1,1,0.22,0.2727,0.8,0.0,3,45,84,840,87,885
7936,2011-12-02,4,0,12,7,0,5,1,1,0.22,0.2576,0.87,0.0896,6,90,199,1990,205,2080
7937,2011-12-02,4,0,12,8,0,5,1,1,0.24,0.2879,0.87,0.0,13,195,432,4320,445,4515
7938,2011-12-02,4,0,12,9,0,5,1,1,0.28,0.3182,0.81,0.0,12,180,234,2340,246,2520
7939,2011-12-02,4,0,12,10,0,5,1,1,0.3,0.2879,0.75,0.2239,16,240,89,890,105,1130
7940,2011-12-02,4,0,12,11,0,5,1,1,0.34,0.3333,0.66,0.1642,18,270,142,1420,160,1690
7941,2011-12-02,4,0,12,12,0,5,1,1,0.36,0.3485,0.57,0.1343,18,270,186,1860,204,2130
7942,2011-12-02,4,0,12,13,0,5,1,1,0.4,0.4091,0.47,0.1343,19,285,188,1880,207,2165
7943,2011-12-02,4,0,12,14,0,5,1,1,0.42,0.4242,0.44,0.1045,25,375,145,1450,170,1825
7944,2011-12-02,4,0,12,15,0,5,1,1,0.42,0.4242,0.41,0.0896,24,360,175,1750,199,2110
7945,2011-12-02,4,0,12,16,0,5,1,1,0.42,0.4242,0.41,0.0896,22,330,254,2540,276,2870
7946,2011-12-02,4,0,12,17,0,5,1,1,0.42,0.4242,0.38,0.0,20,300,391,3910,411,4210
7947,2011-12-02,4,0,12,18,0,5,1,1,0.4,0.4091,0.5,0.0,10,150,362,3620,372,3770
7948,2011-12-02,4,0,12,19,0,5,1,1,0.34,0.3182,0.53,0.2537,13,195,252,2520,265,2715
7949,2011-12-02,4,0,12,20,0,5,1,1,0.38,0.3939,0.4,0.2836,12,180,178,1780,190,1960
7950,2011-12-02,4,0,12,21,0,5,1,1,0.34,0.3333,0.49,0.194,9,135,102,1020,111,1155
7951,2011-12-02,4,0,12,22,0,5,1,1,0.32,0.3182,0.53,0.194,7,105,95,950,102,1055
7952,2011-12-02,4,0,12,23,0,5,1,1,0.32,0.303,0.53,0.2836,14,210,81,810,95,1020
7953,2011-12-03,4,0,12,0,0,6,0,1,0.3,0.2879,0.56,0.2537,10,150,65,650,75,800
7954,2011-12-03,4,0,12,1,0,6,0,1,0.26,0.2576,0.65,0.194,9,135,62,620,71,755
7955,2011-12-03,4,0,12,2,0,6,0,1,0.26,0.2576,0.65,0.1642,9,135,41,410,50,545
7956,2011-12-03,4,0,12,3,0,6,0,1,0.24,0.2424,0.7,0.1343,4,60,5,50,9,110
7957,2011-12-03,4,0,12,4,0,6,0,1,0.22,0.2273,0.75,0.1343,1,15,7,70,8,85
7958,2011-12-03,4,0,12,5,0,6,0,1,0.24,0.2576,0.7,0.0896,0,0,6,60,6,60
7959,2011-12-03,4,0,12,6,0,6,0,1,0.24,0.2576,0.65,0.1045,1,15,10,100,11,115
7960,2011-12-03,4,0,12,7,0,6,0,1,0.22,0.2576,0.75,0.0896,2,30,24,240,26,270
7961,2011-12-03,4,0,12,8,0,6,0,1,0.24,0.2576,0.75,0.0896,1,15,62,620,63,635
7962,2011-12-03,4,0,12,9,0,6,0,1,0.26,0.2727,0.7,0.1045,25,375,99,990,124,1365
7963,2011-12-03,4,0,12,10,0,6,0,1,0.32,0.3333,0.61,0.1343,22,330,173,1730,195,2060
7964,2011-12-03,4,0,12,11,0,6,0,1,0.32,0.3333,0.57,0.0896,48,720,227,2270,275,2990
7965,2011-12-03,4,0,12,12,0,6,0,1,0.36,0.3788,0.5,0.0,78,1170,280,2800,358,3970
7966,2011-12-03,4,0,12,13,0,6,0,1,0.36,0.3636,0.5,0.0896,70,1050,222,2220,292,3270
7967,2011-12-03,4,0,12,14,0,6,0,1,0.36,0.3788,0.46,0.0,92,1380,251,2510,343,3890
7968,2011-12-03,4,0,12,15,0,6,0,1,0.38,0.3939,0.46,0.0,100,1500,237,2370,337,3870
7969,2011-12-03,4,0,12,16,0,6,0,1,0.38,0.3939,0.46,0.0,75,1125,230,2300,305,3425
7970,2011-12-03,4,0,12,17,0,6,0,1,0.36,0.3788,0.62,0.0,46,690,186,1860,232,2550
7971,2011-12-03,4,0,12,18,0,6,0,1,0.34,0.3333,0.53,0.1343,31,465,193,1930,224,2395
7972,2011-12-03,4,0,12,19,0,6,0,1,0.3,0.3182,0.61,0.0896,31,465,144,1440,175,1905
7973,2011-12-03,4,0,12,20,0,6,0,1,0.3,0.3182,0.61,0.0896,17,255,110,1100,127,1355
7974,2011-12-03,4,0,12,21,0,6,0,2,0.3,0.3182,0.61,0.0896,5,75,104,1040,109,1115
7975,2011-12-03,4,0,12,22,0,6,0,2,0.32,0.3333,0.61,0.0896,17,255,97,970,114,1225
7976,2011-12-03,4,0,12,23,0,6,0,1,0.3,0.303,0.7,0.1343,12,180,73,730,85,910
7977,2011-12-04,4,0,12,0,0,0,0,1,0.3,0.3182,0.7,0.1045,19,285,64,640,83,925
7978,2011-12-04,4,0,12,1,0,0,0,1,0.3,0.3182,0.75,0.0896,20,300,54,540,74,840
7979,2011-12-04,4,0,12,2,0,0,0,1,0.26,0.303,0.81,0.0,11,165,51,510,62,675
7980,2011-12-04,4,0,12,3,0,0,0,1,0.28,0.3182,0.75,0.0,7,105,34,340,41,445
7981,2011-12-04,4,0,12,4,0,0,0,1,0.26,0.303,0.87,0.0,2,30,9,90,11,120
7982,2011-12-04,4,0,12,5,0,0,0,1,0.26,0.303,0.81,0.0,2,30,2,20,4,50
7983,2011-12-04,4,0,12,6,0,0,0,1,0.24,0.2879,0.93,0.0,1,15,3,30,4,45
7984,2011-12-04,4,0,12,7,0,0,0,1,0.26,0.303,0.87,0.0,3,45,23,230,26,275
7985,2011-12-04,4,0,12,8,0,0,0,1,0.26,0.303,0.87,0.0,7,105,48,480,55,585
7986,2011-12-04,4,0,12,9,0,0,0,1,0.3,0.3333,0.81,0.0,12,180,114,1140,126,1320
7987,2011-12-04,4,0,12,10,0,0,0,1,0.32,0.3333,0.81,0.1343,36,540,180,1800,216,2340
7988,2011-12-04,4,0,12,11,0,0,0,1,0.34,0.3333,0.81,0.1642,48,720,206,2060,254,2780
7989,2011-12-04,4,0,12,12,0,0,0,1,0.36,0.3485,0.81,0.1642,82,1230,247,2470,329,3700
7990,2011-12-04,4,0,12,13,0,0,0,1,0.4,0.4091,0.66,0.2239,88,1320,269,2690,357,4010
7991,2011-12-04,4,0,12,14,0,0,0,1,0.42,0.4242,0.62,0.1343,77,1155,246,2460,323,3615
7992,2011-12-04,4,0,12,15,0,0,0,1,0.42,0.4242,0.62,0.194,69,1035,227,2270,296,3305
7993,2011-12-04,4,0,12,16,0,0,0,1,0.42,0.4242,0.58,0.2239,64,960,266,2660,330,3620
7994,2011-12-04,4,0,12,17,0,0,0,1,0.38,0.3939,0.76,0.1343,38,570,207,2070,245,2640
7995,2011-12-04,4,0,12,18,0,0,0,1,0.38,0.3939,0.71,0.0,10,150,161,1610,171,1760
7996,2011-12-04,4,0,12,19,0,0,0,1,0.38,0.3939,0.76,0.0,15,225,158,1580,173,1805
7997,2011-12-04,4,0,12,20,0,0,0,1,0.36,0.3485,0.76,0.1343,8,120,116,1160,124,1280
7998,2011-12-04,4,0,12,21,0,0,0,1,0.36,0.3636,0.81,0.1045,7,105,65,650,72,755
7999,2011-12-04,4,0,12,22,0,0,0,1,0.34,0.3485,0.87,0.1045,5,75,59,590,64,665
8000,2011-12-04,4,0,12,23,0,0,0,1,0.34,0.3485,0.87,0.1045,3,45,42,420,45,465
8001,2011-12-05,4,0,12,0,0,1,1,1,0.32,0.3333,0.87,0.0896,3,45,21,210,24,255
8002,2011-12-05,4,0,12,1,0,1,1,1,0.32,0.3485,0.87,0.0,2,30,10,100,12,130
8003,2011-12-05,4,0,12,2,0,1,1,1,0.32,0.3485,0.87,0.0,0,0,8,80,8,80
8004,2011-12-05,4,0,12,3,0,1,1,1,0.32,0.3485,0.87,0.0,0,0,2,20,2,20
8005,2011-12-05,4,0,12,4,0,1,1,1,0.3,0.3182,0.87,0.1045,0,0,7,70,7,70
8006,2011-12-05,4,0,12,5,0,1,1,1,0.3,0.3182,0.87,0.1045,1,15,24,240,25,255
8007,2011-12-05,4,0,12,6,0,1,1,1,0.3,0.3182,0.93,0.0896,1,15,89,890,90,905
8008,2011-12-05,4,0,12,7,0,1,1,1,0.32,0.3485,0.9,0.0,9,135,274,2740,283,2875
8009,2011-12-05,4,0,12,8,0,1,1,1,0.32,0.3485,0.93,0.0,12,180,392,3920,404,4100
8010,2011-12-05,4,0,12,9,0,1,1,2,0.36,0.3636,0.87,0.0896,12,180,178,1780,190,1960
8011,2011-12-05,4,0,12,10,0,1,1,2,0.36,0.3636,0.87,0.0896,9,135,78,780,87,915
8012,2011-12-05,4,0,12,11,0,1,1,2,0.36,0.3636,0.87,0.0896,17,255,106,1060,123,1315
8013,2011-12-05,4,0,12,12,0,1,1,2,0.4,0.4091,0.76,0.1045,29,435,125,1250,154,1685
8014,2011-12-05,4,0,12,13,0,1,1,2,0.42,0.4242,0.71,0.0896,18,270,153,1530,171,1800
8015,2011-12-05,4,0,12,14,0,1,1,2,0.46,0.4545,0.67,0.0,7,105,126,1260,133,1365
8016,2011-12-05,4,0,12,15,0,1,1,2,0.46,0.4545,0.72,0.0896,16,240,132,1320,148,1560
8017,2011-12-05,4,0,12,16,0,1,1,1,0.5,0.4848,0.63,0.0896,10,150,238,2380,248,2530
8018,2011-12-05,4,0,12,17,0,1,1,1,0.42,0.4242,0.77,0.0,16,240,430,4300,446,4540
8019,2011-12-05,4,0,12,18,0,1,1,1,0.44,0.4394,0.77,0.0,13,195,386,3860,399,4055
8020,2011-12-05,4,0,12,19,0,1,1,2,0.46,0.4545,0.77,0.0,13,195,295,2950,308,3145
8021,2011-12-05,4,0,12,20,0,1,1,2,0.46,0.4545,0.82,0.1045,15,225,190,1900,205,2125
8022,2011-12-05,4,0,12,21,0,1,1,2,0.44,0.4394,0.88,0.0896,10,150,166,1660,176,1810
8023,2011-12-05,4,0,12,22,0,1,1,2,0.44,0.4394,0.88,0.1343,12,180,94,940,106,1120
8024,2011-12-05,4,0,12,23,0,1,1,2,0.46,0.4545,0.88,0.1343,8,120,54,540,62,660
8025,2011-12-06,4,0,12,0,0,2,1,2,0.5,0.4848,0.77,0.2985,3,45,25,250,28,295
8026,2011-12-06,4,0,12,1,0,2,1,2,0.46,0.4545,0.88,0.2985,2,30,14,140,16,170
8027,2011-12-06,4,0,12,2,0,2,1,2,0.46,0.4545,0.87,0.194,0,0,3,30,3,30
8028,2011-12-06,4,0,12,3,0,2,1,2,0.46,0.4545,0.87,0.194,0,0,3,30,3,30
8029,2011-12-06,4,0,12,4,0,2,1,3,0.46,0.4545,0.88,0.2239,0,0,7,70,7,70
8030,2011-12-06,4,0,12,5,0,2,1,3,0.46,0.4545,0.88,0.2239,0,0,20,200,20,200
8031,2011-12-06,4,0,12,6,0,2,1,2,0.44,0.4394,0.94,0.2836,5,75,81,810,86,885
8032,2011-12-06,4,0,12,7,0,2,1,2,0.46,0.4545,0.94,0.194,7,105,227,2270,234,2375
8033,2011-12-06,4,0,12,8,0,2,1,2,0.46,0.4545,0.94,0.194,13,195,401,4010,414,4205
8034,2011-12-06,4,0,12,9,0,2,1,2,0.46,0.4545,0.94,0.2239,4,60,200,2000,204,2060
8035,2011-12-06,4,0,12,10,0,2,1,3,0.46,0.4545,0.94,0.2836,6,90,44,440,50,530
8036,2011-12-06,4,0,12,11,0,2,1,3,0.46,0.4545,0.94,0.2537,4,60,28,280,32,340
8037,2011-12-06,4,0,12,12,0,2,1,3,0.46,0.4545,1.0,0.2239,5,75,50,500,55,575
8038,2011-12-06,4,0,12,13,0,2,1,3,0.46,0.4545,1.0,0.194,6,90,65,650,71,740
8039,2011-12-06,4,0,12,14,0,2,1,3,0.48,0.4697,1.0,0.2239,6,90,69,690,75,780
8040,2011-12-06,4,0,12,15,0,2,1,3,0.5,0.4848,1.0,0.194,2,30,43,430,45,460
8041,2011-12-06,4,0,12,16,0,2,1,3,0.46,0.4545,1.0,0.2537,4,60,84,840,88,900
8042,2011-12-06,4,0,12,17,0,2,1,2,0.46,0.4545,1.0,0.2239,13,195,249,2490,262,2685
8043,2011-12-06,4,0,12,18,0,2,1,2,0.46,0.4545,1.0,0.2836,17,255,287,2870,304,3125
8044,2011-12-06,4,0,12,19,0,2,1,3,0.46,0.4545,1.0,0.2985,10,150,223,2230,233,2380
8045,2011-12-06,4,0,12,20,0,2,1,3,0.46,0.4545,1.0,0.2985,3,45,107,1070,110,1115
8046,2011-12-06,4,0,12,21,0,2,1,2,0.44,0.4394,1.0,0.194,6,90,108,1080,114,1170
8047,2011-12-06,4,0,12,22,0,2,1,3,0.46,0.4545,1.0,0.1642,5,75,82,820,87,895
8048,2011-12-06,4,0,12,23,0,2,1,3,0.46,0.4545,1.0,0.1642,5,75,48,480,53,555
8049,2011-12-07,4,0,12,0,0,3,1,1,0.44,0.4394,1.0,0.194,3,45,30,300,33,345
8050,2011-12-07,4,0,12,1,0,3,1,2,0.46,0.4545,1.0,0.2537,4,60,9,90,13,150
8051,2011-12-07,4,0,12,2,0,3,1,3,0.46,0.4545,1.0,0.2239,2,30,4,40,6,70
8052,2011-12-07,4,0,12,3,0,3,1,3,0.46,0.4545,1.0,0.2239,0,0,3,30,3,30
8053,2011-12-07,4,0,12,4,0,3,1,3,0.46,0.4545,1.0,0.1642,0,0,1,10,1,10
8054,2011-12-07,4,0,12,5,0,3,1,3,0.46,0.4545,1.0,0.1642,0,0,3,30,3,30
8055,2011-12-07,4,0,12,6,0,3,1,3,0.48,0.4697,1.0,0.4179,0,0,18,180,18,180
8056,2011-12-07,4,0,12,7,0,3,1,3,0.44,0.4394,1.0,0.1045,3,45,43,430,46,475
8057,2011-12-07,4,0,12,8,0,3,1,3,0.44,0.4394,1.0,0.0,6,90,80,800,86,890
8058,2011-12-07,4,0,12,9,0,3,1,3,0.44,0.4394,1.0,0.2537,0,0,64,640,64,640
8059,2011-12-07,4,0,12,10,0,3,1,3,0.44,0.4394,1.0,0.0896,1,15,32,320,33,335
8060,2011-12-07,4,0,12,11,0,3,1,3,0.44,0.4394,1.0,0.0896,3,45,47,470,50,515
8061,2011-12-07,4,0,12,12,0,3,1,3,0.44,0.4394,1.0,0.1343,4,60,29,290,33,350
8062,2011-12-07,4,0,12,13,0,3,1,3,0.44,0.4394,1.0,0.194,5,75,28,280,33,355
8063,2011-12-07,4,0,12,14,0,3,1,3,0.44,0.4394,1.0,0.194,1,15,24,240,25,255
8064,2011-12-07,4,0,12,15,0,3,1,3,0.42,0.4242,0.94,0.2239,5,75,25,250,30,325
8065,2011-12-07,4,0,12,16,0,3,1,3,0.42,0.4242,0.94,0.194,3,45,28,280,31,325
8066,2011-12-07,4,0,12,17,0,3,1,3,0.4,0.4091,1.0,0.3284,4,60,48,480,52,540
8067,2011-12-07,4,0,12,18,0,3,1,3,0.4,0.4091,0.94,0.2985,3,45,48,480,51,525
8068,2011-12-07,4,0,12,19,0,3,1,3,0.34,0.2879,0.87,0.6418,2,30,31,310,33,340
8069,2011-12-07,4,0,12,20,0,3,1,3,0.34,0.2879,0.87,0.6418,1,15,25,250,26,265
8070,2011-12-07,4,0,12,21,0,3,1,3,0.3,0.2576,0.87,0.5224,0,0,6,60,6,60
8071,2011-12-07,4,0,12,22,0,3,1,3,0.24,0.197,0.93,0.4478,0,0,13,130,13,130
8072,2011-12-07,4,0,12,23,0,3,1,1,0.24,0.2121,0.93,0.3881,0,0,16,160,16,160
8073,2011-12-08,4,0,12,0,0,4,1,2,0.26,0.2273,0.87,0.2985,0,0,21,210,21,210
8074,2011-12-08,4,0,12,1,0,4,1,1,0.26,0.2273,0.81,0.3582,1,15,6,60,7,75
8075,2011-12-08,4,0,12,2,0,4,1,1,0.28,0.2727,0.65,0.2239,0,0,4,40,4,40
8076,2011-12-08,4,0,12,3,0,4,1,1,0.26,0.2273,0.6,0.2985,0,0,1,10,1,10
8077,2011-12-08,4,0,12,4,0,4,1,2,0.24,0.197,0.6,0.4627,0,0,2,20,2,20
8078,2011-12-08,4,0,12,5,0,4,1,1,0.22,0.2121,0.64,0.2239,0,0,12,120,12,120
8079,2011-12-08,4,0,12,6,0,4,1,1,0.22,0.2121,0.55,0.2836,0,0,71,710,71,710
8080,2011-12-08,4,0,12,7,0,4,1,1,0.22,0.2121,0.6,0.2239,11,165,233,2330,244,2495
8081,2011-12-08,4,0,12,8,0,4,1,1,0.22,0.2121,0.55,0.2836,11,165,418,4180,429,4345
8082,2011-12-08,4,0,12,9,0,4,1,1,0.24,0.2121,0.52,0.3881,7,105,218,2180,225,2285
8083,2011-12-08,4,0,12,10,0,4,1,1,0.26,0.2273,0.52,0.3284,1,15,109,1090,110,1105
8084,2011-12-08,4,0,12,11,0,4,1,1,0.28,0.2727,0.52,0.2537,6,90,100,1000,106,1090
8085,2011-12-08,4,0,12,12,0,4,1,1,0.28,0.2576,0.52,0.3284,8,120,148,1480,156,1600
8086,2011-12-08,4,0,12,13,0,4,1,1,0.3,0.2727,0.49,0.3582,9,135,115,1150,124,1285
8087,2011-12-08,4,0,12,14,0,4,1,1,0.32,0.303,0.45,0.2537,16,240,121,1210,137,1450
8088,2011-12-08,4,0,12,15,0,4,1,1,0.32,0.3333,0.45,0.1343,19,285,98,980,117,1265
8089,2011-12-08,4,0,12,16,0,4,1,1,0.32,0.3182,0.45,0.194,7,105,201,2010,208,2115
8090,2011-12-08,4,0,12,17,0,4,1,1,0.3,0.3182,0.49,0.1045,10,150,321,3210,331,3360
8091,2011-12-08,4,0,12,18,0,4,1,1,0.28,0.2727,0.52,0.2239,12,180,306,3060,318,3240
8092,2011-12-08,4,0,12,19,0,4,1,1,0.26,0.2727,0.56,0.1045,12,180,220,2200,232,2380
8093,2011-12-08,4,0,12,20,0,4,1,1,0.26,0.2727,0.6,0.1045,5,75,170,1700,175,1775
8094,2011-12-08,4,0,12,21,0,4,1,1,0.28,0.303,0.61,0.0896,4,60,135,1350,139,1410
8095,2011-12-08,4,0,12,22,0,4,1,1,0.26,0.2727,0.65,0.1343,8,120,84,840,92,960
8096,2011-12-08,4,0,12,23,0,4,1,1,0.24,0.2576,0.7,0.1045,3,45,58,580,61,625
8097,2011-12-09,4,0,12,0,0,5,1,1,0.24,0.2879,0.65,0.0,8,120,26,260,34,380
8098,2011-12-09,4,0,12,1,0,5,1,1,0.24,0.2879,0.65,0.0,2,30,12,120,14,150
8099,2011-12-09,4,0,12,2,0,5,1,1,0.24,0.2879,0.7,0.0,2,30,10,100,12,130
8100,2011-12-09,4,0,12,3,0,5,1,1,0.22,0.2727,0.8,0.0,1,15,5,50,6,65
8101,2011-12-09,4,0,12,4,0,5,1,1,0.22,0.2727,0.8,0.0,1,15,1,10,2,25
8102,2011-12-09,4,0,12,5,0,5,1,1,0.22,0.2727,0.8,0.0,0,0,20,200,20,200
8103,2011-12-09,4,0,12,6,0,5,1,1,0.22,0.2576,0.8,0.0896,1,15,62,620,63,635
8104,2011-12-09,4,0,12,7,0,5,1,1,0.22,0.2576,0.75,0.0896,4,60,195,1950,199,2010
8105,2011-12-09,4,0,12,8,0,5,1,1,0.24,0.2879,0.81,0.0,7,105,378,3780,385,3885
8106,2011-12-09,4,0,12,9,0,5,1,1,0.26,0.2879,0.81,0.0896,8,120,256,2560,264,2680
8107,2011-12-09,4,0,12,10,0,5,1,2,0.3,0.303,0.7,0.1642,11,165,115,1150,126,1315
8108,2011-12-09,4,0,12,11,0,5,1,1,0.32,0.303,0.7,0.2537,15,225,121,1210,136,1435
8109,2011-12-09,4,0,12,12,0,5,1,1,0.36,0.3333,0.57,0.2985,27,405,146,1460,173,1865
8110,2011-12-09,4,0,12,13,0,5,1,1,0.38,0.3939,0.5,0.194,27,405,141,1410,168,1815
8111,2011-12-09,4,0,12,14,0,5,1,1,0.38,0.3939,0.46,0.2836,24,360,163,1630,187,1990
8112,2011-12-09,4,0,12,15,0,5,1,1,0.38,0.3939,0.46,0.2836,29,435,160,1600,189,2035
8113,2011-12-09,4,0,12,16,0,5,1,1,0.36,0.3485,0.62,0.1343,24,360,226,2260,250,2620
8114,2011-12-09,4,0,12,17,0,5,1,1,0.34,0.3485,0.66,0.1045,10,150,352,3520,362,3670
8115,2011-12-09,4,0,12,18,0,5,1,1,0.34,0.3636,0.61,0.0,10,150,308,3080,318,3230
8116,2011-12-09,4,0,12,19,0,5,1,1,0.34,0.3636,0.61,0.0,10,150,189,1890,199,2040
8117,2011-12-09,4,0,12,20,0,5,1,1,0.3,0.3333,0.81,0.0,10,150,140,1400,150,1550
8118,2011-12-09,4,0,12,21,0,5,1,1,0.3,0.3333,0.75,0.0,9,135,131,1310,140,1445
8119,2011-12-09,4,0,12,22,0,5,1,1,0.28,0.3182,0.87,0.0,15,225,114,1140,129,1365
8120,2011-12-09,4,0,12,23,0,5,1,1,0.28,0.3182,0.81,0.0,6,90,88,880,94,970
8121,2011-12-10,4,0,12,0,0,6,0,2,0.26,0.2727,0.81,0.1045,11,165,66,660,77,825
8122,2011-12-10,4,0,12,1,0,6,0,2,0.26,0.2576,0.7,0.1642,11,165,55,550,66,715
8123,2011-12-10,4,0,12,2,0,6,0,2,0.28,0.303,0.61,0.0896,12,180,48,480,60,660
8124,2011-12-10,4,0,12,3,0,6,0,2,0.28,0.303,0.61,0.0896,5,75,20,200,25,275
8125,2011-12-10,4,0,12,4,0,6,0,2,0.26,0.2727,0.65,0.1045,0,0,3,30,3,30
8126,2011-12-10,4,0,12,5,0,6,0,1,0.26,0.2576,0.6,0.1642,0,0,6,60,6,60
8127,2011-12-10,4,0,12,6,0,6,0,1,0.24,0.2576,0.65,0.1045,1,15,10,100,11,115
8128,2011-12-10,4,0,12,7,0,6,0,1,0.24,0.2273,0.65,0.194,0,0,11,110,11,110
8129,2011-12-10,4,0,12,8,0,6,0,1,0.26,0.2727,0.65,0.1343,5,75,68,680,73,755
8130,2011-12-10,4,0,12,9,0,6,0,1,0.28,0.2576,0.61,0.2836,15,225,134,1340,149,1565
8131,2011-12-10,4,0,12,10,0,6,0,1,0.32,0.303,0.57,0.2537,31,465,161,1610,192,2075
8132,2011-12-10,4,0,12,11,0,6,0,1,0.32,0.2879,0.53,0.4179,44,660,192,1920,236,2580
8133,2011-12-10,4,0,12,12,0,6,0,1,0.32,0.2879,0.45,0.4179,48,720,235,2350,283,3070
8134,2011-12-10,4,0,12,13,0,6,0,1,0.34,0.303,0.34,0.4179,47,705,239,2390,286,3095
8135,2011-12-10,4,0,12,14,0,6,0,1,0.34,0.303,0.31,0.3284,51,765,242,2420,293,3185
8136,2011-12-10,4,0,12,15,0,6,0,1,0.34,0.303,0.34,0.3582,60,900,239,2390,299,3290
8137,2011-12-10,4,0,12,16,0,6,0,1,0.32,0.2879,0.31,0.3881,58,870,183,1830,241,2700
8138,2011-12-10,4,0,12,17,0,6,0,1,0.28,0.2576,0.36,0.3284,34,510,151,1510,185,2020
8139,2011-12-10,4,0,12,18,0,6,0,1,0.26,0.2576,0.38,0.2239,28,420,144,1440,172,1860
8140,2011-12-10,4,0,12,19,0,6,0,1,0.26,0.2424,0.38,0.2836,15,225,139,1390,154,1615
8141,2011-12-10,4,0,12,20,0,6,0,1,0.24,0.2273,0.35,0.2239,10,150,114,1140,124,1290
8142,2011-12-10,4,0,12,21,0,6,0,1,0.22,0.2121,0.44,0.2239,4,60,79,790,83,850
8143,2011-12-10,4,0,12,22,0,6,0,1,0.22,0.2273,0.41,0.1343,7,105,88,880,95,985
8144,2011-12-10,4,0,12,23,0,6,0,1,0.2,0.2121,0.47,0.1642,5,75,61,610,66,685
8145,2011-12-11,4,0,12,0,0,0,0,1,0.2,0.197,0.51,0.2239,5,75,69,690,74,765
8146,2011-12-11,4,0,12,1,0,0,0,1,0.16,0.1515,0.59,0.2239,8,120,54,540,62,660
8147,2011-12-11,4,0,12,2,0,0,0,1,0.18,0.1667,0.55,0.2537,5,75,47,470,52,545
8148,2011-12-11,4,0,12,3,0,0,0,1,0.16,0.1818,0.59,0.1343,2,30,17,170,19,200
8149,2011-12-11,4,0,12,4,0,0,0,1,0.16,0.1667,0.59,0.1642,0,0,5,50,5,50
8150,2011-12-11,4,0,12,5,0,0,0,1,0.18,0.2121,0.59,0.1045,0,0,6,60,6,60
8151,2011-12-11,4,0,12,6,0,0,0,1,0.16,0.2273,0.59,0.0,0,0,10,100,10,100
8152,2011-12-11,4,0,12,7,0,0,0,1,0.18,0.2424,0.55,0.0,1,15,30,300,31,315
8153,2011-12-11,4,0,12,8,0,0,0,1,0.16,0.2273,0.69,0.0,4,60,68,680,72,740
8154,2011-12-11,4,0,12,9,0,0,0,1,0.2,0.2576,0.59,0.0,19,285,88,880,107,1165
8155,2011-12-11,4,0,12,10,0,0,0,1,0.24,0.2879,0.44,0.0,30,450,164,1640,194,2090
8156,2011-12-11,4,0,12,11,0,0,0,1,0.26,0.303,0.35,0.0,31,465,166,1660,197,2125
8157,2011-12-11,4,0,12,12,0,0,0,1,0.26,0.303,0.35,0.0,42,630,246,2460,288,3090
8158,2011-12-11,4,0,12,13,0,0,0,1,0.3,0.3333,0.31,0.0,44,660,224,2240,268,2900
8159,2011-12-11,4,0,12,14,0,0,0,1,0.3,0.3333,0.28,0.0,44,660,198,1980,242,2640
8160,2011-12-11,4,0,12,15,0,0,0,1,0.3,0.3333,0.26,0.0,47,705,219,2190,266,2895
8161,2011-12-11,4,0,12,16,0,0,0,1,0.3,0.3333,0.26,0.0,32,480,174,1740,206,2220
8162,2011-12-11,4,0,12,17,0,0,0,1,0.28,0.3182,0.3,0.0,13,195,150,1500,163,1695
8163,2011-12-11,4,0,12,18,0,0,0,1,0.24,0.2273,0.48,0.194,12,180,151,1510,163,1690
8164,2011-12-11,4,0,12,19,0,0,0,1,0.22,0.2273,0.55,0.194,7,105,98,980,105,1085
8165,2011-12-11,4,0,12,20,0,0,0,1,0.22,0.2424,0.55,0.1045,10,150,62,620,72,770
8166,2011-12-11,4,0,12,21,0,0,0,1,0.22,0.2727,0.55,0.0,10,150,53,530,63,680
8167,2011-12-11,4,0,12,22,0,0,0,1,0.22,0.2727,0.55,0.0,7,105,36,360,43,465
8168,2011-12-11,4,0,12,23,0,0,0,1,0.2,0.2576,0.69,0.0,4,60,31,310,35,370
8169,2011-12-12,4,0,12,0,0,1,1,1,0.2,0.2273,0.69,0.0896,4,60,16,160,20,220
8170,2011-12-12,4,0,12,1,0,1,1,1,0.2,0.2576,0.69,0.0,0,0,9,90,9,90
8171,2011-12-12,4,0,12,2,0,1,1,1,0.2,0.2576,0.69,0.0,0,0,4,40,4,40
8172,2011-12-12,4,0,12,3,0,1,1,1,0.18,0.2424,0.74,0.0,0,0,2,20,2,20
8173,2011-12-12,4,0,12,4,0,1,1,1,0.18,0.2424,0.74,0.0,0,0,3,30,3,30
8174,2011-12-12,4,0,12,5,0,1,1,1,0.16,0.2273,0.8,0.0,0,0,21,210,21,210
8175,2011-12-12,4,0,12,6,0,1,1,1,0.16,0.1818,0.8,0.1045,1,15,63,630,64,645
8176,2011-12-12,4,0,12,7,0,1,1,1,0.14,0.1515,0.86,0.1343,4,60,231,2310,235,2370
8177,2011-12-12,4,0,12,8,0,1,1,2,0.16,0.1818,0.8,0.1045,7,105,378,3780,385,3885
8178,2011-12-12,4,0,12,9,0,1,1,2,0.18,0.2121,0.74,0.0896,12,180,208,2080,220,2260
8179,2011-12-12,4,0,12,10,0,1,1,2,0.22,0.2424,0.69,0.1045,14,210,91,910,105,1120
8180,2011-12-12,4,0,12,11,0,1,1,2,0.26,0.2879,0.6,0.0896,15,225,100,1000,115,1225
8181,2011-12-12,4,0,12,12,0,1,1,1,0.28,0.2879,0.52,0.1045,7,105,138,1380,145,1485
8182,2011-12-12,4,0,12,13,0,1,1,2,0.3,0.3182,0.52,0.1045,13,195,153,1530,166,1725
8183,2011-12-12,4,0,12,14,0,1,1,2,0.32,0.3333,0.53,0.1343,16,240,95,950,111,1190
8184,2011-12-12,4,0,12,15,0,1,1,2,0.32,0.3333,0.57,0.1045,8,120,124,1240,132,1360
8185,2011-12-12,4,0,12,16,0,1,1,2,0.32,0.3333,0.57,0.0896,5,75,209,2090,214,2165
8186,2011-12-12,4,0,12,17,0,1,1,2,0.3,0.3333,0.56,0.0,7,105,352,3520,359,3625
8187,2011-12-12,4,0,12,18,0,1,1,1,0.3,0.3182,0.56,0.0896,8,120,349,3490,357,3610
8188,2011-12-12,4,0,12,19,0,1,1,1,0.28,0.303,0.61,0.0896,9,135,232,2320,241,2455
8189,2011-12-12,4,0,12,20,0,1,1,1,0.3,0.3182,0.56,0.0896,8,120,157,1570,165,1690
8190,2011-12-12,4,0,12,21,0,1,1,1,0.26,0.303,0.81,0.0,2,30,119,1190,121,1220
8191,2011-12-12,4,0,12,22,0,1,1,1,0.26,0.303,0.7,0.0,0,0,71,710,71,710
8192,2011-12-12,4,0,12,23,0,1,1,1,0.24,0.2879,0.75,0.0,3,45,42,420,45,465
8193,2011-12-13,4,0,12,0,0,2,1,1,0.22,0.2727,0.8,0.0,1,15,16,160,17,175
8194,2011-12-13,4,0,12,1,0,2,1,1,0.2,0.2576,0.8,0.0,0,0,4,40,4,40
8195,2011-12-13,4,0,12,2,0,2,1,1,0.2,0.2576,0.8,0.0,1,15,1,10,2,25
8196,2011-12-13,4,0,12,3,0,2,1,1,0.18,0.2424,0.8,0.0,0,0,3,30,3,30
8197,2011-12-13,4,0,12,4,0,2,1,1,0.2,0.2576,0.8,0.0,0,0,4,40,4,40
8198,2011-12-13,4,0,12,5,0,2,1,1,0.18,0.2424,0.86,0.0,0,0,20,200,20,200
8199,2011-12-13,4,0,12,6,0,2,1,1,0.2,0.2576,0.8,0.0,0,0,92,920,92,920
8200,2011-12-13,4,0,12,7,0,2,1,1,0.16,0.1667,0.8,0.1642,2,30,221,2210,223,2240
8201,2011-12-13,4,0,12,8,0,2,1,1,0.2,0.2273,0.69,0.1045,9,135,391,3910,400,4045
8202,2011-12-13,4,0,12,9,0,2,1,1,0.26,0.2576,0.6,0.1642,10,150,223,2230,233,2380
8203,2011-12-13,4,0,12,10,0,2,1,1,0.3,0.303,0.52,0.1642,3,45,99,990,102,1035
8204,2011-12-13,4,0,12,11,0,2,1,1,0.34,0.3182,0.46,0.2537,9,135,115,1150,124,1285
8205,2011-12-13,4,0,12,12,0,2,1,1,0.36,0.3333,0.43,0.3582,20,300,147,1470,167,1770
8206,2011-12-13,4,0,12,13,0,2,1,1,0.4,0.4091,0.37,0.3284,7,105,120,1200,127,1305
8207,2011-12-13,4,0,12,14,0,2,1,1,0.4,0.4091,0.37,0.2537,18,270,116,1160,134,1430
8208,2011-12-13,4,0,12,15,0,2,1,1,0.4,0.4091,0.35,0.2537,7,105,144,1440,151,1545
8209,2011-12-13,4,0,12,16,0,2,1,1,0.38,0.3939,0.37,0.2537,13,195,194,1940,207,2135
8210,2011-12-13,4,0,12,17,0,2,1,1,0.36,0.3485,0.4,0.194,17,255,381,3810,398,4065
8211,2011-12-13,4,0,12,18,0,2,1,1,0.34,0.3182,0.42,0.2239,12,180,370,3700,382,3880
8212,2011-12-13,4,0,12,19,0,2,1,1,0.32,0.3182,0.49,0.1642,5,75,262,2620,267,2695
8213,2011-12-13,4,0,12,20,0,2,1,1,0.32,0.3182,0.49,0.1642,7,105,154,1540,161,1645
8214,2011-12-13,4,0,12,21,0,2,1,1,0.3,0.303,0.52,0.1642,5,75,134,1340,139,1415
8215,2011-12-13,4,0,12,22,0,2,1,1,0.3,0.303,0.52,0.1642,5,75,102,1020,107,1095
8216,2011-12-13,4,0,12,23,0,2,1,1,0.26,0.303,0.7,0.0,4,60,55,550,59,610
8217,2011-12-14,4,0,12,0,0,3,1,1,0.26,0.303,0.75,0.0,0,0,22,220,22,220
8218,2011-12-14,4,0,12,1,0,3,1,1,0.26,0.303,0.75,0.0,0,0,8,80,8,80
8219,2011-12-14,4,0,12,2,0,3,1,1,0.26,0.303,0.75,0.0,0,0,2,20,2,20
8220,2011-12-14,4,0,12,3,0,3,1,1,0.28,0.3182,0.65,0.0,0,0,3,30,3,30
8221,2011-12-14,4,0,12,4,0,3,1,1,0.26,0.303,0.75,0.0,0,0,4,40,4,40
8222,2011-12-14,4,0,12,5,0,3,1,2,0.26,0.303,0.81,0.0,0,0,26,260,26,260
8223,2011-12-14,4,0,12,6,0,3,1,2,0.26,0.303,0.87,0.0,0,0,87,870,87,870
8224,2011-12-14,4,0,12,7,0,3,1,1,0.28,0.3182,0.75,0.0,4,60,243,2430,247,2490
8225,2011-12-14,4,0,12,8,0,3,1,2,0.26,0.303,0.87,0.0,9,135,458,4580,467,4715
8226,2011-12-14,4,0,12,9,0,3,1,2,0.3,0.3333,0.61,0.0,9,135,230,2300,239,2435
8227,2011-12-14,4,0,12,10,0,3,1,2,0.32,0.3485,0.57,0.0,9,135,133,1330,142,1465
8228,2011-12-14,4,0,12,11,0,3,1,2,0.34,0.3636,0.55,0.0,12,180,103,1030,115,1210
8229,2011-12-14,4,0,12,12,0,3,1,2,0.36,0.3636,0.57,0.0896,6,90,138,1380,144,1470
8230,2011-12-14,4,0,12,13,0,3,1,2,0.36,0.3636,0.57,0.1045,14,210,119,1190,133,1400
8231,2011-12-14,4,0,12,14,0,3,1,2,0.38,0.3939,0.54,0.0896,17,255,134,1340,151,1595
8232,2011-12-14,4,0,12,15,0,3,1,2,0.38,0.3939,0.54,0.1045,24,360,143,1430,167,1790
8233,2011-12-14,4,0,12,16,0,3,1,2,0.38,0.3939,0.54,0.1045,12,180,233,2330,245,2510
8234,2011-12-14,4,0,12,17,0,3,1,2,0.36,0.3636,0.57,0.1045,19,285,377,3770,396,4055
8235,2011-12-14,4,0,12,18,0,3,1,2,0.36,0.3485,0.62,0.1642,11,165,379,3790,390,3955
8236,2011-12-14,4,0,12,19,0,3,1,2,0.36,0.3636,0.62,0.1045,9,135,259,2590,268,2725
8237,2011-12-14,4,0,12,20,0,3,1,2,0.34,0.3485,0.66,0.1045,6,90,169,1690,175,1780
8238,2011-12-14,4,0,12,21,0,3,1,2,0.34,0.3333,0.66,0.1642,9,135,145,1450,154,1585
8239,2011-12-14,4,0,12,22,0,3,1,1,0.34,0.3333,0.66,0.1642,5,75,99,990,104,1065
8240,2011-12-14,4,0,12,23,0,3,1,1,0.32,0.3182,0.7,0.1642,3,45,48,480,51,525
8241,2011-12-15,4,0,12,0,0,4,1,1,0.32,0.3182,0.7,0.1642,5,75,45,450,50,525
8242,2011-12-15,4,0,12,1,0,4,1,2,0.32,0.3182,0.7,0.1642,5,75,15,150,20,225
8243,2011-12-15,4,0,12,2,0,4,1,2,0.32,0.3333,0.7,0.1343,2,30,5,50,7,80
8244,2011-12-15,4,0,12,3,0,4,1,2,0.32,0.3333,0.7,0.1343,1,15,2,20,3,35
8245,2011-12-15,4,0,12,4,0,4,1,2,0.32,0.303,0.7,0.2239,0,0,6,60,6,60
8246,2011-12-15,4,0,12,5,0,4,1,2,0.32,0.303,0.7,0.2836,0,0,24,240,24,240
8247,2011-12-15,4,0,12,6,0,4,1,1,0.32,0.3182,0.66,0.194,2,30,90,900,92,930
8248,2011-12-15,4,0,12,7,0,4,1,1,0.32,0.3182,0.7,0.194,6,90,252,2520,258,2610
8249,2011-12-15,4,0,12,8,0,4,1,2,0.34,0.3182,0.66,0.2239,8,120,449,4490,457,4610
8250,2011-12-15,4,0,12,9,0,4,1,2,0.36,0.3333,0.62,0.2836,6,90,274,2740,280,2830
8251,2011-12-15,4,0,12,10,0,4,1,2,0.4,0.4091,0.58,0.2985,4,60,105,1050,109,1110
8252,2011-12-15,4,0,12,11,0,4,1,2,0.4,0.4091,0.62,0.4179,9,135,126,1260,135,1395
8253,2011-12-15,4,0,12,12,0,4,1,2,0.46,0.4545,0.59,0.4925,17,255,140,1400,157,1655
8254,2011-12-15,4,0,12,13,0,4,1,2,0.5,0.4848,0.55,0.3582,14,210,150,1500,164,1710
8255,2011-12-15,4,0,12,14,0,4,1,2,0.52,0.5,0.52,0.3284,8,120,124,1240,132,1360
8256,2011-12-15,4,0,12,15,0,4,1,3,0.52,0.5,0.55,0.2239,6,90,76,760,82,850
8257,2011-12-15,4,0,12,16,0,4,1,3,0.46,0.4545,0.72,0.1642,7,105,124,1240,131,1345
8258,2011-12-15,4,0,12,17,0,4,1,2,0.52,0.5,0.59,0.2836,14,210,310,3100,324,3310
8259,2011-12-15,4,0,12,18,0,4,1,2,0.52,0.5,0.59,0.2985,14,210,363,3630,377,3840
8260,2011-12-15,4,0,12,19,0,4,1,2,0.52,0.5,0.59,0.2836,13,195,274,2740,287,2935
8261,2011-12-15,4,0,12,20,0,4,1,1,0.52,0.5,0.59,0.3284,12,180,209,2090,221,2270
8262,2011-12-15,4,0,12,21,0,4,1,1,0.5,0.4848,0.63,0.2985,10,150,145,1450,155,1600
8263,2011-12-15,4,0,12,22,0,4,1,1,0.52,0.5,0.63,0.3284,8,120,116,1160,124,1280
8264,2011-12-15,4,0,12,23,0,4,1,1,0.52,0.5,0.63,0.3284,10,150,104,1040,114,1190
8265,2011-12-16,4,0,12,0,0,5,1,1,0.5,0.4848,0.72,0.3284,12,180,60,600,72,780
8266,2011-12-16,4,0,12,1,0,5,1,1,0.5,0.4848,0.72,0.2239,3,45,28,280,31,325
8267,2011-12-16,4,0,12,2,0,5,1,1,0.48,0.4697,0.77,0.1045,0,0,23,230,23,230
8268,2011-12-16,4,0,12,3,0,5,1,1,0.46,0.4545,0.82,0.1343,2,30,3,30,5,60
8269,2011-12-16,4,0,12,4,0,5,1,2,0.5,0.4848,0.59,0.194,1,15,4,40,5,55
8270,2011-12-16,4,0,12,5,0,5,1,1,0.48,0.4697,0.44,0.3881,0,0,26,260,26,260
8271,2011-12-16,4,0,12,6,0,5,1,2,0.44,0.4394,0.33,0.2985,2,30,80,800,82,830
8272,2011-12-16,4,0,12,7,0,5,1,2,0.38,0.3939,0.46,0.2985,5,75,226,2260,231,2335
8273,2011-12-16,4,0,12,8,0,5,1,1,0.36,0.3333,0.46,0.4179,10,150,449,4490,459,4640
8274,2011-12-16,4,0,12,9,0,5,1,1,0.36,0.3333,0.46,0.3881,8,120,235,2350,243,2470
8275,2011-12-16,4,0,12,10,0,5,1,1,0.34,0.303,0.46,0.2985,10,150,122,1220,132,1370
8276,2011-12-16,4,0,12,11,0,5,1,2,0.34,0.303,0.42,0.2985,9,135,135,1350,144,1485
8277,2011-12-16,4,0,12,12,0,5,1,2,0.34,0.303,0.42,0.3582,10,150,163,1630,173,1780
8278,2011-12-16,4,0,12,13,0,5,1,2,0.34,0.303,0.39,0.3582,12,180,125,1250,137,1430
8279,2011-12-16,4,0,12,14,0,5,1,2,0.34,0.3182,0.42,0.2239,13,195,115,1150,128,1345
8280,2011-12-16,4,0,12,15,0,5,1,2,0.32,0.303,0.45,0.2985,12,180,141,1410,153,1590
8281,2011-12-16,4,0,12,16,0,5,1,2,0.32,0.303,0.45,0.2239,12,180,212,2120,224,2300
8282,2011-12-16,4,0,12,17,0,5,1,2,0.32,0.303,0.45,0.2836,13,195,352,3520,365,3715
8283,2011-12-16,4,0,12,18,0,5,1,2,0.32,0.303,0.45,0.2537,10,150,285,2850,295,3000
8284,2011-12-16,4,0,12,19,0,5,1,2,0.32,0.303,0.45,0.2239,11,165,203,2030,214,2195
8285,2011-12-16,4,0,12,20,0,5,1,2,0.32,0.3182,0.45,0.194,6,90,146,1460,152,1550
8286,2011-12-16,4,0,12,21,0,5,1,2,0.32,0.3182,0.45,0.1642,7,105,95,950,102,1055
8287,2011-12-16,4,0,12,22,0,5,1,2,0.3,0.303,0.49,0.1642,6,90,100,1000,106,1090
8288,2011-12-16,4,0,12,23,0,5,1,2,0.3,0.303,0.49,0.1343,4,60,71,710,75,770
8289,2011-12-17,4,0,12,0,0,6,0,1,0.3,0.2879,0.49,0.2836,3,45,59,590,62,635
8290,2011-12-17,4,0,12,1,0,6,0,2,0.3,0.2879,0.52,0.2537,4,60,39,390,43,450
8291,2011-12-17,4,0,12,2,0,6,0,2,0.28,0.2727,0.56,0.2239,11,165,47,470,58,635
8292,2011-12-17,4,0,12,3,0,6,0,1,0.26,0.2576,0.6,0.194,4,60,22,220,26,280
8293,2011-12-17,4,0,12,4,0,6,0,1,0.24,0.2424,0.65,0.1642,0,0,9,90,9,90
8294,2011-12-17,4,0,12,5,0,6,0,2,0.26,0.2576,0.6,0.194,2,30,7,70,9,100
8295,2011-12-17,4,0,12,6,0,6,0,2,0.26,0.2424,0.56,0.2836,0,0,17,170,17,170
8296,2011-12-17,4,0,12,7,0,6,0,2,0.26,0.2576,0.56,0.2239,0,0,20,200,20,200
8297,2011-12-17,4,0,12,8,0,6,0,2,0.26,0.2576,0.56,0.2239,4,60,55,550,59,610
8298,2011-12-17,4,0,12,9,0,6,0,2,0.26,0.2424,0.56,0.2537,5,75,95,950,100,1025
8299,2011-12-17,4,0,12,10,0,6,0,2,0.26,0.2424,0.52,0.2836,10,150,171,1710,181,1860
8300,2011-12-17,4,0,12,11,0,6,0,2,0.28,0.2576,0.45,0.3284,21,315,188,1880,209,2195
8301,2011-12-17,4,0,12,12,0,6,0,2,0.28,0.2576,0.45,0.2836,28,420,216,2160,244,2580
8302,2011-12-17,4,0,12,13,0,6,0,2,0.28,0.2727,0.48,0.2537,32,480,204,2040,236,2520
8303,2011-12-17,4,0,12,14,0,6,0,1,0.28,0.2576,0.45,0.3582,30,450,207,2070,237,2520
8304,2011-12-17,4,0,12,15,0,6,0,1,0.28,0.2576,0.45,0.2836,33,495,195,1950,228,2445
8305,2011-12-17,4,0,12,16,0,6,0,1,0.28,0.2727,0.45,0.2239,30,450,192,1920,222,2370
8306,2011-12-17,4,0,12,17,0,6,0,1,0.26,0.2576,0.48,0.2239,12,180,153,1530,165,1710
8307,2011-12-17,4,0,12,18,0,6,0,1,0.26,0.2273,0.48,0.3881,7,105,150,1500,157,1605
8308,2011-12-17,4,0,12,19,0,6,0,3,0.24,0.2121,0.65,0.3284,11,165,95,950,106,1115
8309,2011-12-17,4,0,12,20,0,6,0,1,0.22,0.2121,0.69,0.2537,7,105,99,990,106,1095
8310,2011-12-17,4,0,12,21,0,6,0,1,0.2,0.2121,0.75,0.1642,8,120,88,880,96,1000
8311,2011-12-17,4,0,12,22,0,6,0,1,0.2,0.2121,0.75,0.1642,7,105,73,730,80,835
8312,2011-12-17,4,0,12,23,0,6,0,1,0.2,0.2273,0.75,0.0,6,90,63,630,69,720
8313,2011-12-18,4,0,12,0,0,0,0,1,0.2,0.2121,0.75,0.1343,7,105,64,640,71,745
8314,2011-12-18,4,0,12,1,0,0,0,1,0.2,0.2273,0.69,0.1045,3,45,43,430,46,475
8315,2011-12-18,4,0,12,2,0,0,0,1,0.22,0.2424,0.55,0.1045,2,30,39,390,41,420
8316,2011-12-18,4,0,12,3,0,0,0,1,0.22,0.2121,0.55,0.2239,2,30,16,160,18,190
8317,2011-12-18,4,0,12,4,0,0,0,1,0.22,0.2121,0.55,0.2239,0,0,1,10,1,10
8318,2011-12-18,4,0,12,5,0,0,0,1,0.2,0.2273,0.59,0.1045,1,15,4,40,5,55
8319,2011-12-18,4,0,12,6,0,0,0,1,0.2,0.2121,0.59,0.1343,0,0,3,30,3,30
8320,2011-12-18,4,0,12,7,0,0,0,1,0.2,0.2121,0.59,0.1642,1,15,11,110,12,125
8321,2011-12-18,4,0,12,8,0,0,0,1,0.2,0.2576,0.69,0.0,1,15,31,310,32,325
8322,2011-12-18,4,0,12,9,0,0,0,1,0.22,0.2273,0.64,0.1642,6,90,75,750,81,840
8323,2011-12-18,4,0,12,10,0,0,0,1,0.24,0.2273,0.6,0.2537,7,105,122,1220,129,1325
8324,2011-12-18,4,0,12,11,0,0,0,2,0.24,0.2273,0.6,0.2239,20,300,168,1680,188,1980
8325,2011-12-18,4,0,12,12,0,0,0,1,0.26,0.2576,0.6,0.2239,26,390,202,2020,228,2410
8326,2011-12-18,4,0,12,13,0,0,0,1,0.3,0.2727,0.49,0.2985,18,270,210,2100,228,2370
8327,2011-12-18,4,0,12,14,0,0,0,1,0.3,0.2879,0.49,0.2836,19,285,200,2000,219,2285
8328,2011-12-18,4,0,12,15,0,0,0,1,0.32,0.303,0.45,0.2836,23,345,184,1840,207,2185
8329,2011-12-18,4,0,12,16,0,0,0,1,0.28,0.2727,0.48,0.2537,27,405,207,2070,234,2475
8330,2011-12-18,4,0,12,17,0,0,0,1,0.28,0.2727,0.46,0.1642,10,150,126,1260,136,1410
8331,2011-12-18,4,0,12,18,0,0,0,1,0.28,0.2727,0.45,0.194,15,225,123,1230,138,1455
8332,2011-12-18,4,0,12,19,0,0,0,1,0.26,0.2727,0.52,0.1343,5,75,130,1300,135,1375
8333,2011-12-18,4,0,12,20,0,0,0,1,0.24,0.2576,0.6,0.1045,10,150,94,940,104,1090
8334,2011-12-18,4,0,12,21,0,0,0,1,0.22,0.2727,0.64,0.0,9,135,80,800,89,935
8335,2011-12-18,4,0,12,22,0,0,0,1,0.22,0.2273,0.75,0.194,2,30,47,470,49,500
8336,2011-12-18,4,0,12,23,0,0,0,1,0.2,0.2273,0.75,0.1045,6,90,31,310,37,400
8337,2011-12-19,4,0,12,0,0,1,1,1,0.2,0.2273,0.75,0.0896,3,45,14,140,17,185
8338,2011-12-19,4,0,12,1,0,1,1,1,0.18,0.2121,0.8,0.0896,3,45,8,80,11,125
8339,2011-12-19,4,0,12,2,0,1,1,1,0.18,0.2121,0.8,0.0896,0,0,3,30,3,30
8340,2011-12-19,4,0,12,3,0,1,1,1,0.16,0.197,0.86,0.0896,0,0,3,30,3,30
8341,2011-12-19,4,0,12,4,0,1,1,1,0.16,0.1818,0.86,0.1343,0,0,4,40,4,40
8342,2011-12-19,4,0,12,5,0,1,1,1,0.14,0.1667,0.93,0.1045,0,0,21,210,21,210
8343,2011-12-19,4,0,12,6,0,1,1,1,0.16,0.1818,0.86,0.1045,0,0,68,680,68,680
8344,2011-12-19,4,0,12,7,0,1,1,1,0.18,0.2121,0.74,0.1045,4,60,187,1870,191,1930
8345,2011-12-19,4,0,12,8,0,1,1,1,0.2,0.197,0.75,0.194,8,120,389,3890,397,4010
8346,2011-12-19,4,0,12,9,0,1,1,1,0.22,0.2121,0.69,0.2239,17,255,166,1660,183,1915
8347,2011-12-19,4,0,12,10,0,1,1,1,0.24,0.2273,0.67,0.194,12,180,96,960,108,1140
8348,2011-12-19,4,0,12,11,0,1,1,1,0.26,0.2424,0.65,0.2537,22,330,105,1050,127,1380
8349,2011-12-19,4,0,12,12,0,1,1,1,0.3,0.2727,0.61,0.3284,13,195,128,1280,141,1475
8350,2011-12-19,4,0,12,13,0,1,1,1,0.34,0.303,0.49,0.3284,15,225,127,1270,142,1495
8351,2011-12-19,4,0,12,14,0,1,1,1,0.36,0.3485,0.46,0.2239,30,450,107,1070,137,1520
8352,2011-12-19,4,0,12,15,0,1,1,1,0.38,0.3939,0.46,0.1642,24,360,135,1350,159,1710
8353,2011-12-19,4,0,12,16,0,1,1,1,0.4,0.4091,0.4,0.2537,19,285,189,1890,208,2175
8354,2011-12-19,4,0,12,17,0,1,1,1,0.38,0.3939,0.46,0.194,16,240,362,3620,378,3860
8355,2011-12-19,4,0,12,18,0,1,1,1,0.36,0.3485,0.5,0.194,11,165,343,3430,354,3595
8356,2011-12-19,4,0,12,19,0,1,1,2,0.36,0.3485,0.53,0.1642,17,255,234,2340,251,2595
8357,2011-12-19,4,0,12,20,0,1,1,1,0.4,0.4091,0.4,0.1642,9,135,197,1970,206,2105
8358,2011-12-19,4,0,12,21,0,1,1,2,0.36,0.3485,0.53,0.1343,15,225,112,1120,127,1345
8359,2011-12-19,4,0,12,22,0,1,1,2,0.36,0.3485,0.57,0.1642,12,180,95,950,107,1130
8360,2011-12-19,4,0,12,23,0,1,1,1,0.36,0.3485,0.53,0.1642,10,150,50,500,60,650
8361,2011-12-20,4,0,12,0,0,2,1,1,0.36,0.3636,0.57,0.1045,0,0,21,210,21,210
8362,2011-12-20,4,0,12,1,0,2,1,1,0.36,0.3788,0.53,0.0,0,0,6,60,6,60
8363,2011-12-20,4,0,12,2,0,2,1,2,0.34,0.3636,0.61,0.0,1,15,10,100,11,115
8364,2011-12-20,4,0,12,3,0,2,1,2,0.34,0.3636,0.61,0.0,1,15,1,10,2,25
8365,2011-12-20,4,0,12,4,0,2,1,2,0.36,0.3636,0.53,0.1045,0,0,4,40,4,40
8366,2011-12-20,4,0,12,5,0,2,1,2,0.36,0.3788,0.57,0.0,0,0,15,150,15,150
8367,2011-12-20,4,0,12,6,0,2,1,2,0.36,0.3788,0.57,0.0,1,15,71,710,72,725
8368,2011-12-20,4,0,12,7,0,2,1,2,0.36,0.3788,0.62,0.0,7,105,261,2610,268,2715
8369,2011-12-20,4,0,12,8,0,2,1,2,0.42,0.4242,0.54,0.0896,10,150,422,4220,432,4370
8370,2011-12-20,4,0,12,9,0,2,1,2,0.36,0.3788,0.66,0.0,14,210,245,2450,259,2660
8371,2011-12-20,4,0,12,10,0,2,1,2,0.42,0.4242,0.58,0.194,20,300,109,1090,129,1390
8372,2011-12-20,4,0,12,11,0,2,1,2,0.4,0.4091,0.62,0.1642,13,195,116,1160,129,1355
8373,2011-12-20,4,0,12,12,0,2,1,2,0.44,0.4394,0.54,0.1343,16,240,159,1590,175,1830
8374,2011-12-20,4,0,12,13,0,2,1,2,0.44,0.4394,0.54,0.1343,18,270,163,1630,181,1900
8375,2011-12-20,4,0,12,14,0,2,1,2,0.44,0.4394,0.58,0.1045,11,165,127,1270,138,1435
8376,2011-12-20,4,0,12,15,0,2,1,2,0.44,0.4394,0.54,0.0,15,225,139,1390,154,1615
8377,2011-12-20,4,0,12,16,0,2,1,1,0.44,0.4394,0.54,0.0,20,300,218,2180,238,2480
8378,2011-12-20,4,0,12,17,0,2,1,1,0.4,0.4091,0.62,0.1642,14,210,417,4170,431,4380
8379,2011-12-20,4,0,12,18,0,2,1,1,0.38,0.3939,0.66,0.194,26,390,385,3850,411,4240
8380,2011-12-20,4,0,12,19,0,2,1,1,0.38,0.3939,0.66,0.0,6,90,218,2180,224,2270
8381,2011-12-20,4,0,12,20,0,2,1,1,0.36,0.3788,0.66,0.0,3,45,144,1440,147,1485
8382,2011-12-20,4,0,12,21,0,2,1,1,0.36,0.3636,0.66,0.0896,4,60,139,1390,143,1450
8383,2011-12-20,4,0,12,22,0,2,1,2,0.36,0.3788,0.66,0.0,3,45,104,1040,107,1085
8384,2011-12-20,4,0,12,23,0,2,1,2,0.38,0.3939,0.62,0.0,13,195,40,400,53,595
8385,2011-12-21,1,0,12,0,0,3,1,2,0.34,0.3333,0.71,0.1343,7,105,18,180,25,285
8386,2011-12-21,1,0,12,1,0,3,1,2,0.36,0.3636,0.66,0.1045,1,15,10,100,11,115
8387,2011-12-21,1,0,12,2,0,3,1,2,0.36,0.3788,0.71,0.0,0,0,4,40,4,40
8388,2011-12-21,1,0,12,3,0,3,1,2,0.36,0.3788,0.71,0.0,0,0,2,20,2,20
8389,2011-12-21,1,0,12,4,0,3,1,2,0.36,0.3788,0.71,0.0,0,0,2,20,2,20
8390,2011-12-21,1,0,12,5,0,3,1,2,0.38,0.3939,0.82,0.1045,0,0,28,280,28,280
8391,2011-12-21,1,0,12,6,0,3,1,2,0.36,0.3788,0.87,0.0,1,15,75,750,76,765
8392,2011-12-21,1,0,12,7,0,3,1,2,0.36,0.3636,0.87,0.1045,5,75,224,2240,229,2315
8393,2011-12-21,1,0,12,8,0,3,1,3,0.36,0.3788,0.93,0.0,12,180,393,3930,405,4110
8394,2011-12-21,1,0,12,9,0,3,1,2,0.4,0.4091,0.87,0.2239,14,210,220,2200,234,2410
8395,2011-12-21,1,0,12,10,0,3,1,2,0.48,0.4697,0.82,0.4179,6,90,83,830,89,920
8396,2011-12-21,1,0,12,11,0,3,1,2,0.48,0.4697,0.82,0.4179,3,45,53,530,56,575
8397,2011-12-21,1,0,12,12,0,3,1,3,0.46,0.4545,0.88,0.3881,3,45,58,580,61,625
8398,2011-12-21,1,0,12,13,0,3,1,3,0.44,0.4394,0.94,0.2985,3,45,55,550,58,595
8399,2011-12-21,1,0,12,14,0,3,1,2,0.48,0.4697,0.88,0.3582,11,165,40,400,51,565
8400,2011-12-21,1,0,12,15,0,3,1,2,0.48,0.4697,0.88,0.3881,4,60,57,570,61,630
8401,2011-12-21,1,0,12,16,0,3,1,3,0.44,0.4394,1.0,0.3284,6,90,95,950,101,1040
8402,2011-12-21,1,0,12,17,0,3,1,3,0.44,0.4394,1.0,0.3284,3,45,226,2260,229,2305
8403,2011-12-21,1,0,12,18,0,3,1,2,0.44,0.4394,1.0,0.2985,2,30,278,2780,280,2810
8404,2011-12-21,1,0,12,19,0,3,1,2,0.5,0.4848,0.94,0.3284,9,135,200,2000,209,2135
8405,2011-12-21,1,0,12,20,0,3,1,2,0.5,0.4848,0.94,0.3582,5,75,162,1620,167,1695
8406,2011-12-21,1,0,12,21,0,3,1,1,0.5,0.4848,0.88,0.2836,9,135,114,1140,123,1275
8407,2011-12-21,1,0,12,22,0,3,1,1,0.5,0.4848,0.88,0.2537,3,45,102,1020,105,1065
8408,2011-12-21,1,0,12,23,0,3,1,1,0.5,0.4848,0.88,0.194,0,0,54,540,54,540
8409,2011-12-22,1,0,12,0,0,4,1,2,0.5,0.4848,0.82,0.1045,3,45,24,240,27,285
8410,2011-12-22,1,0,12,1,0,4,1,1,0.44,0.4394,0.94,0.0896,0,0,15,150,15,150
8411,2011-12-22,1,0,12,2,0,4,1,1,0.48,0.4697,0.82,0.1045,1,15,10,100,11,115
8412,2011-12-22,1,0,12,3,0,4,1,1,0.44,0.4394,0.67,0.1642,0,0,6,60,6,60
8413,2011-12-22,1,0,12,4,0,4,1,1,0.38,0.3939,0.82,0.1343,0,0,3,30,3,30
8414,2011-12-22,1,0,12,5,0,4,1,1,0.38,0.3939,0.82,0.0,1,15,15,150,16,165
8415,2011-12-22,1,0,12,6,0,4,1,1,0.36,0.3788,0.87,0.0,1,15,63,630,64,645
8416,2011-12-22,1,0,12,7,0,4,1,1,0.34,0.3636,0.93,0.0,4,60,182,1820,186,1880
8417,2011-12-22,1,0,12,8,0,4,1,2,0.36,0.3788,0.87,0.0,10,150,333,3330,343,3480
8418,2011-12-22,1,0,12,9,0,4,1,2,0.38,0.3939,0.87,0.0896,10,150,218,2180,228,2330
8419,2011-12-22,1,0,12,10,0,4,1,2,0.4,0.4091,0.82,0.0896,13,195,128,1280,141,1475
8420,2011-12-22,1,0,12,11,0,4,1,2,0.44,0.4394,0.77,0.0,10,150,135,1350,145,1500
8421,2011-12-22,1,0,12,12,0,4,1,2,0.48,0.4697,0.55,0.0,22,330,180,1800,202,2130
8422,2011-12-22,1,0,12,13,0,4,1,2,0.46,0.4545,0.63,0.0,21,315,167,1670,188,1985
8423,2011-12-22,1,0,12,14,0,4,1,2,0.46,0.4545,0.63,0.0,23,345,136,1360,159,1705
8424,2011-12-22,1,0,12,15,0,4,1,2,0.48,0.4697,0.59,0.0,28,420,186,1860,214,2280
8425,2011-12-22,1,0,12,16,0,4,1,2,0.46,0.4545,0.63,0.0,30,450,226,2260,256,2710
8426,2011-12-22,1,0,12,17,0,4,1,2,0.44,0.4394,0.67,0.1642,24,360,332,3320,356,3680
8427,2011-12-22,1,0,12,18,0,4,1,2,0.44,0.4394,0.62,0.0896,11,165,277,2770,288,2935
8428,2011-12-22,1,0,12,19,0,4,1,2,0.44,0.4394,0.62,0.0,12,180,130,1300,142,1480
8429,2011-12-22,1,0,12,20,0,4,1,3,0.42,0.4242,0.71,0.0,0,0,33,330,33,330
8430,2011-12-22,1,0,12,21,0,4,1,3,0.42,0.4242,0.71,0.0,2,30,15,150,17,180
8431,2011-12-22,1,0,12,22,0,4,1,3,0.36,0.3636,0.93,0.1045,0,0,17,170,17,170
8432,2011-12-22,1,0,12,23,0,4,1,3,0.4,0.4091,0.87,0.0,1,15,10,100,11,115
8433,2011-12-23,1,0,12,0,0,5,1,3,0.4,0.4091,0.87,0.194,2,30,7,70,9,100
8434,2011-12-23,1,0,12,1,0,5,1,3,0.4,0.4091,0.87,0.194,1,15,11,110,12,125
8435,2011-12-23,1,0,12,2,0,5,1,3,0.38,0.3939,0.94,0.1343,1,15,12,120,13,135
8436,2011-12-23,1,0,12,3,0,5,1,3,0.38,0.3939,0.94,0.1343,0,0,4,40,4,40
8437,2011-12-23,1,0,12,4,0,5,1,3,0.38,0.3939,0.94,0.2836,0,0,2,20,2,20
8438,2011-12-23,1,0,12,5,0,5,1,1,0.36,0.3485,0.93,0.194,0,0,8,80,8,80
8439,2011-12-23,1,0,12,6,0,5,1,1,0.38,0.3939,0.82,0.2537,0,0,40,400,40,400
8440,2011-12-23,1,0,12,7,0,5,1,1,0.38,0.3939,0.82,0.2239,4,60,88,880,92,940
8441,2011-12-23,1,0,12,8,0,5,1,1,0.4,0.4091,0.76,0.2537,9,135,173,1730,182,1865
8442,2011-12-23,1,0,12,9,0,5,1,1,0.4,0.4091,0.66,0.2985,4,60,152,1520,156,1580
8443,2011-12-23,1,0,12,10,0,5,1,1,0.4,0.4091,0.62,0.3582,8,120,96,960,104,1080
8444,2011-12-23,1,0,12,11,0,5,1,1,0.4,0.4091,0.58,0.4478,26,390,148,1480,174,1870
8445,2011-12-23,1,0,12,12,0,5,1,1,0.4,0.4091,0.54,0.5224,14,210,156,1560,170,1770
8446,2011-12-23,1,0,12,13,0,5,1,1,0.4,0.4091,0.5,0.4627,17,255,177,1770,194,2025
8447,2011-12-23,1,0,12,14,0,5,1,1,0.4,0.4091,0.54,0.4179,23,345,177,1770,200,2115
8448,2011-12-23,1,0,12,15,0,5,1,1,0.38,0.3939,0.54,0.3582,12,180,191,1910,203,2090
8449,2011-12-23,1,0,12,16,0,5,1,1,0.38,0.3939,0.5,0.2985,15,225,166,1660,181,1885
8450,2011-12-23,1,0,12,17,0,5,1,1,0.36,0.3485,0.53,0.2239,11,165,129,1290,140,1455
8451,2011-12-23,1,0,12,18,0,5,1,1,0.36,0.3333,0.5,0.2537,4,60,91,910,95,970
8452,2011-12-23,1,0,12,19,0,5,1,1,0.34,0.3333,0.53,0.194,1,15,75,750,76,765
8453,2011-12-23,1,0,12,20,0,5,1,1,0.32,0.303,0.61,0.3284,3,45,47,470,50,515
8454,2011-12-23,1,0,12,21,0,5,1,1,0.32,0.303,0.61,0.2239,0,0,32,320,32,320
8455,2011-12-23,1,0,12,22,0,5,1,1,0.32,0.3182,0.66,0.194,4,60,43,430,47,490
8456,2011-12-23,1,0,12,23,0,5,1,1,0.32,0.3333,0.66,0.1343,4,60,21,210,25,270
8457,2011-12-24,1,0,12,0,0,6,0,2,0.32,0.3182,0.7,0.1642,3,45,20,200,23,245
8458,2011-12-24,1,0,12,1,0,6,0,2,0.32,0.3485,0.66,0.0,1,15,15,150,16,165
8459,2011-12-24,1,0,12,2,0,6,0,2,0.32,0.3333,0.66,0.0896,4,60,22,220,26,280
8460,2011-12-24,1,0,12,3,0,6,0,2,0.32,0.3333,0.7,0.0896,0,0,5,50,5,50
8461,2011-12-24,1,0,12,4,0,6,0,2,0.32,0.3182,0.66,0.1642,0,0,3,30,3,30
8462,2011-12-24,1,0,12,5,0,6,0,2,0.32,0.3182,0.66,0.1642,1,15,3,30,4,45
8463,2011-12-24,1,0,12,6,0,6,0,2,0.3,0.303,0.75,0.1642,0,0,10,100,10,100
8464,2011-12-24,1,0,12,7,0,6,0,1,0.3,0.2727,0.7,0.3582,0,0,10,100,10,100
8465,2011-12-24,1,0,12,8,0,6,0,1,0.28,0.2727,0.7,0.194,0,0,27,270,27,270
8466,2011-12-24,1,0,12,9,0,6,0,1,0.3,0.2727,0.45,0.4179,3,45,53,530,56,575
8467,2011-12-24,1,0,12,10,0,6,0,1,0.3,0.2576,0.42,0.4925,4,60,52,520,56,580
8468,2011-12-24,1,0,12,11,0,6,0,1,0.32,0.2879,0.39,0.3582,9,135,62,620,71,755
8469,2011-12-24,1,0,12,12,0,6,0,1,0.34,0.3182,0.39,0.2836,15,225,79,790,94,1015
8470,2011-12-24,1,0,12,13,0,6,0,1,0.34,0.303,0.39,0.2985,24,360,97,970,121,1330
8471,2011-12-24,1,0,12,14,0,6,0,1,0.34,0.303,0.39,0.2985,15,225,70,700,85,925
8472,2011-12-24,1,0,12,15,0,6,0,1,0.32,0.303,0.39,0.2239,15,225,82,820,97,1045
8473,2011-12-24,1,0,12,16,0,6,0,1,0.32,0.3182,0.42,0.194,25,375,74,740,99,1115
8474,2011-12-24,1,0,12,17,0,6,0,1,0.28,0.2879,0.45,0.1343,15,225,53,530,68,755
8475,2011-12-24,1,0,12,18,0,6,0,1,0.3,0.3182,0.42,0.0896,2,30,33,330,35,360
8476,2011-12-24,1,0,12,19,0,6,0,1,0.3,0.3182,0.52,0.0896,1,15,24,240,25,255
8477,2011-12-24,1,0,12,20,0,6,0,1,0.26,0.2727,0.56,0.1343,5,75,19,190,24,265
8478,2011-12-24,1,0,12,21,0,6,0,1,0.26,0.2576,0.56,0.1642,4,60,15,150,19,210
8479,2011-12-24,1,0,12,22,0,6,0,1,0.24,0.2879,0.52,0.0,8,120,12,120,20,240
8480,2011-12-24,1,0,12,23,0,6,0,1,0.24,0.2576,0.56,0.0,1,15,16,160,17,175
8481,2011-12-25,1,0,12,0,0,0,0,1,0.24,0.2273,0.6,0.194,2,30,4,40,6,70
8482,2011-12-25,1,0,12,1,0,0,0,1,0.22,0.2273,0.69,0.1343,2,30,2,20,4,50
8483,2011-12-25,1,0,12,2,0,0,0,1,0.22,0.2576,0.75,0.0896,0,0,2,20,2,20
8484,2011-12-25,1,0,12,3,0,0,0,1,0.22,0.2727,0.72,0.0,1,15,3,30,4,45
8485,2011-12-25,1,0,12,5,0,0,0,1,0.2,0.2273,0.75,0.1045,0,0,1,10,1,10
8486,2011-12-25,1,0,12,6,0,0,0,1,0.2,0.2273,0.75,0.1045,0,0,1,10,1,10
8487,2011-12-25,1,0,12,7,0,0,0,1,0.22,0.2424,0.8,0.1045,0,0,4,40,4,40
8488,2011-12-25,1,0,12,8,0,0,0,1,0.2,0.2121,0.8,0.1642,1,15,4,40,5,55
8489,2011-12-25,1,0,12,9,0,0,0,1,0.24,0.2424,0.87,0.1642,3,45,20,200,23,245
8490,2011-12-25,1,0,12,10,0,0,0,1,0.26,0.2424,0.81,0.2537,31,465,12,120,43,585
8491,2011-12-25,1,0,12,11,0,0,0,1,0.3,0.303,0.7,0.1642,43,645,42,420,85,1065
8492,2011-12-25,1,0,12,12,0,0,0,1,0.3,0.2727,0.75,0.2985,25,375,41,410,66,785
8493,2011-12-25,1,0,12,13,0,0,0,1,0.32,0.303,0.7,0.2537,40,600,39,390,79,990
8494,2011-12-25,1,0,12,14,0,0,0,1,0.34,0.3182,0.61,0.2537,41,615,45,450,86,1065
8495,2011-12-25,1,0,12,15,0,0,0,1,0.34,0.3333,0.61,0.194,43,645,48,480,91,1125
8496,2011-12-25,1,0,12,16,0,0,0,1,0.36,0.3636,0.57,0.1045,35,525,51,510,86,1035
8497,2011-12-25,1,0,12,17,0,0,0,1,0.34,0.3333,0.61,0.1343,11,165,33,330,44,495
8498,2011-12-25,1,0,12,18,0,0,0,1,0.32,0.3182,0.7,0.194,7,105,23,230,30,335
8499,2011-12-25,1,0,12,19,0,0,0,1,0.32,0.3333,0.57,0.1343,2,30,14,140,16,170
8500,2011-12-25,1,0,12,20,0,0,0,1,0.32,0.3333,0.49,0.0896,8,120,18,180,26,300
8501,2011-12-25,1,0,12,21,0,0,0,1,0.3,0.303,0.56,0.1343,4,60,15,150,19,210
8502,2011-12-25,1,0,12,22,0,0,0,1,0.28,0.2727,0.61,0.1642,2,30,15,150,17,180
8503,2011-12-25,1,0,12,23,0,0,0,1,0.26,0.2727,0.65,0.1343,2,30,14,140,16,170
8504,2011-12-26,1,0,12,0,1,1,0,1,0.22,0.2273,0.75,0.1642,5,75,6,60,11,135
8505,2011-12-26,1,0,12,1,1,1,0,1,0.28,0.2727,0.56,0.194,3,45,7,70,10,115
8506,2011-12-26,1,0,12,2,1,1,0,1,0.34,0.3182,0.46,0.2239,2,30,5,50,7,80
8507,2011-12-26,1,0,12,4,1,1,0,1,0.34,0.303,0.46,0.2985,0,0,2,20,2,20
8508,2011-12-26,1,0,12,5,1,1,0,1,0.34,0.303,0.42,0.3881,0,0,4,40,4,40
8509,2011-12-26,1,0,12,6,1,1,0,1,0.32,0.303,0.45,0.2836,0,0,4,40,4,40
8510,2011-12-26,1,0,12,7,1,1,0,1,0.32,0.3182,0.45,0.194,2,30,17,170,19,200
8511,2011-12-26,1,0,12,8,1,1,0,1,0.32,0.3333,0.45,0.1343,5,75,13,130,18,205
8512,2011-12-26,1,0,12,9,1,1,0,1,0.34,0.303,0.46,0.2985,24,360,38,380,62,740
8513,2011-12-26,1,0,12,10,1,1,0,1,0.34,0.2879,0.42,0.5224,31,465,39,390,70,855
8514,2011-12-26,1,0,12,11,1,1,0,1,0.34,0.2879,0.46,0.5821,40,600,51,510,91,1110
8515,2011-12-26,1,0,12,12,1,1,0,1,0.36,0.3182,0.43,0.4627,34,510,66,660,100,1170
8516,2011-12-26,1,0,12,13,1,1,0,1,0.38,0.3939,0.4,0.2985,57,855,83,830,140,1685
8517,2011-12-26,1,0,12,14,1,1,0,1,0.38,0.3939,0.4,0.3284,73,1095,80,800,153,1895
8518,2011-12-26,1,0,12,15,1,1,0,1,0.38,0.3939,0.4,0.2537,26,390,105,1050,131,1440
8519,2011-12-26,1,0,12,16,1,1,0,1,0.36,0.3333,0.43,0.2836,28,420,69,690,97,1110
8520,2011-12-26,1,0,12,17,1,1,0,1,0.34,0.3182,0.46,0.2239,30,450,67,670,97,1120
8521,2011-12-26,1,0,12,18,1,1,0,1,0.32,0.3333,0.49,0.0896,21,315,54,540,75,855
8522,2011-12-26,1,0,12,19,1,1,0,1,0.3,0.3182,0.65,0.0896,16,240,49,490,65,730
8523,2011-12-26,1,0,12,20,1,1,0,1,0.3,0.3182,0.56,0.0896,14,210,42,420,56,630
8524,2011-12-26,1,0,12,21,1,1,0,1,0.26,0.303,0.7,0.0,10,150,39,390,49,540
8525,2011-12-26,1,0,12,22,1,1,0,1,0.26,0.303,0.7,0.0,5,75,22,220,27,295
8526,2011-12-26,1,0,12,23,1,1,0,1,0.26,0.2727,0.7,0.1045,4,60,25,250,29,310
8527,2011-12-27,1,0,12,0,0,2,1,1,0.26,0.2576,0.7,0.1642,3,45,9,90,12,135
8528,2011-12-27,1,0,12,1,0,2,1,1,0.26,0.2727,0.7,0.1343,0,0,6,60,6,60
8529,2011-12-27,1,0,12,2,0,2,1,1,0.26,0.2727,0.7,0.1343,2,30,2,20,4,50
8530,2011-12-27,1,0,12,3,0,2,1,2,0.3,0.2879,0.61,0.2239,0,0,3,30,3,30
8531,2011-12-27,1,0,12,4,0,2,1,2,0.3,0.2879,0.65,0.2239,0,0,3,30,3,30
8532,2011-12-27,1,0,12,5,0,2,1,2,0.3,0.2727,0.64,0.2836,0,0,8,80,8,80
8533,2011-12-27,1,0,12,6,0,2,1,2,0.3,0.2727,0.61,0.2985,0,0,35,350,35,350
8534,2011-12-27,1,0,12,7,0,2,1,2,0.3,0.2879,0.65,0.2836,1,15,79,790,80,805
8535,2011-12-27,1,0,12,8,0,2,1,2,0.3,0.303,0.65,0.1642,9,135,155,1550,164,1685
8536,2011-12-27,1,0,12,9,0,2,1,3,0.32,0.3333,0.66,0.1045,19,285,85,850,104,1135
8537,2011-12-27,1,0,12,10,0,2,1,2,0.32,0.3333,0.66,0.0896,13,195,47,470,60,665
8538,2011-12-27,1,0,12,11,0,2,1,3,0.32,0.3333,0.66,0.1045,6,90,24,240,30,330
8539,2011-12-27,1,0,12,12,0,2,1,3,0.3,0.3182,0.81,0.0896,8,120,16,160,24,280
8540,2011-12-27,1,0,12,13,0,2,1,3,0.3,0.303,0.87,0.1343,1,15,19,190,20,205
8541,2011-12-27,1,0,12,14,0,2,1,3,0.42,0.4242,0.82,0.3881,0,0,14,140,14,140
8542,2011-12-27,1,0,12,15,0,2,1,3,0.42,0.4242,0.82,0.3881,2,30,17,170,19,200
8543,2011-12-27,1,0,12,16,0,2,1,3,0.44,0.4394,0.88,0.3284,2,30,44,440,46,470
8544,2011-12-27,1,0,12,17,0,2,1,3,0.4,0.4091,0.87,0.1343,6,90,109,1090,115,1180
8545,2011-12-27,1,0,12,18,0,2,1,1,0.38,0.3939,0.87,0.2836,9,135,126,1260,135,1395
8546,2011-12-27,1,0,12,19,0,2,1,1,0.34,0.3333,0.87,0.1642,3,45,87,870,90,915
8547,2011-12-27,1,0,12,20,0,2,1,1,0.32,0.3333,0.93,0.0896,3,45,66,660,69,705
8548,2011-12-27,1,0,12,21,0,2,1,1,0.32,0.3333,0.87,0.0896,11,165,52,520,63,685
8549,2011-12-27,1,0,12,22,0,2,1,1,0.32,0.3333,0.87,0.0896,3,45,29,290,32,335
8550,2011-12-27,1,0,12,23,0,2,1,1,0.3,0.303,0.93,0.1343,2,30,24,240,26,270
8551,2011-12-28,1,0,12,0,0,3,1,1,0.32,0.3182,0.87,0.1642,0,0,10,100,10,100
8552,2011-12-28,1,0,12,1,0,3,1,1,0.32,0.3182,0.76,0.1642,0,0,12,120,12,120
8553,2011-12-28,1,0,12,2,0,3,1,1,0.32,0.303,0.61,0.2537,0,0,7,70,7,70
8554,2011-12-28,1,0,12,3,0,3,1,1,0.32,0.303,0.61,0.2537,0,0,4,40,4,40
8555,2011-12-28,1,0,12,5,0,3,1,1,0.32,0.2879,0.57,0.3582,0,0,9,90,9,90
8556,2011-12-28,1,0,12,6,0,3,1,1,0.32,0.303,0.57,0.2537,1,15,42,420,43,435
8557,2011-12-28,1,0,12,7,0,3,1,1,0.32,0.303,0.57,0.2537,4,60,106,1060,110,1120
8558,2011-12-28,1,0,12,8,0,3,1,1,0.32,0.2879,0.57,0.3582,11,165,206,2060,217,2225
8559,2011-12-28,1,0,12,9,0,3,1,1,0.32,0.303,0.57,0.3284,18,270,171,1710,189,1980
8560,2011-12-28,1,0,12,10,0,3,1,1,0.34,0.3182,0.57,0.2239,12,180,84,840,96,1020
8561,2011-12-28,1,0,12,11,0,3,1,1,0.36,0.3333,0.46,0.3582,18,270,93,930,111,1200
8562,2011-12-28,1,0,12,12,0,3,1,1,0.34,0.2879,0.46,0.5522,32,480,108,1080,140,1560
8563,2011-12-28,1,0,12,13,0,3,1,1,0.34,0.2879,0.39,0.4627,24,360,135,1350,159,1710
8564,2011-12-28,1,0,12,14,0,3,1,1,0.32,0.2879,0.39,0.3881,24,360,96,960,120,1320
8565,2011-12-28,1,0,12,15,0,3,1,1,0.32,0.2879,0.36,0.4179,16,240,101,1010,117,1250
8566,2011-12-28,1,0,12,16,0,3,1,1,0.3,0.2727,0.36,0.4179,23,345,144,1440,167,1785
8567,2011-12-28,1,0,12,17,0,3,1,1,0.28,0.2727,0.38,0.2537,25,375,225,2250,250,2625
8568,2011-12-28,1,0,12,18,0,3,1,1,0.26,0.2273,0.38,0.3284,10,150,159,1590,169,1740
8569,2011-12-28,1,0,12,19,0,3,1,1,0.24,0.2273,0.41,0.2537,16,240,135,1350,151,1590
8570,2011-12-28,1,0,12,20,0,3,1,1,0.24,0.2273,0.41,0.2239,9,135,70,700,79,835
8571,2011-12-28,1,0,12,21,0,3,1,1,0.22,0.2273,0.44,0.1343,7,105,63,630,70,735
8572,2011-12-28,1,0,12,22,0,3,1,1,0.22,0.2424,0.44,0.1045,2,30,31,310,33,340
8573,2011-12-28,1,0,12,23,0,3,1,1,0.22,0.2121,0.44,0.2537,3,45,36,360,39,405
8574,2011-12-29,1,0,12,0,0,4,1,2,0.22,0.2273,0.47,0.194,4,60,24,240,28,300
8575,2011-12-29,1,0,12,1,0,4,1,1,0.22,0.2121,0.47,0.2239,0,0,15,150,15,150
8576,2011-12-29,1,0,12,2,0,4,1,1,0.2,0.2273,0.51,0.1045,0,0,3,30,3,30
8577,2011-12-29,1,0,12,3,0,4,1,1,0.2,0.197,0.55,0.194,0,0,2,20,2,20
8578,2011-12-29,1,0,12,4,0,4,1,1,0.2,0.2121,0.55,0.1642,1,15,2,20,3,35
8579,2011-12-29,1,0,12,5,0,4,1,1,0.2,0.2273,0.55,0.1045,0,0,10,100,10,100
8580,2011-12-29,1,0,12,6,0,4,1,1,0.2,0.2576,0.59,0.0,2,30,39,390,41,420
8581,2011-12-29,1,0,12,7,0,4,1,1,0.18,0.2121,0.64,0.0896,2,30,104,1040,106,1070
8582,2011-12-29,1,0,12,8,0,4,1,2,0.2,0.2576,0.64,0.0,3,45,207,2070,210,2115
8583,2011-12-29,1,0,12,9,0,4,1,2,0.2,0.2121,0.64,0.1343,15,225,155,1550,170,1775
8584,2011-12-29,1,0,12,10,0,4,1,2,0.22,0.2273,0.64,0.1642,13,195,97,970,110,1165
8585,2011-12-29,1,0,12,11,0,4,1,2,0.24,0.2576,0.6,0.0896,23,345,99,990,122,1335
8586,2011-12-29,1,0,12,12,0,4,1,2,0.26,0.2727,0.56,0.1045,12,180,118,1180,130,1360
8587,2011-12-29,1,0,12,13,0,4,1,2,0.28,0.2879,0.52,0.1045,36,540,95,950,131,1490
8588,2011-12-29,1,0,12,14,0,4,1,2,0.3,0.3333,0.52,0.0,30,450,112,1120,142,1570
8589,2011-12-29,1,0,12,15,0,4,1,2,0.3,0.3182,0.52,0.0896,27,405,150,1500,177,1905
8590,2011-12-29,1,0,12,16,0,4,1,1,0.3,0.303,0.52,0.1642,22,330,155,1550,177,1880
8591,2011-12-29,1,0,12,17,0,4,1,1,0.3,0.303,0.61,0.1642,14,210,226,2260,240,2470
8592,2011-12-29,1,0,12,18,0,4,1,1,0.3,0.303,0.56,0.1343,15,225,192,1920,207,2145
8593,2011-12-29,1,0,12,19,0,4,1,1,0.3,0.3182,0.56,0.1045,11,165,124,1240,135,1405
8594,2011-12-29,1,0,12,20,0,4,1,1,0.28,0.2879,0.65,0.1045,8,120,88,880,96,1000
8595,2011-12-29,1,0,12,21,0,4,1,2,0.28,0.2879,0.61,0.1343,8,120,60,600,68,720
8596,2011-12-29,1,0,12,22,0,4,1,1,0.28,0.2879,0.65,0.1343,7,105,48,480,55,585
8597,2011-12-29,1,0,12,23,0,4,1,1,0.3,0.303,0.65,0.1642,1,15,44,440,45,455
8598,2011-12-30,1,0,12,0,0,5,1,1,0.28,0.2879,0.7,0.1343,4,60,26,260,30,320
8599,2011-12-30,1,0,12,1,0,5,1,1,0.26,0.2879,0.65,0.0896,9,135,11,110,20,245
8600,2011-12-30,1,0,12,2,0,5,1,1,0.24,0.2576,0.7,0.1045,2,30,10,100,12,130
8601,2011-12-30,1,0,12,3,0,5,1,1,0.24,0.2576,0.7,0.1045,0,0,6,60,6,60
8602,2011-12-30,1,0,12,4,0,5,1,1,0.24,0.2576,0.7,0.0896,0,0,2,20,2,20
8603,2011-12-30,1,0,12,5,0,5,1,1,0.22,0.2576,0.75,0.0896,0,0,10,100,10,100
8604,2011-12-30,1,0,12,6,0,5,1,1,0.24,0.2576,0.7,0.0896,1,15,31,310,32,325
8605,2011-12-30,1,0,12,7,0,5,1,1,0.24,0.2576,0.75,0.0896,3,45,92,920,95,965
8606,2011-12-30,1,0,12,8,0,5,1,2,0.24,0.2576,0.75,0.0896,12,180,193,1930,205,2110
8607,2011-12-30,1,0,12,9,0,5,1,1,0.26,0.303,0.75,0.0,19,285,175,1750,194,2035
8608,2011-12-30,1,0,12,10,0,5,1,1,0.3,0.2879,0.65,0.2537,10,150,108,1080,118,1230
8609,2011-12-30,1,0,12,11,0,5,1,1,0.32,0.3182,0.66,0.194,45,675,126,1260,171,1935
8610,2011-12-30,1,0,12,12,0,5,1,1,0.32,0.3333,0.57,0.1343,38,570,159,1590,197,2160
8611,2011-12-30,1,0,12,13,0,5,1,2,0.36,0.3485,0.53,0.1343,53,795,154,1540,207,2335
8612,2011-12-30,1,0,12,14,0,5,1,2,0.4,0.4091,0.47,0.0896,67,1005,178,1780,245,2785
8613,2011-12-30,1,0,12,15,0,5,1,1,0.42,0.4242,0.44,0.0,56,840,236,2360,292,3200
8614,2011-12-30,1,0,12,16,0,5,1,1,0.42,0.4242,0.47,0.194,36,540,247,2470,283,3010
8615,2011-12-30,1,0,12,17,0,5,1,1,0.38,0.3939,0.54,0.1642,54,810,188,1880,242,2690
8616,2011-12-30,1,0,12,18,0,5,1,1,0.36,0.3485,0.62,0.1343,19,285,163,1630,182,1915
8617,2011-12-30,1,0,12,19,0,5,1,2,0.34,0.303,0.49,0.4179,16,240,96,960,112,1200
8618,2011-12-30,1,0,12,20,0,5,1,2,0.34,0.3485,0.66,0.1045,16,240,75,750,91,990
8619,2011-12-30,1,0,12,21,0,5,1,2,0.36,0.3636,0.66,0.1045,11,165,84,840,95,1005
8620,2011-12-30,1,0,12,22,0,5,1,2,0.34,0.3333,0.71,0.1642,7,105,78,780,85,885
8621,2011-12-30,1,0,12,23,0,5,1,2,0.36,0.3333,0.66,0.2537,13,195,60,600,73,795
8622,2011-12-31,1,0,12,0,0,6,0,2,0.38,0.3939,0.62,0.3284,7,105,37,370,44,475
8623,2011-12-31,1,0,12,1,0,6,0,2,0.4,0.4091,0.62,0.2836,4,60,31,310,35,370
8624,2011-12-31,1,0,12,2,0,6,0,2,0.4,0.4091,0.62,0.2836,1,15,27,270,28,285
8625,2011-12-31,1,0,12,3,0,6,0,2,0.4,0.4091,0.62,0.2836,1,15,17,170,18,185
8626,2011-12-31,1,0,12,4,0,6,0,1,0.38,0.3939,0.71,0.2239,1,15,9,90,10,105
8627,2011-12-31,1,0,12,5,0,6,0,2,0.36,0.3485,0.76,0.2239,1,15,0,0,1,15
8628,2011-12-31,1,0,12,6,0,6,0,2,0.4,0.4091,0.71,0.0896,1,15,5,50,6,65
8629,2011-12-31,1,0,12,7,0,6,0,3,0.38,0.3939,0.76,0.0,6,90,13,130,19,220
8630,2011-12-31,1,0,12,8,0,6,0,1,0.34,0.3333,0.81,0.1343,7,105,42,420,49,525
8631,2011-12-31,1,0,12,9,0,6,0,1,0.38,0.3939,0.76,0.0,18,270,72,720,90,990
8632,2011-12-31,1,0,12,10,0,6,0,1,0.4,0.4091,0.76,0.1642,20,300,108,1080,128,1380
8633,2011-12-31,1,0,12,11,0,6,0,1,0.42,0.4242,0.71,0.1642,65,975,152,1520,217,2495
8634,2011-12-31,1,0,12,12,0,6,0,1,0.52,0.5,0.39,0.2985,93,1395,180,1800,273,3195
8635,2011-12-31,1,0,12,13,0,6,0,1,0.5,0.4848,0.42,0.4925,108,1620,205,2050,313,3670
8636,2011-12-31,1,0,12,14,0,6,0,1,0.46,0.4545,0.51,0.3284,115,1725,185,1850,300,3575
8637,2011-12-31,1,0,12,15,0,6,0,1,0.46,0.4545,0.47,0.4925,89,1335,164,1640,253,2975
8638,2011-12-31,1,0,12,16,0,6,0,1,0.44,0.4394,0.51,0.3881,52,780,143,1430,195,2210
8639,2011-12-31,1,0,12,17,0,6,0,1,0.42,0.4242,0.54,0.194,28,420,101,1010,129,1430
8640,2011-12-31,1,0,12,18,0,6,0,1,0.42,0.4242,0.54,0.1343,13,195,80,800,93,995
8641,2011-12-31,1,0,12,19,0,6,0,1,0.42,0.4242,0.54,0.2239,19,285,73,730,92,1015
8642,2011-12-31,1,0,12,20,0,6,0,1,0.42,0.4242,0.54,0.2239,8,120,63,630,71,750
8643,2011-12-31,1,0,12,21,0,6,0,1,0.4,0.4091,0.58,0.194,2,30,50,500,52,530
8644,2011-12-31,1,0,12,22,0,6,0,1,0.38,0.3939,0.62,0.1343,2,30,36,360,38,390
8645,2011-12-31,1,0,12,23,0,6,0,1,0.36,0.3788,0.66,0.0,4,60,27,270,31,330
8646,2012-01-01,1,1,1,0,0,0,0,1,0.36,0.3788,0.66,0.0,5,75,43,430,48,505
8647,2012-01-01,1,1,1,1,0,0,0,1,0.36,0.3485,0.66,0.1343,15,225,78,780,93,1005
8648,2012-01-01,1,1,1,2,0,0,0,1,0.32,0.3485,0.76,0.0,16,240,59,590,75,830
8649,2012-01-01,1,1,1,3,0,0,0,1,0.3,0.3333,0.81,0.0,11,165,41,410,52,575
8650,2012-01-01,1,1,1,4,0,0,0,1,0.28,0.303,0.81,0.0896,0,0,8,80,8,80
8651,2012-01-01,1,1,1,5,0,0,0,1,0.28,0.2879,0.81,0.1045,0,0,5,50,5,50
8652,2012-01-01,1,1,1,6,0,0,0,1,0.26,0.2727,0.93,0.1343,1,15,1,10,2,25
8653,2012-01-01,1,1,1,7,0,0,0,1,0.26,0.2576,0.93,0.1642,1,15,6,60,7,75
8654,2012-01-01,1,1,1,8,0,0,0,1,0.26,0.2727,0.87,0.1045,4,60,10,100,14,160
8655,2012-01-01,1,1,1,9,0,0,0,1,0.26,0.2727,0.93,0.1045,13,195,27,270,40,465
8656,2012-01-01,1,1,1,10,0,0,0,1,0.3,0.3182,0.81,0.1045,18,270,52,520,70,790
8657,2012-01-01,1,1,1,11,0,0,0,1,0.34,0.3333,0.76,0.1343,40,600,98,980,138,1580
8658,2012-01-01,1,1,1,12,0,0,0,1,0.4,0.4091,0.62,0.2836,58,870,143,1430,201,2300
8659,2012-01-01,1,1,1,13,0,0,0,1,0.42,0.4242,0.58,0.2836,82,1230,141,1410,223,2640
8660,2012-01-01,1,1,1,14,0,0,0,1,0.44,0.4394,0.54,0.2985,120,1800,147,1470,267,3270
8661,2012-01-01,1,1,1,15,0,0,0,1,0.46,0.4545,0.51,0.2985,101,1515,164,1640,265,3155
8662,2012-01-01,1,1,1,16,0,0,0,2,0.44,0.4394,0.54,0.2985,68,1020,147,1470,215,2490
8663,2012-01-01,1,1,1,17,0,0,0,2,0.48,0.4697,0.48,0.1642,36,540,75,750,111,1290
8664,2012-01-01,1,1,1,18,0,0,0,3,0.46,0.4545,0.59,0.2537,25,375,81,810,106,1185
8665,2012-01-01,1,1,1,19,0,0,0,3,0.42,0.4242,0.67,0.3881,20,300,85,850,105,1150
8666,2012-01-01,1,1,1,20,0,0,0,2,0.44,0.4394,0.62,0.2985,25,375,58,580,83,955
8667,2012-01-01,1,1,1,21,0,0,0,2,0.44,0.4394,0.67,0.2537,10,150,61,610,71,760
8668,2012-01-01,1,1,1,22,0,0,0,1,0.46,0.4545,0.55,0.4179,13,195,53,530,66,725
8669,2012-01-01,1,1,1,23,0,0,0,1,0.44,0.4394,0.51,0.2985,4,60,25,250,29,310
8670,2012-01-02,1,1,1,0,1,1,0,1,0.4,0.4091,0.4,0.4627,8,120,31,310,39,430
8671,2012-01-02,1,1,1,1,1,1,0,1,0.36,0.3333,0.43,0.4179,1,15,11,110,12,125
8672,2012-01-02,1,1,1,2,1,1,0,1,0.36,0.3182,0.34,0.4478,1,15,6,60,7,75
8673,2012-01-02,1,1,1,4,1,1,0,1,0.28,0.2576,0.45,0.3284,0,0,4,40,4,40
8674,2012-01-02,1,1,1,5,1,1,0,1,0.28,0.2576,0.45,0.3284,1,15,3,30,4,45
8675,2012-01-02,1,1,1,6,1,1,0,1,0.26,0.2273,0.41,0.3881,0,0,14,140,14,140
8676,2012-01-02,1,1,1,7,1,1,0,1,0.24,0.2121,0.32,0.3881,0,0,16,160,16,160
8677,2012-01-02,1,1,1,8,1,1,0,1,0.24,0.2273,0.35,0.2537,2,30,51,510,53,540
8678,2012-01-02,1,1,1,9,1,1,0,1,0.24,0.2576,0.35,0.0,15,225,53,530,68,755
8679,2012-01-02,1,1,1,10,1,1,0,1,0.26,0.2424,0.35,0.2836,20,300,89,890,109,1190
8680,2012-01-02,1,1,1,11,1,1,0,1,0.26,0.2121,0.35,0.4925,33,495,142,1420,175,1915
8681,2012-01-02,1,1,1,12,1,1,0,1,0.28,0.2727,0.36,0.2537,41,615,161,1610,202,2225
8682,2012-01-02,1,1,1,13,1,1,0,1,0.3,0.2727,0.36,0.2985,26,390,150,1500,176,1890
8683,2012-01-02,1,1,1,14,1,1,0,1,0.3,0.2727,0.36,0.4179,10,150,141,1410,151,1560
8684,2012-01-02,1,1,1,15,1,1,0,1,0.28,0.2424,0.38,0.4478,29,435,139,1390,168,1825
8685,2012-01-02,1,1,1,16,1,1,0,1,0.26,0.2273,0.35,0.4179,10,150,144,1440,154,1590
8686,2012-01-02,1,1,1,17,1,1,0,1,0.26,0.2273,0.35,0.3881,17,255,136,1360,153,1615
8687,2012-01-02,1,1,1,18,1,1,0,1,0.26,0.2424,0.33,0.2537,13,195,113,1130,126,1325
8688,2012-01-02,1,1,1,19,1,1,0,1,0.24,0.2273,0.38,0.2239,4,60,89,890,93,950
8689,2012-01-02,1,1,1,20,1,1,0,1,0.24,0.2273,0.41,0.2239,5,75,83,830,88,905
8690,2012-01-02,1,1,1,21,1,1,0,2,0.24,0.2121,0.41,0.3284,3,45,63,630,66,675
8691,2012-01-02,1,1,1,22,1,1,0,2,0.22,0.2121,0.44,0.2836,3,45,36,360,39,405
8692,2012-01-02,1,1,1,23,1,1,0,1,0.22,0.2121,0.44,0.2537,2,30,32,320,34,350
8693,2012-01-03,1,1,1,0,0,2,1,1,0.2,0.197,0.51,0.2537,0,0,13,130,13,130
8694,2012-01-03,1,1,1,1,0,2,1,1,0.18,0.1818,0.55,0.2239,1,15,5,50,6,65
8695,2012-01-03,1,1,1,2,0,2,1,1,0.18,0.1667,0.51,0.2537,0,0,3,30,3,30
8696,2012-01-03,1,1,1,3,0,2,1,1,0.16,0.1364,0.55,0.2836,0,0,2,20,2,20
8697,2012-01-03,1,1,1,4,0,2,1,1,0.16,0.1515,0.55,0.2537,0,0,5,50,5,50
8698,2012-01-03,1,1,1,5,0,2,1,1,0.14,0.1364,0.54,0.194,0,0,12,120,12,120
8699,2012-01-03,1,1,1,6,0,2,1,1,0.14,0.1212,0.59,0.2836,4,60,81,810,85,870
8700,2012-01-03,1,1,1,7,0,2,1,1,0.14,0.1212,0.59,0.2537,2,30,168,1680,170,1710
8701,2012-01-03,1,1,1,8,0,2,1,1,0.16,0.1364,0.55,0.2836,5,75,349,3490,354,3565
8702,2012-01-03,1,1,1,9,0,2,1,1,0.16,0.1364,0.5,0.2836,8,120,145,1450,153,1570
8703,2012-01-03,1,1,1,10,0,2,1,1,0.16,0.1212,0.47,0.4627,5,75,55,550,60,625
8704,2012-01-03,1,1,1,11,0,2,1,1,0.18,0.1364,0.37,0.5224,12,180,63,630,75,810
8705,2012-01-03,1,1,1,12,0,2,1,1,0.18,0.1364,0.37,0.5224,4,60,70,700,74,760
8706,2012-01-03,1,1,1,13,0,2,1,1,0.18,0.1212,0.34,0.6567,5,75,68,680,73,755
8707,2012-01-03,1,1,1,14,0,2,1,1,0.16,0.1212,0.43,0.5224,7,105,72,720,79,825
8708,2012-01-03,1,1,1,15,0,2,1,1,0.16,0.1212,0.37,0.4179,9,135,68,680,77,815
8709,2012-01-03,1,1,1,16,0,2,1,1,0.14,0.0909,0.39,0.5821,7,105,129,1290,136,1395
8710,2012-01-03,1,1,1,17,0,2,1,1,0.14,0.1061,0.26,0.4627,4,60,241,2410,245,2470
8711,2012-01-03,1,1,1,18,0,2,1,1,0.14,0.0909,0.26,0.5224,10,150,214,2140,224,2290
8712,2012-01-03,1,1,1,19,0,2,1,1,0.12,0.0909,0.28,0.4179,4,60,152,1520,156,1580
8713,2012-01-03,1,1,1,20,0,2,1,1,0.12,0.1212,0.33,0.2537,0,0,115,1150,115,1150
8714,2012-01-03,1,1,1,21,0,2,1,1,0.1,0.1061,0.36,0.2239,2,30,66,660,68,690
8715,2012-01-03,1,1,1,22,0,2,1,1,0.1,0.1061,0.46,0.2537,0,0,33,330,33,330
8716,2012-01-03,1,1,1,23,0,2,1,1,0.1,0.0758,0.46,0.3881,0,0,18,180,18,180
8717,2012-01-04,1,1,1,0,0,3,1,1,0.08,0.0606,0.42,0.3284,0,0,9,90,9,90
8718,2012-01-04,1,1,1,1,0,3,1,1,0.04,0.0303,0.38,0.2985,0,0,3,30,3,30
8719,2012-01-04,1,1,1,2,0,3,1,1,0.02,0.0152,0.34,0.2836,0,0,1,10,1,10
8720,2012-01-04,1,1,1,3,0,3,1,1,0.02,0.0152,0.34,0.2836,0,0,1,10,1,10
8721,2012-01-04,1,1,1,4,0,3,1,1,0.02,0.0455,0.41,0.194,0,0,2,20,2,20
8722,2012-01-04,1,1,1,5,0,3,1,1,0.02,0.0455,0.41,0.194,0,0,14,140,14,140
8723,2012-01-04,1,1,1,6,0,3,1,1,0.02,0.0455,0.41,0.1642,0,0,59,590,59,590
8724,2012-01-04,1,1,1,7,0,3,1,1,0.02,0.0455,0.44,0.194,1,15,151,1510,152,1525
8725,2012-01-04,1,1,1,8,0,3,1,1,0.02,0.0606,0.44,0.1343,5,75,310,3100,315,3175
8726,2012-01-04,1,1,1,9,0,3,1,1,0.04,0.0606,0.45,0.1343,7,105,173,1730,180,1835
8727,2012-01-04,1,1,1,10,0,3,1,1,0.06,0.1061,0.45,0.0,7,105,57,570,64,675
8728,2012-01-04,1,1,1,11,0,3,1,2,0.08,0.1212,0.42,0.0896,6,90,40,400,46,490
8729,2012-01-04,1,1,1,12,0,3,1,2,0.1,0.1061,0.46,0.194,9,135,75,750,84,885
8730,2012-01-04,1,1,1,13,0,3,1,2,0.14,0.1212,0.43,0.2537,9,135,82,820,91,955
8731,2012-01-04,1,1,1,14,0,3,1,2,0.14,0.1212,0.46,0.2537,6,90,69,690,75,780
8732,2012-01-04,1,1,1,15,0,3,1,2,0.18,0.1515,0.37,0.3284,9,135,81,810,90,945
8733,2012-01-04,1,1,1,16,0,3,1,2,0.18,0.1667,0.4,0.2836,8,120,123,1230,131,1350
8734,2012-01-04,1,1,1,17,0,3,1,2,0.2,0.197,0.4,0.194,9,135,272,2720,281,2855
8735,2012-01-04,1,1,1,18,0,3,1,2,0.2,0.2121,0.37,0.1343,9,135,280,2800,289,2935
8736,2012-01-04,1,1,1,19,0,3,1,2,0.2,0.2273,0.4,0.1045,2,30,182,1820,184,1850
8737,2012-01-04,1,1,1,20,0,3,1,2,0.2,0.197,0.4,0.194,2,30,121,1210,123,1240
8738,2012-01-04,1,1,1,21,0,3,1,2,0.2,0.2576,0.44,0.0,2,30,88,880,90,910
8739,2012-01-04,1,1,1,22,0,3,1,2,0.2,0.2273,0.47,0.0896,4,60,48,480,52,540
8740,2012-01-04,1,1,1,23,0,3,1,2,0.2,0.2273,0.44,0.1045,0,0,32,320,32,320
8741,2012-01-05,1,1,1,0,0,4,1,2,0.22,0.2273,0.47,0.194,1,15,13,130,14,145
8742,2012-01-05,1,1,1,1,0,4,1,1,0.2,0.2273,0.51,0.0896,0,0,5,50,5,50
8743,2012-01-05,1,1,1,2,0,4,1,1,0.2,0.2273,0.51,0.0896,0,0,4,40,4,40
8744,2012-01-05,1,1,1,3,0,4,1,1,0.2,0.2576,0.61,0.0,0,0,4,40,4,40
8745,2012-01-05,1,1,1,4,0,4,1,2,0.2,0.2273,0.59,0.0896,0,0,5,50,5,50
8746,2012-01-05,1,1,1,5,0,4,1,2,0.2,0.2273,0.59,0.0896,0,0,26,260,26,260
8747,2012-01-05,1,1,1,6,0,4,1,2,0.2,0.2121,0.75,0.1343,0,0,78,780,78,780
8748,2012-01-05,1,1,1,7,0,4,1,2,0.2,0.2273,0.69,0.0896,3,45,212,2120,215,2165
8749,2012-01-05,1,1,1,8,0,4,1,2,0.2,0.2576,0.75,0.0,11,165,377,3770,388,3935
8750,2012-01-05,1,1,1,9,0,4,1,2,0.22,0.2727,0.69,0.0,7,105,220,2200,227,2305
8751,2012-01-05,1,1,1,10,0,4,1,2,0.24,0.2576,0.52,0.0896,5,75,81,810,86,885
8752,2012-01-05,1,1,1,11,0,4,1,1,0.3,0.3333,0.49,0.0,6,90,78,780,84,870
8753,2012-01-05,1,1,1,12,0,4,1,1,0.3,0.2879,0.49,0.2537,6,90,114,1140,120,1230
8754,2012-01-05,1,1,1,13,0,4,1,1,0.34,0.303,0.42,0.2985,6,90,112,1120,118,1210
8755,2012-01-05,1,1,1,14,0,4,1,1,0.34,0.3182,0.39,0.2836,13,195,104,1040,117,1235
8756,2012-01-05,1,1,1,15,0,4,1,1,0.36,0.3333,0.34,0.2836,6,90,113,1130,119,1220
8757,2012-01-05,1,1,1,16,0,4,1,1,0.36,0.3333,0.34,0.2836,19,285,178,1780,197,2065
8758,2012-01-05,1,1,1,17,0,4,1,2,0.36,0.3485,0.34,0.194,19,285,393,3930,412,4215
8759,2012-01-05,1,1,1,18,0,4,1,1,0.34,0.3333,0.36,0.1642,9,135,374,3740,383,3875
8760,2012-01-05,1,1,1,19,0,4,1,1,0.34,0.3485,0.34,0.0896,10,150,255,2550,265,2700
8761,2012-01-05,1,1,1,20,0,4,1,1,0.3,0.3333,0.49,0.0,5,75,172,1720,177,1795
8762,2012-01-05,1,1,1,21,0,4,1,1,0.26,0.2727,0.6,0.1343,9,135,88,880,97,1015
8763,2012-01-05,1,1,1,22,0,4,1,1,0.26,0.2576,0.6,0.1642,1,15,70,700,71,715
8764,2012-01-05,1,1,1,23,0,4,1,1,0.24,0.2576,0.7,0.1045,4,60,56,560,60,620
8765,2012-01-06,1,1,1,0,0,5,1,1,0.22,0.2576,0.75,0.0896,1,15,24,240,25,255
8766,2012-01-06,1,1,1,1,0,5,1,1,0.22,0.2727,0.75,0.0,2,30,6,60,8,90
8767,2012-01-06,1,1,1,2,0,5,1,1,0.22,0.2273,0.69,0.1642,2,30,3,30,5,60
8768,2012-01-06,1,1,1,3,0,5,1,1,0.22,0.2424,0.69,0.1045,1,15,3,30,4,45
8769,2012-01-06,1,1,1,4,0,5,1,1,0.22,0.2273,0.69,0.1343,0,0,3,30,3,30
8770,2012-01-06,1,1,1,5,0,5,1,2,0.2,0.2121,0.8,0.1343,0,0,13,130,13,130
8771,2012-01-06,1,1,1,6,0,5,1,2,0.22,0.2424,0.73,0.1045,1,15,69,690,70,705
8772,2012-01-06,1,1,1,7,0,5,1,2,0.24,0.2879,0.65,0.0,4,60,201,2010,205,2070
8773,2012-01-06,1,1,1,8,0,5,1,1,0.24,0.2424,0.7,0.1343,11,165,436,4360,447,4525
8774,2012-01-06,1,1,1,9,0,5,1,1,0.24,0.2424,0.7,0.1642,4,60,237,2370,241,2430
8775,2012-01-06,1,1,1,10,0,5,1,1,0.26,0.2576,0.65,0.194,14,210,102,1020,116,1230
8776,2012-01-06,1,1,1,11,0,5,1,1,0.3,0.303,0.56,0.1642,8,120,130,1300,138,1420
8777,2012-01-06,1,1,1,12,0,5,1,1,0.36,0.3333,0.5,0.2537,23,345,168,1680,191,2025
8778,2012-01-06,1,1,1,13,0,5,1,1,0.4,0.4091,0.43,0.2836,16,240,188,1880,204,2120
8779,2012-01-06,1,1,1,14,0,5,1,1,0.46,0.4545,0.36,0.194,26,390,152,1520,178,1910
8780,2012-01-06,1,1,1,15,0,5,1,1,0.52,0.5,0.27,0.2537,44,660,178,1780,222,2440
8781,2012-01-06,1,1,1,16,0,5,1,1,0.52,0.5,0.27,0.2836,35,525,259,2590,294,3115
8782,2012-01-06,1,1,1,17,0,5,1,1,0.46,0.4545,0.36,0.2239,20,300,456,4560,476,4860
8783,2012-01-06,1,1,1,18,0,5,1,1,0.5,0.4848,0.29,0.2537,28,420,391,3910,419,4330
8784,2012-01-06,1,1,1,19,0,5,1,1,0.46,0.4545,0.33,0.2836,11,165,261,2610,272,2775
8785,2012-01-06,1,1,1,20,0,5,1,1,0.42,0.4242,0.41,0.194,14,210,163,1630,177,1840
8786,2012-01-06,1,1,1,21,0,5,1,1,0.4,0.4091,0.43,0.2239,17,255,137,1370,154,1625
8787,2012-01-06,1,1,1,22,0,5,1,1,0.36,0.3485,0.5,0.194,12,180,123,1230,135,1410
8788,2012-01-06,1,1,1,23,0,5,1,1,0.36,0.3788,0.5,0.0,13,195,88,880,101,1075
8789,2012-01-07,1,1,1,0,0,6,0,1,0.36,0.3485,0.5,0.1642,2,30,77,770,79,800
8790,2012-01-07,1,1,1,1,0,6,0,1,0.38,0.3939,0.46,0.1642,6,90,56,560,62,650
8791,2012-01-07,1,1,1,2,0,6,0,1,0.36,0.3636,0.5,0.1045,2,30,36,360,38,390
8792,2012-01-07,1,1,1,3,0,6,0,1,0.32,0.3333,0.57,0.1045,1,15,19,190,20,205
8793,2012-01-07,1,1,1,4,0,6,0,1,0.32,0.3333,0.57,0.0896,1,15,9,90,10,105
8794,2012-01-07,1,1,1,5,0,6,0,1,0.26,0.2727,0.75,0.1045,2,30,7,70,9,100
8795,2012-01-07,1,1,1,6,0,6,0,1,0.26,0.2727,0.75,0.1045,0,0,7,70,7,70
8796,2012-01-07,1,1,1,7,0,6,0,1,0.22,0.2273,0.87,0.194,0,0,20,200,20,200
8797,2012-01-07,1,1,1,8,0,6,0,1,0.24,0.2576,0.75,0.1045,0,0,64,640,64,640
8798,2012-01-07,1,1,1,9,0,6,0,1,0.22,0.2273,0.8,0.1343,14,210,116,1160,130,1370
8799,2012-01-07,1,1,1,10,0,6,0,1,0.28,0.303,0.75,0.0896,43,645,160,1600,203,2245
8800,2012-01-07,1,1,1,11,0,6,0,1,0.34,0.3182,0.57,0.2239,74,1110,250,2500,324,3610
8801,2012-01-07,1,1,1,12,0,6,0,1,0.4,0.4091,0.43,0.2239,100,1500,276,2760,376,4260
8802,2012-01-07,1,1,1,13,0,6,0,1,0.44,0.4394,0.44,0.194,149,2235,296,2960,445,5195
8803,2012-01-07,1,1,1,14,0,6,0,1,0.5,0.4848,0.42,0.2836,156,2340,356,3560,512,5900
8804,2012-01-07,1,1,1,15,0,6,0,1,0.58,0.5455,0.37,0.2985,132,1980,317,3170,449,5150
8805,2012-01-07,1,1,1,16,0,6,0,2,0.56,0.5303,0.37,0.2836,133,1995,268,2680,401,4675
8806,2012-01-07,1,1,1,17,0,6,0,2,0.54,0.5152,0.43,0.1343,87,1305,235,2350,322,3655
8807,2012-01-07,1,1,1,18,0,6,0,1,0.54,0.5152,0.45,0.1343,49,735,248,2480,297,3215
8808,2012-01-07,1,1,1,19,0,6,0,1,0.52,0.5,0.42,0.1045,44,660,171,1710,215,2370
8809,2012-01-07,1,1,1,20,0,6,0,1,0.5,0.4848,0.39,0.2537,21,315,149,1490,170,1805
8810,2012-01-07,1,1,1,21,0,6,0,1,0.44,0.4394,0.44,0.2239,22,330,118,1180,140,1510
8811,2012-01-07,1,1,1,22,0,6,0,1,0.44,0.4394,0.38,0.2537,16,240,93,930,109,1170
8812,2012-01-07,1,1,1,23,0,6,0,1,0.42,0.4242,0.38,0.2239,16,240,103,1030,119,1270
8813,2012-01-08,1,1,1,0,0,0,0,1,0.38,0.3939,0.4,0.2836,14,210,77,770,91,980
8814,2012-01-08,1,1,1,1,0,0,0,1,0.34,0.3333,0.42,0.194,10,150,62,620,72,770
8815,2012-01-08,1,1,1,2,0,0,0,1,0.36,0.3333,0.37,0.2836,10,150,57,570,67,720
8816,2012-01-08,1,1,1,3,0,0,0,1,0.34,0.3333,0.42,0.1343,6,90,26,260,32,350
8817,2012-01-08,1,1,1,4,0,0,0,1,0.32,0.303,0.49,0.2537,2,30,4,40,6,70
8818,2012-01-08,1,1,1,5,0,0,0,2,0.32,0.3333,0.49,0.1045,0,0,2,20,2,20
8819,2012-01-08,1,1,1,6,0,0,0,2,0.3,0.3333,0.52,0.0,0,0,2,20,2,20
8820,2012-01-08,1,1,1,7,0,0,0,2,0.3,0.3333,0.52,0.0,1,15,23,230,24,245
8821,2012-01-08,1,1,1,8,0,0,0,1,0.3,0.303,0.52,0.1343,4,60,53,530,57,590
8822,2012-01-08,1,1,1,9,0,0,0,1,0.32,0.3333,0.53,0.1343,23,345,102,1020,125,1365
8823,2012-01-08,1,1,1,10,0,0,0,1,0.34,0.3333,0.49,0.1642,27,405,181,1810,208,2215
8824,2012-01-08,1,1,1,11,0,0,0,1,0.36,0.3485,0.46,0.2239,55,825,201,2010,256,2835
8825,2012-01-08,1,1,1,12,0,0,0,1,0.38,0.3939,0.43,0.2239,78,1170,273,2730,351,3900
8826,2012-01-08,1,1,1,13,0,0,0,1,0.4,0.4091,0.37,0.2985,77,1155,266,2660,343,3815
8827,2012-01-08,1,1,1,14,0,0,0,1,0.4,0.4091,0.4,0.194,75,1125,253,2530,328,3655
8828,2012-01-08,1,1,1,15,0,0,0,1,0.4,0.4091,0.37,0.2836,89,1335,241,2410,330,3745
8829,2012-01-08,1,1,1,16,0,0,0,1,0.4,0.4091,0.37,0.2985,58,870,256,2560,314,3430
8830,2012-01-08,1,1,1,17,0,0,0,1,0.38,0.3939,0.4,0.2239,22,330,197,1970,219,2300
8831,2012-01-08,1,1,1,18,0,0,0,1,0.34,0.3182,0.46,0.2239,19,285,162,1620,181,1905
8832,2012-01-08,1,1,1,19,0,0,0,1,0.32,0.3182,0.49,0.194,8,120,104,1040,112,1160
8833,2012-01-08,1,1,1,20,0,0,0,1,0.3,0.303,0.52,0.1642,7,105,119,1190,126,1295
8834,2012-01-08,1,1,1,21,0,0,0,1,0.28,0.2727,0.56,0.2239,10,150,81,810,91,960
8835,2012-01-08,1,1,1,22,0,0,0,1,0.26,0.2727,0.6,0.1045,4,60,54,540,58,600
8836,2012-01-08,1,1,1,23,0,0,0,1,0.26,0.2424,0.56,0.2537,0,0,30,300,30,300
8837,2012-01-09,1,1,1,0,0,1,1,1,0.24,0.2273,0.6,0.2239,3,45,12,120,15,165
8838,2012-01-09,1,1,1,1,0,1,1,1,0.24,0.2424,0.6,0.1343,1,15,4,40,5,55
8839,2012-01-09,1,1,1,2,0,1,1,1,0.24,0.2424,0.56,0.1343,2,30,3,30,5,60
8840,2012-01-09,1,1,1,3,0,1,1,1,0.24,0.2424,0.52,0.1642,0,0,3,30,3,30
8841,2012-01-09,1,1,1,4,0,1,1,1,0.22,0.2424,0.64,0.1045,0,0,4,40,4,40
8842,2012-01-09,1,1,1,5,0,1,1,2,0.2,0.2273,0.64,0.0896,0,0,21,210,21,210
8843,2012-01-09,1,1,1,6,0,1,1,2,0.22,0.2273,0.6,0.1343,3,45,85,850,88,895
8844,2012-01-09,1,1,1,7,0,1,1,2,0.22,0.2424,0.6,0.1045,1,15,239,2390,240,2405
8845,2012-01-09,1,1,1,8,0,1,1,2,0.22,0.2576,0.55,0.0896,13,195,407,4070,420,4265
8846,2012-01-09,1,1,1,9,0,1,1,2,0.22,0.2727,0.64,0.0,9,135,188,1880,197,2015
8847,2012-01-09,1,1,1,10,0,1,1,1,0.24,0.2879,0.6,0.0,13,195,95,950,108,1145
8848,2012-01-09,1,1,1,11,0,1,1,2,0.26,0.2879,0.56,0.0896,6,90,82,820,88,910
8849,2012-01-09,1,1,1,12,0,1,1,2,0.26,0.2727,0.56,0.1045,10,150,93,930,103,1080
8850,2012-01-09,1,1,1,13,0,1,1,2,0.26,0.2727,0.56,0.1045,3,45,77,770,80,815
8851,2012-01-09,1,1,1,14,0,1,1,3,0.22,0.2273,0.75,0.1642,5,75,45,450,50,525
8852,2012-01-09,1,1,1,15,0,1,1,3,0.22,0.2273,0.75,0.1642,5,75,64,640,69,715
8853,2012-01-09,1,1,1,16,0,1,1,3,0.22,0.2576,0.87,0.0896,3,45,46,460,49,505
8854,2012-01-09,1,1,1,17,0,1,1,3,0.22,0.2727,0.87,0.0,5,75,147,1470,152,1545
8855,2012-01-09,1,1,1,18,0,1,1,4,0.2,0.2273,0.86,0.0896,6,90,158,1580,164,1670
8856,2012-01-09,1,1,1,19,0,1,1,3,0.2,0.2273,0.93,0.0896,3,45,187,1870,190,1915
8857,2012-01-09,1,1,1,20,0,1,1,2,0.2,0.2273,0.86,0.0896,5,75,127,1270,132,1345
8858,2012-01-09,1,1,1,21,0,1,1,2,0.2,0.2576,0.93,0.0,1,15,78,780,79,795
8859,2012-01-09,1,1,1,22,0,1,1,2,0.2,0.2273,0.92,0.1045,8,120,54,540,62,660
8860,2012-01-09,1,1,1,23,0,1,1,2,0.22,0.2424,0.87,0.1045,1,15,51,510,52,525
8861,2012-01-10,1,1,1,0,0,2,1,2,0.22,0.2424,0.87,0.1045,0,0,14,140,14,140
8862,2012-01-10,1,1,1,1,0,2,1,2,0.22,0.2424,0.93,0.1045,2,30,3,30,5,60
8863,2012-01-10,1,1,1,2,0,2,1,2,0.22,0.2273,0.87,0.1642,2,30,2,20,4,50
8864,2012-01-10,1,1,1,4,0,2,1,2,0.2,0.2121,0.86,0.1642,0,0,4,40,4,40
8865,2012-01-10,1,1,1,5,0,2,1,1,0.4,0.4091,0.47,0.2239,0,0,23,230,23,230
8866,2012-01-10,1,1,1,6,0,2,1,2,0.18,0.1818,0.93,0.194,0,0,79,790,79,790
8867,2012-01-10,1,1,1,7,0,2,1,2,0.18,0.197,0.93,0.1642,3,45,219,2190,222,2235
8868,2012-01-10,1,1,1,8,0,2,1,2,0.18,0.197,0.93,0.1642,6,90,465,4650,471,4740
8869,2012-01-10,1,1,1,9,0,2,1,2,0.18,0.197,0.93,0.1642,11,165,184,1840,195,2005
8870,2012-01-10,1,1,1,10,0,2,1,2,0.18,0.197,0.93,0.1642,3,45,80,800,83,845
8871,2012-01-10,1,1,1,11,0,2,1,1,0.42,0.4242,0.38,0.2985,8,120,93,930,101,1050
8872,2012-01-10,1,1,1,12,0,2,1,1,0.42,0.4242,0.38,0.2985,13,195,127,1270,140,1465
8873,2012-01-10,1,1,1,13,0,2,1,1,0.42,0.4242,0.38,0.2985,15,225,163,1630,178,1855
8874,2012-01-10,1,1,1,14,0,2,1,1,0.42,0.4242,0.38,0.2985,10,150,96,960,106,1110
8875,2012-01-10,1,1,1,15,0,2,1,1,0.42,0.4242,0.38,0.2985,17,255,119,1190,136,1445
8876,2012-01-10,1,1,1,16,0,2,1,1,0.42,0.4242,0.38,0.3582,15,225,225,2250,240,2475
8877,2012-01-10,1,1,1,17,0,2,1,1,0.42,0.4242,0.38,0.2537,14,210,446,4460,460,4670
8878,2012-01-10,1,1,1,18,0,2,1,1,0.4,0.4091,0.4,0.1045,13,195,372,3720,385,3915
8879,2012-01-10,1,1,1,19,0,2,1,1,0.38,0.3939,0.46,0.1045,11,165,270,2700,281,2865
8880,2012-01-10,1,1,1,20,0,2,1,1,0.34,0.3485,0.53,0.1045,10,150,190,1900,200,2050
8881,2012-01-10,1,1,1,21,0,2,1,1,0.32,0.3333,0.66,0.0896,7,105,109,1090,116,1195
8882,2012-01-10,1,1,1,22,0,2,1,1,0.3,0.303,0.7,0.0896,10,150,104,1040,114,1190
8883,2012-01-10,1,1,1,23,0,2,1,1,0.26,0.2727,0.81,0.1045,3,45,38,380,41,425
8884,2012-01-11,1,1,1,0,0,3,1,1,0.26,0.303,0.81,0.0,2,30,26,260,28,290
8885,2012-01-11,1,1,1,1,0,3,1,1,0.24,0.2576,0.87,0.0896,1,15,6,60,7,75
8886,2012-01-11,1,1,1,2,0,3,1,1,0.2,0.2121,0.85,0.1642,0,0,5,50,5,50
8887,2012-01-11,1,1,1,3,0,3,1,1,0.22,0.2727,0.8,0.0,0,0,4,40,4,40
8888,2012-01-11,1,1,1,4,0,3,1,1,0.2,0.2121,0.8,0.1343,0,0,2,20,2,20
8889,2012-01-11,1,1,1,5,0,3,1,1,0.2,0.2121,0.8,0.1343,0,0,22,220,22,220
8890,2012-01-11,1,1,1,6,0,3,1,1,0.2,0.2121,0.86,0.1343,2,30,72,720,74,750
8891,2012-01-11,1,1,1,7,0,3,1,1,0.2,0.2121,0.8,0.1343,9,135,247,2470,256,2605
8892,2012-01-11,1,1,1,8,0,3,1,1,0.2,0.2273,0.82,0.1045,11,165,488,4880,499,5045
8893,2012-01-11,1,1,1,9,0,3,1,2,0.2,0.2121,0.86,0.1343,7,105,218,2180,225,2285
8894,2012-01-11,1,1,1,10,0,3,1,2,0.24,0.2424,0.87,0.1343,13,195,84,840,97,1035
8895,2012-01-11,1,1,1,11,0,3,1,2,0.26,0.2879,0.87,0.0896,9,135,90,900,99,1035
8896,2012-01-11,1,1,1,12,0,3,1,3,0.3,0.3333,0.81,0.0,4,60,51,510,55,570
8897,2012-01-11,1,1,1,13,0,3,1,3,0.32,0.3485,0.76,0.0,8,120,57,570,65,690
8898,2012-01-11,1,1,1,14,0,3,1,3,0.32,0.3333,0.81,0.1045,3,45,70,700,73,745
8899,2012-01-11,1,1,1,15,0,3,1,2,0.34,0.3485,0.87,0.0896,6,90,73,730,79,820
8900,2012-01-11,1,1,1,16,0,3,1,2,0.34,0.3182,0.87,0.2537,6,90,112,1120,118,1210
8901,2012-01-11,1,1,1,17,0,3,1,3,0.34,0.3182,0.87,0.2239,6,90,128,1280,134,1370
8902,2012-01-11,1,1,1,18,0,3,1,3,0.34,0.3333,0.87,0.194,2,30,96,960,98,990
8903,2012-01-11,1,1,1,19,0,3,1,3,0.32,0.303,0.93,0.2239,1,15,92,920,93,935
8904,2012-01-11,1,1,1,20,0,3,1,3,0.32,0.3182,0.93,0.1642,2,30,55,550,57,580
8905,2012-01-11,1,1,1,21,0,3,1,3,0.34,0.3182,0.87,0.2239,0,0,29,290,29,290
8906,2012-01-11,1,1,1,22,0,3,1,3,0.34,0.3333,0.87,0.194,0,0,49,490,49,490
8907,2012-01-11,1,1,1,23,0,3,1,3,0.34,0.3182,0.87,0.2239,0,0,9,90,9,90
8908,2012-01-12,1,1,1,0,0,4,1,3,0.34,0.3333,0.93,0.194,0,0,3,30,3,30
8909,2012-01-12,1,1,1,1,0,4,1,3,0.36,0.3485,0.93,0.194,0,0,3,30,3,30
8910,2012-01-12,1,1,1,2,0,4,1,3,0.36,0.3485,0.93,0.2537,1,15,1,10,2,25
8911,2012-01-12,1,1,1,3,0,4,1,3,0.36,0.3485,0.93,0.2537,0,0,3,30,3,30
8912,2012-01-12,1,1,1,4,0,4,1,3,0.36,0.3485,0.93,0.194,0,0,2,20,2,20
8913,2012-01-12,1,1,1,5,0,4,1,3,0.34,0.3485,0.93,0.0896,0,0,16,160,16,160
8914,2012-01-12,1,1,1,6,0,4,1,3,0.36,0.3485,0.93,0.1343,1,15,88,880,89,895
8915,2012-01-12,1,1,1,7,0,4,1,2,0.34,0.3182,0.87,0.2836,2,30,218,2180,220,2210
8916,2012-01-12,1,1,1,8,0,4,1,1,0.32,0.3182,0.81,0.194,11,165,497,4970,508,5135
8917,2012-01-12,1,1,1,9,0,4,1,1,0.32,0.3333,0.81,0.1045,10,150,220,2200,230,2350
8918,2012-01-12,1,1,1,10,0,4,1,1,0.34,0.3485,0.81,0.1045,6,90,84,840,90,930
8919,2012-01-12,1,1,1,11,0,4,1,2,0.34,0.3485,0.81,0.1045,18,270,101,1010,119,1280
8920,2012-01-12,1,1,1,12,0,4,1,2,0.34,0.3485,0.81,0.1045,14,210,130,1300,144,1510
8921,2012-01-12,1,1,1,13,0,4,1,1,0.42,0.4242,0.77,0.1642,13,195,170,1700,183,1895
8922,2012-01-12,1,1,1,14,0,4,1,1,0.42,0.4242,0.77,0.1642,24,360,132,1320,156,1680
8923,2012-01-12,1,1,1,15,0,4,1,1,0.44,0.4394,0.72,0.1343,32,480,156,1560,188,2040
8924,2012-01-12,1,1,1,16,0,4,1,1,0.46,0.4545,0.67,0.194,33,495,248,2480,281,2975
8925,2012-01-12,1,1,1,17,0,4,1,1,0.46,0.4545,0.63,0.1642,23,345,472,4720,495,5065
8926,2012-01-12,1,1,1,18,0,4,1,1,0.44,0.4394,0.67,0.194,22,330,399,3990,421,4320
8927,2012-01-12,1,1,1,19,0,4,1,2,0.42,0.4242,0.71,0.1642,17,255,313,3130,330,3385
8928,2012-01-12,1,1,1,20,0,4,1,2,0.42,0.4242,0.71,0.194,11,165,229,2290,240,2455
8929,2012-01-12,1,1,1,21,0,4,1,1,0.44,0.4394,0.67,0.1343,12,180,162,1620,174,1800
8930,2012-01-12,1,1,1,22,0,4,1,1,0.38,0.3939,0.76,0.2985,12,180,121,1210,133,1390
8931,2012-01-12,1,1,1,23,0,4,1,1,0.4,0.4091,0.76,0.3284,7,105,60,600,67,705
8932,2012-01-13,1,1,1,0,0,5,1,2,0.4,0.4091,0.71,0.2836,4,60,38,380,42,440
8933,2012-01-13,1,1,1,1,0,5,1,2,0.38,0.3939,0.76,0.2985,0,0,12,120,12,120
8934,2012-01-13,1,1,1,2,0,5,1,1,0.4,0.4091,0.76,0.3582,1,15,13,130,14,145
8935,2012-01-13,1,1,1,3,0,5,1,1,0.36,0.3333,0.87,0.2537,3,45,4,40,7,85
8936,2012-01-13,1,1,1,4,0,5,1,3,0.32,0.2879,0.7,0.4925,1,15,2,20,3,35
8937,2012-01-13,1,1,1,5,0,5,1,2,0.3,0.2424,0.7,0.5522,0,0,21,210,21,210
8938,2012-01-13,1,1,1,6,0,5,1,2,0.26,0.2576,0.75,0.2239,2,30,71,710,73,740
8939,2012-01-13,1,1,1,7,0,5,1,1,0.26,0.2576,0.6,0.2239,3,45,174,1740,177,1785
8940,2012-01-13,1,1,1,8,0,5,1,1,0.24,0.2121,0.52,0.3582,11,165,408,4080,419,4245
8941,2012-01-13,1,1,1,9,0,5,1,1,0.22,0.197,0.47,0.3881,10,150,204,2040,214,2190
8942,2012-01-13,1,1,1,10,0,5,1,1,0.24,0.197,0.44,0.4478,2,30,101,1010,103,1040
8943,2012-01-13,1,1,1,11,0,5,1,1,0.24,0.1818,0.38,0.6119,12,180,102,1020,114,1200
8944,2012-01-13,1,1,1,12,0,5,1,1,0.24,0.197,0.38,0.4925,14,210,140,1400,154,1610
8945,2012-01-13,1,1,1,13,0,5,1,1,0.26,0.2121,0.33,0.5224,14,210,140,1400,154,1610
8946,2012-01-13,1,1,1,14,0,5,1,1,0.26,0.2121,0.33,0.5522,10,150,119,1190,129,1340
8947,2012-01-13,1,1,1,15,0,5,1,1,0.26,0.2121,0.33,0.5821,15,225,123,1230,138,1455
8948,2012-01-13,1,1,1,16,0,5,1,1,0.28,0.2424,0.3,0.4627,18,270,215,2150,233,2420
8949,2012-01-13,1,1,1,17,0,5,1,1,0.28,0.2424,0.33,0.4179,15,225,317,3170,332,3395
8950,2012-01-13,1,1,1,18,0,5,1,1,0.26,0.2273,0.38,0.2985,7,105,294,2940,301,3045
8951,2012-01-13,1,1,1,19,0,5,1,1,0.26,0.2424,0.38,0.2836,7,105,199,1990,206,2095
8952,2012-01-13,1,1,1,20,0,5,1,1,0.24,0.2424,0.41,0.1642,6,90,130,1300,136,1390
8953,2012-01-13,1,1,1,21,0,5,1,1,0.24,0.2121,0.41,0.2836,7,105,95,950,102,1055
8954,2012-01-13,1,1,1,22,0,5,1,1,0.2,0.1818,0.47,0.3284,7,105,58,580,65,685
8955,2012-01-13,1,1,1,23,0,5,1,1,0.18,0.1818,0.47,0.194,5,75,60,600,65,675
8956,2012-01-14,1,1,1,0,0,6,0,1,0.16,0.1818,0.47,0.1045,2,30,42,420,44,450
8957,2012-01-14,1,1,1,1,0,6,0,1,0.16,0.1515,0.47,0.194,6,90,44,440,50,530
8958,2012-01-14,1,1,1,2,0,6,0,1,0.16,0.1667,0.47,0.1642,6,90,32,320,38,410
8959,2012-01-14,1,1,1,3,0,6,0,1,0.14,0.1667,0.54,0.1045,6,90,14,140,20,230
8960,2012-01-14,1,1,1,4,0,6,0,1,0.14,0.1515,0.5,0.1343,0,0,3,30,3,30
8961,2012-01-14,1,1,1,5,0,6,0,1,0.14,0.1515,0.5,0.1343,0,0,4,40,4,40
8962,2012-01-14,1,1,1,6,0,6,0,1,0.14,0.1515,0.5,0.0,0,0,5,50,5,50
8963,2012-01-14,1,1,1,7,0,6,0,1,0.14,0.1515,0.5,0.1343,0,0,24,240,24,240
8964,2012-01-14,1,1,1,8,0,6,0,1,0.12,0.1515,0.54,0.1045,3,45,89,890,92,935
8965,2012-01-14,1,1,1,9,0,6,0,1,0.14,0.1667,0.5,0.1045,3,45,78,780,81,825
8966,2012-01-14,1,1,1,10,0,6,0,1,0.16,0.2273,0.47,0.0,14,210,135,1350,149,1560
8967,2012-01-14,1,1,1,11,0,6,0,1,0.2,0.197,0.4,0.194,28,420,150,1500,178,1920
8968,2012-01-14,1,1,1,12,0,6,0,1,0.22,0.2121,0.41,0.2537,30,450,189,1890,219,2340
8969,2012-01-14,1,1,1,13,0,6,0,1,0.22,0.2121,0.44,0.2836,38,570,182,1820,220,2390
8970,2012-01-14,1,1,1,14,0,6,0,1,0.24,0.2121,0.41,0.2985,52,780,179,1790,231,2570
8971,2012-01-14,1,1,1,15,0,6,0,1,0.24,0.2121,0.38,0.2985,49,735,177,1770,226,2505
8972,2012-01-14,1,1,1,16,0,6,0,1,0.24,0.2273,0.38,0.2239,28,420,178,1780,206,2200
8973,2012-01-14,1,1,1,17,0,6,0,1,0.24,0.2273,0.41,0.2537,15,225,129,1290,144,1515
8974,2012-01-14,1,1,1,18,0,6,0,1,0.22,0.2273,0.41,0.194,21,315,122,1220,143,1535
8975,2012-01-14,1,1,1,19,0,6,0,1,0.2,0.197,0.47,0.2239,12,180,90,900,102,1080
8976,2012-01-14,1,1,1,20,0,6,0,1,0.2,0.197,0.44,0.2537,8,120,95,950,103,1070
8977,2012-01-14,1,1,1,21,0,6,0,1,0.18,0.1667,0.43,0.2537,3,45,66,660,69,705
8978,2012-01-14,1,1,1,22,0,6,0,1,0.16,0.1364,0.47,0.3582,4,60,62,620,66,680
8979,2012-01-14,1,1,1,23,0,6,0,1,0.16,0.1515,0.47,0.2239,5,75,71,710,76,785
8980,2012-01-15,1,1,1,0,0,0,0,1,0.16,0.1364,0.47,0.3284,9,135,50,500,59,635
8981,2012-01-15,1,1,1,1,0,0,0,2,0.16,0.1364,0.47,0.2985,2,30,40,400,42,430
8982,2012-01-15,1,1,1,2,0,0,0,2,0.16,0.1364,0.47,0.2836,5,75,38,380,43,455
8983,2012-01-15,1,1,1,3,0,0,0,2,0.16,0.1364,0.48,0.3881,1,15,24,240,25,255
8984,2012-01-15,1,1,1,4,0,0,0,2,0.16,0.1364,0.47,0.3881,1,15,5,50,6,65
8985,2012-01-15,1,1,1,5,0,0,0,2,0.16,0.1364,0.47,0.3284,0,0,5,50,5,50
8986,2012-01-15,1,1,1,6,0,0,0,2,0.14,0.1212,0.5,0.2836,1,15,7,70,8,85
8987,2012-01-15,1,1,1,7,0,0,0,1,0.12,0.1212,0.54,0.2836,3,45,14,140,17,185
8988,2012-01-15,1,1,1,8,0,0,0,1,0.12,0.1212,0.54,0.2239,2,30,34,340,36,370
8989,2012-01-15,1,1,1,9,0,0,0,1,0.12,0.1364,0.54,0.194,10,150,80,800,90,950
8990,2012-01-15,1,1,1,10,0,0,0,1,0.14,0.1212,0.54,0.2836,11,165,115,1150,126,1315
8991,2012-01-15,1,1,1,11,0,0,0,1,0.16,0.1515,0.47,0.2239,21,315,144,1440,165,1755
8992,2012-01-15,1,1,1,12,0,0,0,1,0.18,0.1667,0.4,0.2985,42,630,192,1920,234,2550
8993,2012-01-15,1,1,1,13,0,0,0,1,0.2,0.1818,0.34,0.2836,40,600,184,1840,224,2440
8994,2012-01-15,1,1,1,14,0,0,0,1,0.2,0.1818,0.32,0.3582,25,375,163,1630,188,2005
8995,2012-01-15,1,1,1,15,0,0,0,1,0.22,0.2273,0.27,0.194,33,495,173,1730,206,2225
8996,2012-01-15,1,1,1,16,0,0,0,1,0.22,0.2121,0.29,0.2985,31,465,174,1740,205,2205
8997,2012-01-15,1,1,1,17,0,0,0,1,0.22,0.2121,0.25,0.2537,15,225,131,1310,146,1535
8998,2012-01-15,1,1,1,18,0,0,0,1,0.18,0.1818,0.29,0.2239,7,105,113,1130,120,1235
8999,2012-01-15,1,1,1,19,0,0,0,1,0.16,0.1667,0.37,0.1642,9,135,101,1010,110,1145
9000,2012-01-15,1,1,1,20,0,0,0,1,0.16,0.1818,0.37,0.1045,10,150,85,850,95,1000
9001,2012-01-15,1,1,1,21,0,0,0,1,0.16,0.1667,0.4,0.1642,1,15,71,710,72,725
9002,2012-01-15,1,1,1,22,0,0,0,1,0.18,0.2121,0.37,0.0896,2,30,58,580,60,610
9003,2012-01-15,1,1,1,23,0,0,0,1,0.16,0.197,0.43,0.0896,3,45,26,260,29,305
9004,2012-01-16,1,1,1,0,1,1,0,1,0.14,0.1515,0.46,0.1343,2,30,23,230,25,260
9005,2012-01-16,1,1,1,1,1,1,0,1,0.14,0.1667,0.43,0.1045,2,30,18,180,20,210
9006,2012-01-16,1,1,1,2,1,1,0,1,0.14,0.2121,0.46,0.0,3,45,14,140,17,185
9007,2012-01-16,1,1,1,3,1,1,0,1,0.12,0.197,0.5,0.0,0,0,3,30,3,30
9008,2012-01-16,1,1,1,4,1,1,0,1,0.12,0.1515,0.58,0.1045,2,30,6,60,8,90
9009,2012-01-16,1,1,1,5,1,1,0,1,0.12,0.1667,0.54,0.0896,1,15,5,50,6,65
9010,2012-01-16,1,1,1,6,1,1,0,1,0.1,0.1364,0.54,0.0896,0,0,13,130,13,130
9011,2012-01-16,1,1,1,7,1,1,0,1,0.1,0.1364,0.54,0.1045,5,75,28,280,33,355
9012,2012-01-16,1,1,1,8,1,1,0,1,0.1,0.1212,0.58,0.1642,3,45,75,750,78,795
9013,2012-01-16,1,1,1,9,1,1,0,1,0.1,0.1212,0.58,0.1642,7,105,89,890,96,995
9014,2012-01-16,1,1,1,10,1,1,0,2,0.14,0.1364,0.59,0.194,19,285,107,1070,126,1355
9015,2012-01-16,1,1,1,11,1,1,0,1,0.16,0.1515,0.59,0.2537,21,315,158,1580,179,1895
9016,2012-01-16,1,1,1,12,1,1,0,1,0.2,0.1818,0.55,0.3284,20,300,165,1650,185,1950
9017,2012-01-16,1,1,1,13,1,1,0,2,0.24,0.197,0.41,0.4179,26,390,202,2020,228,2410
9018,2012-01-16,1,1,1,14,1,1,0,1,0.24,0.2121,0.44,0.3881,23,345,158,1580,181,1925
9019,2012-01-16,1,1,1,15,1,1,0,1,0.26,0.2121,0.44,0.4478,17,255,175,1750,192,2005
9020,2012-01-16,1,1,1,16,1,1,0,1,0.26,0.2273,0.44,0.3582,22,330,158,1580,180,1910
9021,2012-01-16,1,1,1,17,1,1,0,1,0.26,0.2273,0.48,0.3284,19,285,174,1740,193,2025
9022,2012-01-16,1,1,1,18,1,1,0,1,0.26,0.2273,0.52,0.3284,6,90,175,1750,181,1840
9023,2012-01-16,1,1,1,19,1,1,0,1,0.26,0.2424,0.56,0.2836,10,150,134,1340,144,1490
9024,2012-01-16,1,1,1,20,1,1,0,1,0.26,0.2424,0.6,0.2836,2,30,88,880,90,910
9025,2012-01-16,1,1,1,21,1,1,0,1,0.28,0.2576,0.52,0.3284,3,45,46,460,49,505
9026,2012-01-16,1,1,1,22,1,1,0,2,0.3,0.2727,0.49,0.3582,4,60,39,390,43,450
9027,2012-01-16,1,1,1,23,1,1,0,3,0.26,0.2273,0.7,0.2985,0,0,28,280,28,280
9028,2012-01-17,1,1,1,0,0,2,1,2,0.26,0.2273,0.7,0.3284,0,0,12,120,12,120
9029,2012-01-17,1,1,1,1,0,2,1,2,0.28,0.2576,0.65,0.3582,0,0,2,20,2,20
9030,2012-01-17,1,1,1,2,0,2,1,3,0.28,0.2727,0.75,0.2537,0,0,12,120,12,120
9031,2012-01-17,1,1,1,4,0,2,1,3,0.32,0.303,0.66,0.3284,0,0,2,20,2,20
9032,2012-01-17,1,1,1,5,0,2,1,3,0.32,0.303,0.66,0.3284,0,0,13,130,13,130
9033,2012-01-17,1,1,1,6,0,2,1,3,0.3,0.2879,0.75,0.2537,0,0,57,570,57,570
9034,2012-01-17,1,1,1,7,0,2,1,3,0.3,0.2879,0.81,0.2239,5,75,121,1210,126,1285
9035,2012-01-17,1,1,1,8,0,2,1,3,0.3,0.2879,0.81,0.2836,3,45,90,900,93,945
9036,2012-01-17,1,1,1,9,0,2,1,3,0.32,0.303,0.81,0.2537,7,105,61,610,68,715
9037,2012-01-17,1,1,1,10,0,2,1,3,0.3,0.2879,0.87,0.2537,1,15,61,610,62,625
9038,2012-01-17,1,1,1,11,0,2,1,2,0.34,0.3485,0.87,0.1045,2,30,73,730,75,760
9039,2012-01-17,1,1,1,12,0,2,1,2,0.32,0.303,0.87,0.2836,3,45,83,830,86,875
9040,2012-01-17,1,1,1,13,0,2,1,2,0.38,0.3939,0.76,0.3284,8,120,95,950,103,1070
9041,2012-01-17,1,1,1,14,0,2,1,1,0.44,0.4394,0.62,0.4925,12,180,120,1200,132,1380
9042,2012-01-17,1,1,1,15,0,2,1,1,0.44,0.4394,0.62,0.4925,6,90,123,1230,129,1320
9043,2012-01-17,1,1,1,16,0,2,1,1,0.46,0.4545,0.63,0.5522,14,210,205,2050,219,2260
9044,2012-01-17,1,1,1,17,0,2,1,1,0.46,0.4545,0.63,0.4478,20,300,442,4420,462,4720
9045,2012-01-17,1,1,1,18,0,2,1,1,0.46,0.4545,0.63,0.4478,12,180,451,4510,463,4690
9046,2012-01-17,1,1,1,19,0,2,1,1,0.46,0.4545,0.63,0.4179,11,165,297,2970,308,3135
9047,2012-01-17,1,1,1,20,0,2,1,1,0.46,0.4545,0.63,0.3582,11,165,169,1690,180,1855
9048,2012-01-17,1,1,1,21,0,2,1,1,0.46,0.4545,0.67,0.4627,6,90,174,1740,180,1830
9049,2012-01-17,1,1,1,22,0,2,1,1,0.46,0.4545,0.72,0.3881,5,75,85,850,90,925
9050,2012-01-17,1,1,1,23,0,2,1,1,0.46,0.4545,0.72,0.3881,1,15,60,600,61,615
9051,2012-01-18,1,1,1,0,0,3,1,2,0.46,0.4545,0.77,0.3284,3,45,14,140,17,185
9052,2012-01-18,1,1,1,1,0,3,1,2,0.46,0.4545,0.77,0.3284,0,0,10,100,10,100
9053,2012-01-18,1,1,1,2,0,3,1,2,0.44,0.4394,0.51,0.4925,1,15,1,10,2,25
9054,2012-01-18,1,1,1,3,0,3,1,2,0.44,0.4394,0.51,0.4925,1,15,3,30,4,45
9055,2012-01-18,1,1,1,4,0,3,1,1,0.34,0.2879,0.46,0.5224,0,0,1,10,1,10
9056,2012-01-18,1,1,1,5,0,3,1,1,0.34,0.2879,0.46,0.5224,0,0,29,290,29,290
9057,2012-01-18,1,1,1,6,0,3,1,1,0.34,0.2879,0.36,0.5224,0,0,88,880,88,880
9058,2012-01-18,1,1,1,7,0,3,1,1,0.32,0.2879,0.42,0.3582,1,15,262,2620,263,2635
9059,2012-01-18,1,1,1,8,0,3,1,1,0.3,0.2727,0.52,0.4179,15,225,474,4740,489,4965
9060,2012-01-18,1,1,1,9,0,3,1,1,0.28,0.2576,0.52,0.3284,6,90,196,1960,202,2050
9061,2012-01-18,1,1,1,10,0,3,1,1,0.3,0.2727,0.42,0.4627,5,75,88,880,93,955
9062,2012-01-18,1,1,1,11,0,3,1,1,0.3,0.2727,0.42,0.3881,4,60,110,1100,114,1160
9063,2012-01-18,1,1,1,12,0,3,1,1,0.3,0.2576,0.39,0.4925,6,90,155,1550,161,1640
9064,2012-01-18,1,1,1,13,0,3,1,1,0.3,0.2727,0.42,0.4627,6,90,124,1240,130,1330
9065,2012-01-18,1,1,1,14,0,3,1,1,0.3,0.2727,0.33,0.3881,7,105,98,980,105,1085
9066,2012-01-18,1,1,1,15,0,3,1,1,0.3,0.2576,0.33,0.5224,8,120,122,1220,130,1340
9067,2012-01-18,1,1,1,16,0,3,1,1,0.28,0.2273,0.3,0.5224,13,195,163,1630,176,1825
9068,2012-01-18,1,1,1,17,0,3,1,1,0.26,0.2121,0.33,0.4478,8,120,338,3380,346,3500
9069,2012-01-18,1,1,1,18,0,3,1,1,0.24,0.2121,0.32,0.3582,8,120,347,3470,355,3590
9070,2012-01-18,1,1,1,19,0,3,1,1,0.22,0.197,0.37,0.3881,5,75,251,2510,256,2585
9071,2012-01-18,1,1,1,20,0,3,1,1,0.22,0.2121,0.37,0.2537,1,15,164,1640,165,1655
9072,2012-01-18,1,1,1,21,0,3,1,1,0.2,0.1667,0.4,0.4179,5,75,119,1190,124,1265
9073,2012-01-18,1,1,1,22,0,3,1,1,0.18,0.1667,0.47,0.2537,4,60,74,740,78,800
9074,2012-01-18,1,1,1,23,0,3,1,1,0.16,0.1364,0.47,0.2985,2,30,36,360,38,390
9075,2012-01-19,1,1,1,0,0,4,1,1,0.14,0.1364,0.5,0.194,0,0,16,160,16,160
9076,2012-01-19,1,1,1,1,0,4,1,1,0.14,0.1515,0.5,0.1642,0,0,5,50,5,50
9077,2012-01-19,1,1,1,2,0,4,1,1,0.14,0.1515,0.5,0.1343,0,0,3,30,3,30
9078,2012-01-19,1,1,1,3,0,4,1,1,0.12,0.1515,0.54,0.1045,0,0,4,40,4,40
9079,2012-01-19,1,1,1,4,0,4,1,1,0.12,0.1515,0.54,0.1045,0,0,1,10,1,10
9080,2012-01-19,1,1,1,5,0,4,1,1,0.12,0.1212,0.55,0.2537,0,0,19,190,19,190
9081,2012-01-19,1,1,1,6,0,4,1,1,0.12,0.1364,0.54,0.1642,0,0,86,860,86,860
9082,2012-01-19,1,1,1,7,0,4,1,1,0.12,0.1667,0.54,0.0896,2,30,204,2040,206,2070
9083,2012-01-19,1,1,1,8,0,4,1,1,0.12,0.1515,0.54,0.1045,9,135,414,4140,423,4275
9084,2012-01-19,1,1,1,9,0,4,1,1,0.12,0.197,0.54,0.0,6,90,204,2040,210,2130
9085,2012-01-19,1,1,1,10,0,4,1,1,0.14,0.2121,0.59,0.0,10,150,98,980,108,1130
9086,2012-01-19,1,1,1,11,0,4,1,1,0.16,0.1667,0.55,0.1642,6,90,93,930,99,1020
9087,2012-01-19,1,1,1,12,0,4,1,1,0.2,0.197,0.51,0.194,5,75,106,1060,111,1135
9088,2012-01-19,1,1,1,13,0,4,1,1,0.22,0.2121,0.47,0.2836,6,90,118,1180,124,1270
9089,2012-01-19,1,1,1,14,0,4,1,1,0.24,0.2273,0.44,0.194,15,225,104,1040,119,1265
9090,2012-01-19,1,1,1,15,0,4,1,1,0.26,0.2273,0.44,0.2985,9,135,118,1180,127,1315
9091,2012-01-19,1,1,1,16,0,4,1,1,0.26,0.2273,0.41,0.3284,8,120,185,1850,193,1970
9092,2012-01-19,1,1,1,17,0,4,1,2,0.26,0.2273,0.44,0.3284,21,315,364,3640,385,3955
9093,2012-01-19,1,1,1,18,0,4,1,2,0.26,0.2273,0.44,0.3284,16,240,345,3450,361,3690
9094,2012-01-19,1,1,1,19,0,4,1,2,0.26,0.2273,0.48,0.2985,5,75,229,2290,234,2365
9095,2012-01-19,1,1,1,20,0,4,1,1,0.26,0.2121,0.52,0.4478,7,105,184,1840,191,1945
9096,2012-01-19,1,1,1,21,0,4,1,1,0.26,0.2273,0.44,0.3582,4,60,117,1170,121,1230
9097,2012-01-19,1,1,1,22,0,4,1,2,0.26,0.2273,0.44,0.4179,0,0,90,900,90,900
9098,2012-01-19,1,1,1,23,0,4,1,1,0.26,0.2273,0.48,0.3284,1,15,55,550,56,565
9099,2012-01-20,1,1,1,0,0,5,1,2,0.26,0.2273,0.48,0.2985,3,45,24,240,27,285
9100,2012-01-20,1,1,1,1,0,5,1,1,0.26,0.2727,0.48,0.1343,0,0,15,150,15,150
9101,2012-01-20,1,1,1,2,0,5,1,1,0.26,0.2727,0.48,0.1343,0,0,11,110,11,110
9102,2012-01-20,1,1,1,3,0,5,1,1,0.24,0.2576,0.52,0.1045,0,0,4,40,4,40
9103,2012-01-20,1,1,1,4,0,5,1,1,0.22,0.2424,0.6,0.1045,0,0,3,30,3,30
9104,2012-01-20,1,1,1,5,0,5,1,1,0.22,0.2424,0.6,0.1045,0,0,19,190,19,190
9105,2012-01-20,1,1,1,6,0,5,1,1,0.24,0.2121,0.6,0.2836,0,0,68,680,68,680
9106,2012-01-20,1,1,1,7,0,5,1,1,0.22,0.2121,0.69,0.2239,2,30,183,1830,185,1860
9107,2012-01-20,1,1,1,8,0,5,1,1,0.22,0.2121,0.64,0.2537,4,60,421,4210,425,4270
9108,2012-01-20,1,1,1,9,0,5,1,1,0.22,0.197,0.47,0.3881,21,315,242,2420,263,2735
9109,2012-01-20,1,1,1,10,0,5,1,2,0.22,0.2121,0.44,0.2836,1,15,96,960,97,975
9110,2012-01-20,1,1,1,11,0,5,1,2,0.2,0.1818,0.32,0.3582,6,90,117,1170,123,1260
9111,2012-01-20,1,1,1,12,0,5,1,2,0.2,0.1818,0.34,0.3284,5,75,119,1190,124,1265
9112,2012-01-20,1,1,1,13,0,5,1,1,0.22,0.2121,0.32,0.2985,12,180,144,1440,156,1620
9113,2012-01-20,1,1,1,14,0,5,1,2,0.22,0.2121,0.35,0.2985,8,120,107,1070,115,1190
9114,2012-01-20,1,1,1,15,0,5,1,2,0.22,0.2273,0.35,0.194,12,180,144,1440,156,1620
9115,2012-01-20,1,1,1,16,0,5,1,2,0.2,0.2121,0.37,0.1642,11,165,163,1630,174,1795
9116,2012-01-20,1,1,1,17,0,5,1,2,0.22,0.2576,0.32,0.0896,9,135,340,3400,349,3535
9117,2012-01-20,1,1,1,18,0,5,1,2,0.2,0.2273,0.34,0.0896,5,75,296,2960,301,3035
9118,2012-01-20,1,1,1,19,0,5,1,2,0.2,0.2273,0.37,0.1045,6,90,186,1860,192,1950
9119,2012-01-20,1,1,1,20,0,5,1,2,0.2,0.2273,0.34,0.0896,1,15,141,1410,142,1425
9120,2012-01-20,1,1,1,21,0,5,1,2,0.2,0.2273,0.37,0.0896,5,75,99,990,104,1065
9121,2012-01-20,1,1,1,22,0,5,1,2,0.2,0.197,0.37,0.2239,1,15,71,710,72,725
9122,2012-01-20,1,1,1,23,0,5,1,3,0.16,0.1515,0.64,0.2239,3,45,35,350,38,395
9123,2012-01-21,1,1,1,0,0,6,0,3,0.16,0.1515,0.64,0.2239,0,0,24,240,24,240
9124,2012-01-21,1,1,1,1,0,6,0,4,0.14,0.1364,0.86,0.194,1,15,22,220,23,235
9125,2012-01-21,1,1,1,2,0,6,0,3,0.14,0.2121,0.86,0.0,1,15,25,250,26,265
9126,2012-01-21,1,1,1,3,0,6,0,3,0.14,0.1818,0.93,0.0896,0,0,13,130,13,130
9127,2012-01-21,1,1,1,4,0,6,0,3,0.16,0.197,0.86,0.0896,0,0,1,10,1,10
9128,2012-01-21,1,1,1,5,0,6,0,3,0.16,0.1818,0.86,0.1045,0,0,2,20,2,20
9129,2012-01-21,1,1,1,6,0,6,0,3,0.16,0.1667,0.93,0.1642,0,0,1,10,1,10
9130,2012-01-21,1,1,1,7,0,6,0,3,0.16,0.1667,0.93,0.1642,3,45,10,100,13,145
9131,2012-01-21,1,1,1,8,0,6,0,2,0.16,0.1515,0.93,0.2537,3,45,22,220,25,265
9132,2012-01-21,1,1,1,9,0,6,0,2,0.16,0.1515,0.93,0.2537,2,30,40,400,42,430
9133,2012-01-21,1,1,1,10,0,6,0,3,0.16,0.1515,0.93,0.2537,0,0,45,450,45,450
9134,2012-01-21,1,1,1,11,0,6,0,2,0.18,0.2121,0.86,0.1045,1,15,62,620,63,635
9135,2012-01-21,1,1,1,12,0,6,0,2,0.2,0.2121,0.8,0.1642,5,75,62,620,67,695
9136,2012-01-21,1,1,1,13,0,6,0,2,0.2,0.197,0.8,0.2537,10,150,66,660,76,810
9137,2012-01-21,1,1,1,14,0,6,0,3,0.2,0.197,0.8,0.194,6,90,89,890,95,980
9138,2012-01-21,1,1,1,15,0,6,0,3,0.2,0.197,0.8,0.194,6,90,113,1130,119,1220
9139,2012-01-21,1,1,1,16,0,6,0,2,0.2,0.1818,0.8,0.2985,5,75,113,1130,118,1205
9140,2012-01-21,1,1,1,17,0,6,0,2,0.2,0.1818,0.8,0.3881,7,105,99,990,106,1095
9141,2012-01-21,1,1,1,18,0,6,0,2,0.2,0.1818,0.75,0.3881,3,45,107,1070,110,1115
9142,2012-01-21,1,1,1,19,0,6,0,2,0.18,0.1515,0.8,0.3881,0,0,85,850,85,850
9143,2012-01-21,1,1,1,20,0,6,0,2,0.18,0.1667,0.8,0.2985,5,75,62,620,67,695
9144,2012-01-21,1,1,1,21,0,6,0,1,0.18,0.1515,0.74,0.3284,5,75,64,640,69,715
9145,2012-01-21,1,1,1,22,0,6,0,2,0.18,0.1667,0.74,0.2985,3,45,56,560,59,605
9146,2012-01-21,1,1,1,23,0,6,0,2,0.16,0.1515,0.8,0.2537,1,15,51,510,52,525
9147,2012-01-22,1,1,1,0,0,0,0,1,0.16,0.1364,0.8,0.2985,1,15,51,510,52,525
9148,2012-01-22,1,1,1,1,0,0,0,2,0.18,0.1667,0.74,0.2985,1,15,49,490,50,505
9149,2012-01-22,1,1,1,2,0,0,0,2,0.18,0.1667,0.74,0.2836,1,15,46,460,47,475
9150,2012-01-22,1,1,1,3,0,0,0,2,0.18,0.1667,0.69,0.2836,1,15,20,200,21,215
9151,2012-01-22,1,1,1,4,0,0,0,3,0.16,0.1364,0.8,0.2836,1,15,1,10,2,25
9152,2012-01-22,1,1,1,5,0,0,0,3,0.16,0.1515,0.74,0.2239,1,15,2,20,3,35
9153,2012-01-22,1,1,1,6,0,0,0,2,0.16,0.1515,0.74,0.2239,0,0,4,40,4,40
9154,2012-01-22,1,1,1,7,0,0,0,2,0.16,0.1515,0.74,0.2239,2,30,11,110,13,140
9155,2012-01-22,1,1,1,8,0,0,0,2,0.16,0.1515,0.74,0.2239,3,45,29,290,32,335
9156,2012-01-22,1,1,1,9,0,0,0,2,0.16,0.1515,0.74,0.2239,9,135,54,540,63,675
9157,2012-01-22,1,1,1,10,0,0,0,2,0.16,0.1364,0.74,0.2836,9,135,120,1200,129,1335
9158,2012-01-22,1,1,1,11,0,0,0,3,0.16,0.1515,0.8,0.2537,18,270,115,1150,133,1420
9159,2012-01-22,1,1,1,12,0,0,0,2,0.16,0.1515,0.8,0.2239,24,360,161,1610,185,1970
9160,2012-01-22,1,1,1,13,0,0,0,2,0.16,0.1818,0.8,0.1343,24,360,175,1750,199,2110
9161,2012-01-22,1,1,1,14,0,0,0,2,0.16,0.1667,0.8,0.1642,19,285,163,1630,182,1915
9162,2012-01-22,1,1,1,15,0,0,0,2,0.16,0.1515,0.8,0.194,27,405,149,1490,176,1895
9163,2012-01-22,1,1,1,16,0,0,0,2,0.16,0.1515,0.8,0.194,12,180,143,1430,155,1610
9164,2012-01-22,1,1,1,17,0,0,0,2,0.16,0.1818,0.8,0.1045,8,120,100,1000,108,1120
9165,2012-01-22,1,1,1,18,0,0,0,3,0.16,0.1818,0.86,0.1045,11,165,110,1100,121,1265
9166,2012-01-22,1,1,1,19,0,0,0,3,0.16,0.1818,0.86,0.1045,9,135,80,800,89,935
9167,2012-01-22,1,1,1,20,0,0,0,3,0.16,0.1667,0.86,0.1642,5,75,69,690,74,765
9168,2012-01-22,1,1,1,21,0,0,0,3,0.16,0.1818,0.86,0.1045,8,120,36,360,44,480
9169,2012-01-22,1,1,1,22,0,0,0,2,0.16,0.197,0.93,0.0896,0,0,58,580,58,580
9170,2012-01-22,1,1,1,23,0,0,0,2,0.16,0.1818,0.93,0.1045,2,30,35,350,37,380
9171,2012-01-23,1,1,1,0,0,1,1,2,0.18,0.2424,0.86,0.0,2,30,17,170,19,200
9172,2012-01-23,1,1,1,1,0,1,1,2,0.18,0.2121,0.86,0.1045,0,0,4,40,4,40
9173,2012-01-23,1,1,1,2,0,1,1,2,0.18,0.2121,0.86,0.1045,0,0,2,20,2,20
9174,2012-01-23,1,1,1,3,0,1,1,2,0.18,0.2424,0.86,0.0,0,0,1,10,1,10
9175,2012-01-23,1,1,1,4,0,1,1,2,0.2,0.2576,0.8,0.0,0,0,1,10,1,10
9176,2012-01-23,1,1,1,5,0,1,1,2,0.2,0.2576,0.86,0.0,0,0,19,190,19,190
9177,2012-01-23,1,1,1,6,0,1,1,2,0.2,0.2576,0.86,0.0,6,90,36,360,42,450
9178,2012-01-23,1,1,1,7,0,1,1,3,0.2,0.2576,0.86,0.0,8,120,114,1140,122,1260
9179,2012-01-23,1,1,1,8,0,1,1,3,0.2,0.2121,0.86,0.1343,5,75,267,2670,272,2745
9180,2012-01-23,1,1,1,9,0,1,1,2,0.2,0.2273,0.86,0.0896,13,195,198,1980,211,2175
9181,2012-01-23,1,1,1,10,0,1,1,2,0.2,0.2576,0.93,0.0,10,150,139,1390,149,1540
9182,2012-01-23,1,1,1,11,0,1,1,2,0.2,0.2273,0.93,0.0896,5,75,57,570,62,645
9183,2012-01-23,1,1,1,12,0,1,1,2,0.22,0.2727,0.93,0.0,10,150,52,520,62,670
9184,2012-01-23,1,1,1,13,0,1,1,3,0.22,0.2576,0.93,0.0896,5,75,32,320,37,395
9185,2012-01-23,1,1,1,14,0,1,1,3,0.22,0.2273,0.93,0.194,13,195,48,480,61,675
9186,2012-01-23,1,1,1,15,0,1,1,2,0.22,0.2121,1.0,0.2239,10,150,64,640,74,790
9187,2012-01-23,1,1,1,16,0,1,1,2,0.24,0.2424,0.93,0.1642,14,210,108,1080,122,1290
9188,2012-01-23,1,1,1,17,0,1,1,2,0.24,0.2576,0.96,0.1045,6,90,270,2700,276,2790
9189,2012-01-23,1,1,1,18,0,1,1,2,0.24,0.2424,0.93,0.1343,7,105,275,2750,282,2855
9190,2012-01-23,1,1,1,19,0,1,1,2,0.26,0.2576,0.93,0.1642,9,135,211,2110,220,2245
9191,2012-01-23,1,1,1,20,0,1,1,2,0.26,0.2576,1.0,0.1642,8,120,161,1610,169,1730
9192,2012-01-23,1,1,1,21,0,1,1,2,0.26,0.2424,1.0,0.2836,8,120,112,1120,120,1240
9193,2012-01-23,1,1,1,22,0,1,1,2,0.26,0.2424,1.0,0.2836,4,60,64,640,68,700
9194,2012-01-23,1,1,1,23,0,1,1,2,0.28,0.2576,0.93,0.3284,2,30,35,350,37,380
9195,2012-01-24,1,1,1,0,0,2,1,2,0.3,0.2879,1.0,0.2836,6,90,19,190,25,280
9196,2012-01-24,1,1,1,1,0,2,1,2,0.32,0.303,0.93,0.2537,2,30,7,70,9,100
9197,2012-01-24,1,1,1,2,0,2,1,2,0.32,0.303,0.93,0.2239,2,30,6,60,8,90
9198,2012-01-24,1,1,1,3,0,2,1,2,0.32,0.3333,0.93,0.1343,0,0,3,30,3,30
9199,2012-01-24,1,1,1,4,0,2,1,2,0.3,0.3182,1.0,0.0896,0,0,2,20,2,20
9200,2012-01-24,1,1,1,5,0,2,1,2,0.3,0.3182,1.0,0.0896,0,0,26,260,26,260
9201,2012-01-24,1,1,1,6,0,2,1,2,0.32,0.3182,0.93,0.194,1,15,88,880,89,895
9202,2012-01-24,1,1,1,7,0,2,1,2,0.32,0.3333,0.93,0.1343,11,165,221,2210,232,2375
9203,2012-01-24,1,1,1,8,0,2,1,2,0.32,0.3333,0.93,0.1343,11,165,479,4790,490,4955
9204,2012-01-24,1,1,1,9,0,2,1,2,0.32,0.3333,0.87,0.0896,11,165,244,2440,255,2605
9205,2012-01-24,1,1,1,10,0,2,1,1,0.32,0.3333,0.93,0.0896,23,345,93,930,116,1275
9206,2012-01-24,1,1,1,11,0,2,1,1,0.34,0.3333,0.87,0.1343,30,450,123,1230,153,1680
9207,2012-01-24,1,1,1,12,0,2,1,1,0.34,0.3333,0.87,0.1642,25,375,150,1500,175,1875
9208,2012-01-24,1,1,1,13,0,2,1,1,0.34,0.3333,0.87,0.1642,33,495,170,1700,203,2195
9209,2012-01-24,1,1,1,14,0,2,1,1,0.36,0.3485,0.81,0.2239,35,525,138,1380,173,1905
9210,2012-01-24,1,1,1,15,0,2,1,2,0.4,0.4091,0.71,0.1642,52,780,156,1560,208,2340
9211,2012-01-24,1,1,1,16,0,2,1,1,0.4,0.4091,0.71,0.1343,35,525,243,2430,278,2955
9212,2012-01-24,1,1,1,17,0,2,1,1,0.42,0.4242,0.67,0.0896,41,615,474,4740,515,5355
9213,2012-01-24,1,1,1,18,0,2,1,1,0.4,0.4091,0.62,0.0896,32,480,391,3910,423,4390
9214,2012-01-24,1,1,1,19,0,2,1,1,0.44,0.4394,0.51,0.0896,20,300,311,3110,331,3410
9215,2012-01-24,1,1,1,20,0,2,1,1,0.32,0.3485,0.76,0.0,18,270,211,2110,229,2380
9216,2012-01-24,1,1,1,21,0,2,1,1,0.36,0.3788,0.71,0.0,18,270,154,1540,172,1810
9217,2012-01-24,1,1,1,22,0,2,1,1,0.32,0.3485,0.81,0.0,14,210,111,1110,125,1320
9218,2012-01-24,1,1,1,23,0,2,1,1,0.32,0.3485,0.76,0.0,19,285,80,800,99,1085
9219,2012-01-25,1,1,1,0,0,3,1,1,0.26,0.303,0.93,0.0,6,90,25,250,31,340
9220,2012-01-25,1,1,1,1,0,3,1,1,0.3,0.2879,0.7,0.2239,4,60,9,90,13,150
9221,2012-01-25,1,1,1,2,0,3,1,1,0.28,0.2727,0.7,0.194,3,45,3,30,6,75
9222,2012-01-25,1,1,1,3,0,3,1,1,0.26,0.2576,0.75,0.194,0,0,1,10,1,10
9223,2012-01-25,1,1,1,4,0,3,1,1,0.26,0.2424,0.7,0.2836,0,0,4,40,4,40
9224,2012-01-25,1,1,1,5,0,3,1,1,0.26,0.2424,0.7,0.2836,0,0,33,330,33,330
9225,2012-01-25,1,1,1,6,0,3,1,1,0.24,0.2273,0.73,0.2239,1,15,87,870,88,885
9226,2012-01-25,1,1,1,7,0,3,1,1,0.24,0.2273,0.75,0.2239,14,210,243,2430,257,2640
9227,2012-01-25,1,1,1,8,0,3,1,1,0.24,0.2273,0.7,0.2537,18,270,495,4950,513,5220
9228,2012-01-25,1,1,1,9,0,3,1,1,0.24,0.2273,0.7,0.2537,18,270,218,2180,236,2450
9229,2012-01-25,1,1,1,10,0,3,1,2,0.26,0.2273,0.7,0.3284,30,450,111,1110,141,1560
9230,2012-01-25,1,1,1,11,0,3,1,2,0.3,0.2727,0.61,0.2985,52,780,105,1050,157,1830
9231,2012-01-25,1,1,1,12,0,3,1,1,0.32,0.3333,0.53,0.1343,46,690,147,1470,193,2160
9232,2012-01-25,1,1,1,13,0,3,1,1,0.34,0.3333,0.49,0.1343,63,945,149,1490,212,2435
9233,2012-01-25,1,1,1,14,0,3,1,1,0.34,0.3485,0.49,0.0896,53,795,107,1070,160,1865
9234,2012-01-25,1,1,1,15,0,3,1,1,0.36,0.3788,0.46,0.0,30,450,125,1250,155,1700
9235,2012-01-25,1,1,1,16,0,3,1,1,0.34,0.3333,0.53,0.1642,29,435,217,2170,246,2605
9236,2012-01-25,1,1,1,17,0,3,1,1,0.36,0.3485,0.53,0.1642,27,405,443,4430,470,4835
9237,2012-01-25,1,1,1,18,0,3,1,1,0.32,0.3333,0.66,0.1343,24,360,415,4150,439,4510
9238,2012-01-25,1,1,1,19,0,3,1,2,0.34,0.3636,0.53,0.0,5,75,311,3110,316,3185
9239,2012-01-25,1,1,1,20,0,3,1,1,0.32,0.3182,0.61,0.194,10,150,225,2250,235,2400
9240,2012-01-25,1,1,1,21,0,3,1,1,0.3,0.3333,0.65,0.0,19,285,166,1660,185,1945
9241,2012-01-25,1,1,1,22,0,3,1,1,0.3,0.3182,0.65,0.0896,12,180,101,1010,113,1190
9242,2012-01-25,1,1,1,23,0,3,1,2,0.28,0.3182,0.65,0.0,3,45,63,630,66,675
9243,2012-01-26,1,1,1,0,0,4,1,2,0.28,0.2879,0.75,0.1045,3,45,22,220,25,265
9244,2012-01-26,1,1,1,1,0,4,1,2,0.28,0.3182,0.75,0.0,5,75,16,160,21,235
9245,2012-01-26,1,1,1,2,0,4,1,2,0.28,0.2727,0.75,0.1642,1,15,6,60,7,75
9246,2012-01-26,1,1,1,3,0,4,1,2,0.28,0.303,0.75,0.0896,1,15,5,50,6,65
9247,2012-01-26,1,1,1,4,0,4,1,1,0.28,0.3182,0.75,0.0,0,0,3,30,3,30
9248,2012-01-26,1,1,1,5,0,4,1,2,0.3,0.3182,0.75,0.1045,0,0,28,280,28,280
9249,2012-01-26,1,1,1,6,0,4,1,2,0.28,0.3182,0.81,0.0,0,0,88,880,88,880
9250,2012-01-26,1,1,1,7,0,4,1,2,0.28,0.303,0.81,0.0896,11,165,228,2280,239,2445
9251,2012-01-26,1,1,1,8,0,4,1,2,0.28,0.303,0.81,0.0896,16,240,514,5140,530,5380
9252,2012-01-26,1,1,1,9,0,4,1,2,0.3,0.3333,0.81,0.0,18,270,256,2560,274,2830
9253,2012-01-26,1,1,1,10,0,4,1,2,0.3,0.303,0.81,0.1343,16,240,92,920,108,1160
9254,2012-01-26,1,1,1,11,0,4,1,2,0.3,0.3182,0.87,0.1045,11,165,100,1000,111,1165
9255,2012-01-26,1,1,1,12,0,4,1,2,0.34,0.3333,0.81,0.1343,29,435,136,1360,165,1795
9256,2012-01-26,1,1,1,13,0,4,1,2,0.38,0.3939,0.71,0.0,17,255,156,1560,173,1815
9257,2012-01-26,1,1,1,14,0,4,1,2,0.4,0.4091,0.71,0.1045,16,240,112,1120,128,1360
9258,2012-01-26,1,1,1,15,0,4,1,2,0.42,0.4242,0.71,0.1045,22,330,142,1420,164,1750
9259,2012-01-26,1,1,1,16,0,4,1,2,0.4,0.4091,0.71,0.0896,15,225,209,2090,224,2315
9260,2012-01-26,1,1,1,17,0,4,1,2,0.42,0.4242,0.71,0.0,16,240,397,3970,413,4210
9261,2012-01-26,1,1,1,18,0,4,1,2,0.42,0.4242,0.71,0.0,12,180,394,3940,406,4120
9262,2012-01-26,1,1,1,19,0,4,1,2,0.4,0.4091,0.76,0.1045,11,165,302,3020,313,3185
9263,2012-01-26,1,1,1,20,0,4,1,2,0.4,0.4091,0.82,0.1343,8,120,216,2160,224,2280
9264,2012-01-26,1,1,1,21,0,4,1,2,0.4,0.4091,0.76,0.1045,8,120,184,1840,192,1960
9265,2012-01-26,1,1,1,22,0,4,1,1,0.38,0.3939,0.82,0.1045,3,45,139,1390,142,1435
9266,2012-01-26,1,1,1,23,0,4,1,2,0.4,0.4091,0.82,0.0,5,75,86,860,91,935
9267,2012-01-27,1,1,1,0,0,5,1,2,0.4,0.4091,0.82,0.2537,6,90,32,320,38,410
9268,2012-01-27,1,1,1,1,0,5,1,2,0.4,0.4091,0.87,0.2239,6,90,23,230,29,320
9269,2012-01-27,1,1,1,2,0,5,1,1,0.42,0.4242,0.94,0.1343,2,30,11,110,13,140
9270,2012-01-27,1,1,1,3,0,5,1,2,0.42,0.4242,0.94,0.2836,3,45,5,50,8,95
9271,2012-01-27,1,1,1,4,0,5,1,2,0.4,0.4091,1.0,0.2985,1,15,3,30,4,45
9272,2012-01-27,1,1,1,5,0,5,1,2,0.42,0.4242,0.94,0.3284,0,0,24,240,24,240
9273,2012-01-27,1,1,1,6,0,5,1,2,0.42,0.4242,1.0,0.3284,0,0,72,720,72,720
9274,2012-01-27,1,1,1,7,0,5,1,2,0.42,0.4242,1.0,0.2985,6,90,128,1280,134,1370
9275,2012-01-27,1,1,1,8,0,5,1,3,0.5,0.4848,0.88,0.2836,14,210,206,2060,220,2270
9276,2012-01-27,1,1,1,9,0,5,1,3,0.5,0.4848,0.88,0.2836,6,90,101,1010,107,1100
9277,2012-01-27,1,1,1,10,0,5,1,3,0.48,0.4697,1.0,0.1642,9,135,117,1170,126,1305
9278,2012-01-27,1,1,1,11,0,5,1,2,0.48,0.4697,0.94,0.1343,10,150,95,950,105,1100
9279,2012-01-27,1,1,1,12,0,5,1,2,0.5,0.4848,0.88,0.1642,25,375,155,1550,180,1925
9280,2012-01-27,1,1,1,13,0,5,1,1,0.5,0.4848,0.59,0.4627,26,390,175,1750,201,2140
9281,2012-01-27,1,1,1,14,0,5,1,1,0.5,0.4848,0.55,0.5522,23,345,153,1530,176,1875
9282,2012-01-27,1,1,1,15,0,5,1,1,0.48,0.4697,0.51,0.3284,27,405,170,1700,197,2105
9283,2012-01-27,1,1,1,16,0,5,1,1,0.44,0.4394,0.51,0.5522,26,390,241,2410,267,2800
9284,2012-01-27,1,1,1,17,0,5,1,1,0.42,0.4242,0.5,0.5821,16,240,406,4060,422,4300
9285,2012-01-27,1,1,1,18,0,5,1,1,0.4,0.4091,0.5,0.4925,20,300,363,3630,383,3930
9286,2012-01-27,1,1,1,19,0,5,1,1,0.36,0.3333,0.5,0.3881,10,150,241,2410,251,2560
9287,2012-01-27,1,1,1,20,0,5,1,1,0.34,0.303,0.53,0.3582,6,90,153,1530,159,1620
9288,2012-01-27,1,1,1,21,0,5,1,1,0.34,0.2879,0.53,0.5224,8,120,127,1270,135,1390
9289,2012-01-27,1,1,1,22,0,5,1,1,0.34,0.303,0.49,0.3881,11,165,108,1080,119,1245
9290,2012-01-27,1,1,1,23,0,5,1,1,0.32,0.2879,0.49,0.4179,8,120,78,780,86,900
9291,2012-01-28,1,1,1,0,0,6,0,1,0.3,0.2879,0.52,0.2836,1,15,68,680,69,695
9292,2012-01-28,1,1,1,1,0,6,0,1,0.3,0.303,0.52,0.1642,1,15,57,570,58,585
9293,2012-01-28,1,1,1,2,0,6,0,1,0.26,0.303,0.6,0.0,3,45,38,380,41,425
9294,2012-01-28,1,1,1,3,0,6,0,1,0.26,0.2879,0.6,0.0896,1,15,16,160,17,175
9295,2012-01-28,1,1,1,4,0,6,0,1,0.26,0.2576,0.6,0.1642,0,0,8,80,8,80
9296,2012-01-28,1,1,1,5,0,6,0,1,0.24,0.2576,0.75,0.0896,0,0,10,100,10,100
9297,2012-01-28,1,1,1,6,0,6,0,1,0.24,0.2879,0.7,0.0,3,45,12,120,15,165
9298,2012-01-28,1,1,1,7,0,6,0,1,0.22,0.2727,0.75,0.0,3,45,28,280,31,325
9299,2012-01-28,1,1,1,8,0,6,0,1,0.2,0.2273,0.8,0.0896,9,135,82,820,91,955
9300,2012-01-28,1,1,1,9,0,6,0,1,0.22,0.2727,0.8,0.0,13,195,145,1450,158,1645
9301,2012-01-28,1,1,1,10,0,6,0,1,0.26,0.2727,0.7,0.1343,27,405,164,1640,191,2045
9302,2012-01-28,1,1,1,11,0,6,0,1,0.3,0.303,0.56,0.1343,55,825,241,2410,296,3235
9303,2012-01-28,1,1,1,12,0,6,0,1,0.3,0.2879,0.61,0.2836,70,1050,244,2440,314,3490
9304,2012-01-28,1,1,1,13,0,6,0,1,0.34,0.3182,0.57,0.2537,80,1200,293,2930,373,4130
9305,2012-01-28,1,1,1,14,0,6,0,1,0.38,0.3939,0.5,0.3881,123,1845,239,2390,362,4235
9306,2012-01-28,1,1,1,15,0,6,0,1,0.4,0.4091,0.47,0.3284,90,1350,320,3200,410,4550
9307,2012-01-28,1,1,1,16,0,6,0,1,0.42,0.4242,0.44,0.3582,131,1965,276,2760,407,4725
9308,2012-01-28,1,1,1,17,0,6,0,1,0.42,0.4242,0.44,0.3881,57,855,233,2330,290,3185
9309,2012-01-28,1,1,1,18,0,6,0,1,0.42,0.4242,0.41,0.2239,40,600,201,2010,241,2610
9310,2012-01-28,1,1,1,19,0,6,0,2,0.42,0.4242,0.41,0.5522,33,495,173,1730,206,2225
9311,2012-01-28,1,1,1,20,0,6,0,1,0.4,0.4091,0.35,0.3881,5,75,115,1150,120,1225
9312,2012-01-28,1,1,1,21,0,6,0,1,0.36,0.3333,0.29,0.3582,18,270,109,1090,127,1360
9313,2012-01-28,1,1,1,22,0,6,0,1,0.34,0.3333,0.34,0.194,6,90,97,970,103,1060
9314,2012-01-28,1,1,1,23,0,6,0,1,0.32,0.3182,0.31,0.194,6,90,79,790,85,880
9315,2012-01-29,1,1,1,0,0,0,0,1,0.3,0.2879,0.33,0.2239,15,225,81,810,96,1035
9316,2012-01-29,1,1,1,1,0,0,0,1,0.3,0.2727,0.28,0.3582,5,75,68,680,73,755
9317,2012-01-29,1,1,1,2,0,0,0,1,0.28,0.2576,0.26,0.3284,3,45,48,480,51,525
9318,2012-01-29,1,1,1,3,0,0,0,1,0.26,0.2576,0.28,0.194,4,60,17,170,21,230
9319,2012-01-29,1,1,1,4,0,0,0,1,0.24,0.2576,0.3,0.0,0,0,5,50,5,50
9320,2012-01-29,1,1,1,5,0,0,0,1,0.2,0.2121,0.51,0.1343,1,15,6,60,7,75
9321,2012-01-29,1,1,1,6,0,0,0,1,0.2,0.2273,0.4,0.1045,1,15,4,40,5,55
9322,2012-01-29,1,1,1,7,0,0,0,1,0.2,0.2121,0.37,0.1343,0,0,12,120,12,120
9323,2012-01-29,1,1,1,8,0,0,0,1,0.18,0.197,0.4,0.1343,9,135,61,610,70,745
9324,2012-01-29,1,1,1,9,0,0,0,1,0.18,0.197,0.43,0.1343,13,195,98,980,111,1175
9325,2012-01-29,1,1,1,10,0,0,0,1,0.24,0.2424,0.35,0.1343,38,570,153,1530,191,2100
9326,2012-01-29,1,1,1,11,0,0,0,1,0.28,0.2727,0.28,0.2239,57,855,198,1980,255,2835
9327,2012-01-29,1,1,1,12,0,0,0,1,0.32,0.303,0.26,0.2239,73,1095,215,2150,288,3245
9328,2012-01-29,1,1,1,13,0,0,0,1,0.32,0.303,0.26,0.2239,78,1170,238,2380,316,3550
9329,2012-01-29,1,1,1,14,0,0,0,1,0.32,0.303,0.26,0.2537,51,765,229,2290,280,3055
9330,2012-01-29,1,1,1,15,0,0,0,1,0.36,0.3333,0.25,0.2836,68,1020,242,2420,310,3440
9331,2012-01-29,1,1,1,16,0,0,0,1,0.36,0.3333,0.21,0.4179,54,810,268,2680,322,3490
9332,2012-01-29,1,1,1,17,0,0,0,1,0.36,0.3333,0.21,0.4179,33,495,201,2010,234,2505
9333,2012-01-29,1,1,1,18,0,0,0,1,0.34,0.303,0.23,0.3582,17,255,151,1510,168,1765
9334,2012-01-29,1,1,1,19,0,0,0,1,0.32,0.303,0.29,0.2537,14,210,145,1450,159,1660
9335,2012-01-29,1,1,1,20,0,0,0,1,0.3,0.2879,0.39,0.2239,13,195,98,980,111,1175
9336,2012-01-29,1,1,1,21,0,0,0,1,0.3,0.2879,0.33,0.2836,0,0,69,690,69,690
9337,2012-01-29,1,1,1,22,0,0,0,1,0.32,0.2879,0.26,0.3881,7,105,57,570,64,675
9338,2012-01-29,1,1,1,23,0,0,0,1,0.3,0.2727,0.33,0.3284,4,60,21,210,25,270
9339,2012-01-30,1,1,1,0,0,1,1,2,0.32,0.2879,0.26,0.4179,0,0,10,100,10,100
9340,2012-01-30,1,1,1,1,0,1,1,1,0.26,0.2273,0.6,0.3582,0,0,9,90,9,90
9341,2012-01-30,1,1,1,2,0,1,1,1,0.24,0.2121,0.48,0.3582,1,15,6,60,7,75
9342,2012-01-30,1,1,1,3,0,1,1,1,0.24,0.2273,0.48,0.194,0,0,4,40,4,40
9343,2012-01-30,1,1,1,4,0,1,1,1,0.2,0.2121,0.51,0.1343,0,0,5,50,5,50
9344,2012-01-30,1,1,1,5,0,1,1,1,0.2,0.2121,0.51,0.1343,0,0,26,260,26,260
9345,2012-01-30,1,1,1,6,0,1,1,1,0.22,0.2121,0.44,0.2537,0,0,80,800,80,800
9346,2012-01-30,1,1,1,7,0,1,1,1,0.22,0.2121,0.44,0.2836,4,60,221,2210,225,2270
9347,2012-01-30,1,1,1,8,0,1,1,1,0.2,0.197,0.47,0.2239,12,180,481,4810,493,4990
9348,2012-01-30,1,1,1,9,0,1,1,1,0.2,0.197,0.47,0.2239,5,75,193,1930,198,2005
9349,2012-01-30,1,1,1,10,0,1,1,1,0.22,0.2121,0.41,0.2836,3,45,82,820,85,865
9350,2012-01-30,1,1,1,11,0,1,1,1,0.26,0.2576,0.38,0.0,6,90,93,930,99,1020
9351,2012-01-30,1,1,1,12,0,1,1,1,0.26,0.2273,0.35,0.3881,5,75,129,1290,134,1365
9352,2012-01-30,1,1,1,13,0,1,1,1,0.3,0.2879,0.31,0.194,15,225,117,1170,132,1395
9353,2012-01-30,1,1,1,14,0,1,1,1,0.32,0.3333,0.24,0.1343,15,225,100,1000,115,1225
9354,2012-01-30,1,1,1,15,0,1,1,1,0.32,0.3182,0.24,0.194,7,105,131,1310,138,1415
9355,2012-01-30,1,1,1,16,0,1,1,1,0.34,0.3333,0.25,0.194,11,165,210,2100,221,2265
9356,2012-01-30,1,1,1,17,0,1,1,1,0.36,0.3485,0.21,0.194,16,240,422,4220,438,4460
9357,2012-01-30,1,1,1,18,0,1,1,1,0.34,0.3333,0.23,0.1642,11,165,399,3990,410,4155
9358,2012-01-30,1,1,1,19,0,1,1,1,0.3,0.3182,0.45,0.1045,8,120,298,2980,306,3100
9359,2012-01-30,1,1,1,20,0,1,1,1,0.3,0.303,0.39,0.1642,2,30,179,1790,181,1820
9360,2012-01-30,1,1,1,21,0,1,1,1,0.3,0.303,0.42,0.1642,3,45,159,1590,162,1635
9361,2012-01-30,1,1,1,22,0,1,1,1,0.28,0.2727,0.48,0.2239,2,30,92,920,94,950
9362,2012-01-30,1,1,1,23,0,1,1,1,0.26,0.2576,0.6,0.194,0,0,52,520,52,520
9363,2012-01-31,1,1,1,0,0,2,1,1,0.28,0.2727,0.52,0.2537,0,0,15,150,15,150
9364,2012-01-31,1,1,1,1,0,2,1,1,0.3,0.2727,0.42,0.2985,1,15,7,70,8,85
9365,2012-01-31,1,1,1,2,0,2,1,1,0.3,0.2879,0.42,0.2239,0,0,2,20,2,20
9366,2012-01-31,1,1,1,3,0,2,1,1,0.3,0.2879,0.45,0.2239,0,0,2,20,2,20
9367,2012-01-31,1,1,1,4,0,2,1,1,0.3,0.2879,0.49,0.194,0,0,1,10,1,10
9368,2012-01-31,1,1,1,5,0,2,1,1,0.3,0.2879,0.49,0.194,0,0,22,220,22,220
9369,2012-01-31,1,1,1,6,0,2,1,1,0.28,0.2727,0.52,0.1642,0,0,104,1040,104,1040
9370,2012-01-31,1,1,1,7,0,2,1,1,0.26,0.2576,0.6,0.194,6,90,273,2730,279,2820
9371,2012-01-31,1,1,1,8,0,2,1,1,0.26,0.2727,0.6,0.1045,14,210,498,4980,512,5190
9372,2012-01-31,1,1,1,9,0,2,1,1,0.3,0.2879,0.52,0.194,30,450,231,2310,261,2760
9373,2012-01-31,1,1,1,10,0,2,1,2,0.32,0.3182,0.57,0.194,34,510,110,1100,144,1610
9374,2012-01-31,1,1,1,11,0,2,1,1,0.4,0.4091,0.37,0.2836,14,210,125,1250,139,1460
9375,2012-01-31,1,1,1,12,0,2,1,1,0.4,0.4091,0.43,0.2985,13,195,181,1810,194,2005
9376,2012-01-31,1,1,1,13,0,2,1,1,0.46,0.4545,0.36,0.2239,27,405,171,1710,198,2115
9377,2012-01-31,1,1,1,14,0,2,1,1,0.5,0.4848,0.29,0.3284,18,270,142,1420,160,1690
9378,2012-01-31,1,1,1,15,0,2,1,1,0.54,0.5152,0.26,0.4478,27,405,150,1500,177,1905
9379,2012-01-31,1,1,1,16,0,2,1,1,0.54,0.5152,0.26,0.4478,30,450,277,2770,307,3220
9380,2012-01-31,1,1,1,17,0,2,1,1,0.54,0.5152,0.26,0.4179,41,615,518,5180,559,5795
9381,2012-01-31,1,1,1,18,0,2,1,1,0.54,0.5152,0.24,0.3582,16,240,486,4860,502,5100
9382,2012-01-31,1,1,1,19,0,2,1,1,0.5,0.4848,0.29,0.2836,22,330,306,3060,328,3390
9383,2012-01-31,1,1,1,20,0,2,1,1,0.4,0.4091,0.58,0.1045,15,225,223,2230,238,2455
9384,2012-01-31,1,1,1,21,0,2,1,1,0.46,0.4545,0.33,0.2985,3,45,162,1620,165,1665
9385,2012-01-31,1,1,1,22,0,2,1,1,0.44,0.4394,0.35,0.2985,11,165,118,1180,129,1345
9386,2012-01-31,1,1,1,23,0,2,1,1,0.44,0.4394,0.38,0.2537,2,30,61,610,63,640
9387,2012-02-01,1,1,2,0,0,3,1,1,0.44,0.4394,0.38,0.2836,0,0,31,310,31,310
9388,2012-02-01,1,1,2,1,0,3,1,1,0.44,0.4394,0.41,0.2836,0,0,4,40,4,40
9389,2012-02-01,1,1,2,2,0,3,1,1,0.44,0.4394,0.44,0.2836,1,15,6,60,7,75
9390,2012-02-01,1,1,2,3,0,3,1,1,0.44,0.4394,0.44,0.194,0,0,3,30,3,30
9391,2012-02-01,1,1,2,4,0,3,1,1,0.4,0.4091,0.5,0.1642,0,0,1,10,1,10
9392,2012-02-01,1,1,2,5,0,3,1,1,0.4,0.4091,0.5,0.1642,0,0,18,180,18,180
9393,2012-02-01,1,1,2,6,0,3,1,3,0.4,0.4091,0.54,0.1642,0,0,67,670,67,670
9394,2012-02-01,1,1,2,7,0,3,1,3,0.38,0.3939,0.62,0.0896,7,105,201,2010,208,2115
9395,2012-02-01,1,1,2,8,0,3,1,3,0.36,0.3636,0.73,0.1045,15,225,505,5050,520,5275
9396,2012-02-01,1,1,2,9,0,3,1,2,0.36,0.3485,0.71,0.194,9,135,267,2670,276,2805
9397,2012-02-01,1,1,2,10,0,3,1,1,0.4,0.4091,0.62,0.1343,9,135,124,1240,133,1375
9398,2012-02-01,1,1,2,11,0,3,1,1,0.4,0.4091,0.58,0.1642,27,405,116,1160,143,1565
9399,2012-02-01,1,1,2,12,0,3,1,1,0.44,0.4394,0.54,0.1045,26,390,153,1530,179,1920
9400,2012-02-01,1,1,2,13,0,3,1,1,0.46,0.4545,0.47,0.2239,12,180,174,1740,186,1920
9401,2012-02-01,1,1,2,14,0,3,1,1,0.62,0.6212,0.33,0.2239,33,495,159,1590,192,2085
9402,2012-02-01,1,1,2,15,0,3,1,1,0.6,0.6212,0.35,0.2836,25,375,169,1690,194,2065
9403,2012-02-01,1,1,2,16,0,3,1,1,0.6,0.6212,0.4,0.2239,22,330,261,2610,283,2940
9404,2012-02-01,1,1,2,17,0,3,1,1,0.58,0.5455,0.43,0.194,31,465,508,5080,539,5545
9405,2012-02-01,1,1,2,18,0,3,1,1,0.56,0.5303,0.46,0.1642,12,180,514,5140,526,5320
9406,2012-02-01,1,1,2,19,0,3,1,1,0.54,0.5152,0.52,0.2836,20,300,315,3150,335,3450
9407,2012-02-01,1,1,2,20,0,3,1,1,0.52,0.5,0.52,0.1642,10,150,254,2540,264,2690
9408,2012-02-01,1,1,2,21,0,3,1,1,0.52,0.5,0.52,0.1642,16,240,217,2170,233,2410
9409,2012-02-01,1,1,2,22,0,3,1,1,0.5,0.4848,0.55,0.194,7,105,133,1330,140,1435
9410,2012-02-01,1,1,2,23,0,3,1,1,0.46,0.4545,0.63,0.0896,22,330,75,750,97,1080
9411,2012-02-02,1,1,2,0,0,4,1,1,0.46,0.4545,0.59,0.1343,7,105,24,240,31,345
9412,2012-02-02,1,1,2,1,0,4,1,2,0.46,0.4545,0.55,0.0,3,45,14,140,17,185
9413,2012-02-02,1,1,2,2,0,4,1,2,0.42,0.4242,0.67,0.1343,2,30,7,70,9,100
9414,2012-02-02,1,1,2,3,0,4,1,2,0.42,0.4242,0.67,0.1343,0,0,2,20,2,20
9415,2012-02-02,1,1,2,4,0,4,1,3,0.4,0.4091,0.82,0.0896,0,0,1,10,1,10
9416,2012-02-02,1,1,2,5,0,4,1,3,0.4,0.4091,0.82,0.0,0,0,19,190,19,190
9417,2012-02-02,1,1,2,6,0,4,1,3,0.36,0.3788,0.9,0.0,1,15,73,730,74,745
9418,2012-02-02,1,1,2,7,0,4,1,3,0.36,0.3788,0.93,0.0,4,60,201,2010,205,2070
9419,2012-02-02,1,1,2,8,0,4,1,3,0.4,0.4091,0.87,0.0,9,135,436,4360,445,4495
9420,2012-02-02,1,1,2,9,0,4,1,3,0.38,0.3939,0.87,0.0,15,225,213,2130,228,2355
9421,2012-02-02,1,1,2,10,0,4,1,3,0.42,0.4242,0.77,0.1045,6,90,72,720,78,810
9422,2012-02-02,1,1,2,11,0,4,1,3,0.4,0.4091,0.82,0.2537,6,90,99,990,105,1080
9423,2012-02-02,1,1,2,12,0,4,1,1,0.42,0.4242,0.82,0.0,8,120,140,1400,148,1520
9424,2012-02-02,1,1,2,13,0,4,1,2,0.42,0.4242,0.77,0.0,13,195,124,1240,137,1435
9425,2012-02-02,1,1,2,14,0,4,1,1,0.4,0.4091,0.76,0.1045,12,180,129,1290,141,1470
9426,2012-02-02,1,1,2,15,0,4,1,1,0.46,0.4545,0.67,0.1642,24,360,150,1500,174,1860
9427,2012-02-02,1,1,2,16,0,4,1,1,0.46,0.4545,0.55,0.2836,18,270,211,2110,229,2380
9428,2012-02-02,1,1,2,17,0,4,1,1,0.42,0.4242,0.54,0.4925,13,195,437,4370,450,4565
9429,2012-02-02,1,1,2,18,0,4,1,1,0.4,0.4091,0.43,0.4627,17,255,393,3930,410,4185
9430,2012-02-02,1,1,2,19,0,4,1,1,0.38,0.3939,0.43,0.5224,16,240,311,3110,327,3350
9431,2012-02-02,1,1,2,20,0,4,1,1,0.36,0.3182,0.46,0.5224,9,135,204,2040,213,2175
9432,2012-02-02,1,1,2,21,0,4,1,1,0.34,0.303,0.46,0.4179,4,60,144,1440,148,1500
9433,2012-02-02,1,1,2,22,0,4,1,1,0.32,0.2879,0.49,0.4179,3,45,106,1060,109,1105
9434,2012-02-02,1,1,2,23,0,4,1,1,0.32,0.303,0.49,0.2537,0,0,61,610,61,610
9435,2012-02-03,1,1,2,0,0,5,1,1,0.32,0.2879,0.53,0.3881,1,15,37,370,38,385
9436,2012-02-03,1,1,2,1,0,5,1,1,0.3,0.2727,0.56,0.3284,3,45,19,190,22,235
9437,2012-02-03,1,1,2,2,0,5,1,1,0.3,0.2879,0.52,0.2239,0,0,6,60,6,60
9438,2012-02-03,1,1,2,3,0,5,1,1,0.28,0.2576,0.56,0.2985,0,0,4,40,4,40
9439,2012-02-03,1,1,2,4,0,5,1,1,0.26,0.2576,0.6,0.2239,0,0,2,20,2,20
9440,2012-02-03,1,1,2,5,0,5,1,1,0.26,0.2576,0.6,0.2239,0,0,17,170,17,170
9441,2012-02-03,1,1,2,6,0,5,1,1,0.24,0.2424,0.65,0.1642,0,0,88,880,88,880
9442,2012-02-03,1,1,2,7,0,5,1,1,0.24,0.2273,0.65,0.2239,10,150,216,2160,226,2310
9443,2012-02-03,1,1,2,8,0,5,1,1,0.24,0.2273,0.65,0.2239,12,180,429,4290,441,4470
9444,2012-02-03,1,1,2,9,0,5,1,1,0.24,0.2273,0.65,0.194,18,270,252,2520,270,2790
9445,2012-02-03,1,1,2,10,0,5,1,1,0.28,0.2576,0.56,0.2836,15,225,114,1140,129,1365
9446,2012-02-03,1,1,2,11,0,5,1,1,0.32,0.303,0.53,0.2985,15,225,149,1490,164,1715
9447,2012-02-03,1,1,2,12,0,5,1,1,0.34,0.3333,0.46,0.1343,25,375,191,1910,216,2285
9448,2012-02-03,1,1,2,13,0,5,1,1,0.36,0.3636,0.46,0.0,25,375,173,1730,198,2105
9449,2012-02-03,1,1,2,14,0,5,1,1,0.36,0.3485,0.46,0.2239,22,330,148,1480,170,1810
9450,2012-02-03,1,1,2,15,0,5,1,1,0.38,0.3939,0.4,0.0,48,720,168,1680,216,2400
9451,2012-02-03,1,1,2,16,0,5,1,1,0.4,0.4091,0.37,0.1045,36,540,275,2750,311,3290
9452,2012-02-03,1,1,2,17,0,5,1,1,0.4,0.4091,0.37,0.0896,30,450,458,4580,488,5030
9453,2012-02-03,1,1,2,18,0,5,1,1,0.38,0.3939,0.4,0.1343,17,255,368,3680,385,3935
9454,2012-02-03,1,1,2,19,0,5,1,1,0.34,0.3485,0.49,0.1045,11,165,256,2560,267,2725
9455,2012-02-03,1,1,2,20,0,5,1,1,0.34,0.3485,0.49,0.1045,8,120,155,1550,163,1670
9456,2012-02-03,1,1,2,21,0,5,1,1,0.34,0.3485,0.49,0.1045,8,120,126,1260,134,1380
9457,2012-02-03,1,1,2,22,0,5,1,1,0.34,0.3485,0.49,0.1045,3,45,116,1160,119,1205
9458,2012-02-03,1,1,2,23,0,5,1,1,0.26,0.2727,0.7,0.1045,3,45,74,740,77,785
9459,2012-02-04,1,1,2,0,0,6,0,1,0.26,0.2727,0.7,0.1045,10,150,76,760,86,910
9460,2012-02-04,1,1,2,1,0,6,0,1,0.26,0.2727,0.7,0.1045,0,0,43,430,43,430
9461,2012-02-04,1,1,2,2,0,6,0,1,0.24,0.2576,0.7,0.0896,6,90,38,380,44,470
9462,2012-02-04,1,1,2,3,0,6,0,1,0.24,0.2879,0.75,0.0,1,15,17,170,18,185
9463,2012-02-04,1,1,2,4,0,6,0,1,0.24,0.2576,0.81,0.0896,1,15,5,50,6,65
9464,2012-02-04,1,1,2,5,0,6,0,1,0.24,0.2576,0.81,0.0896,1,15,3,30,4,45
9465,2012-02-04,1,1,2,6,0,6,0,1,0.22,0.2273,0.87,0.1343,1,15,4,40,5,55
9466,2012-02-04,1,1,2,7,0,6,0,2,0.24,0.2424,0.87,0.1343,1,15,27,270,28,285
9467,2012-02-04,1,1,2,8,0,6,0,1,0.24,0.2879,0.87,0.0,4,60,86,860,90,920
9468,2012-02-04,1,1,2,9,0,6,0,1,0.24,0.2424,0.81,0.1343,16,240,141,1410,157,1650
9469,2012-02-04,1,1,2,10,0,6,0,1,0.24,0.2576,0.87,0.1045,31,465,193,1930,224,2395
9470,2012-02-04,1,1,2,11,0,6,0,1,0.3,0.3333,0.7,0.0,46,690,224,2240,270,2930
9471,2012-02-04,1,1,2,12,0,6,0,2,0.3,0.3182,0.7,0.0896,40,600,260,2600,300,3200
9472,2012-02-04,1,1,2,13,0,6,0,2,0.3,0.2879,0.7,0.194,58,870,244,2440,302,3310
9473,2012-02-04,1,1,2,14,0,6,0,2,0.32,0.303,0.66,0.2239,47,705,229,2290,276,2995
9474,2012-02-04,1,1,2,15,0,6,0,2,0.32,0.303,0.66,0.2239,61,915,244,2440,305,3355
9475,2012-02-04,1,1,2,16,0,6,0,2,0.34,0.3333,0.61,0.1642,20,300,123,1230,143,1530
9476,2012-02-04,1,1,2,17,0,6,0,3,0.3,0.2879,0.7,0.194,13,195,54,540,67,735
9477,2012-02-04,1,1,2,18,0,6,0,3,0.28,0.2727,0.75,0.1642,6,90,58,580,64,670
9478,2012-02-04,1,1,2,19,0,6,0,3,0.26,0.2727,0.87,0.1343,5,75,75,750,80,825
9479,2012-02-04,1,1,2,20,0,6,0,3,0.24,0.2273,0.93,0.194,4,60,73,730,77,790
9480,2012-02-04,1,1,2,21,0,6,0,3,0.24,0.2424,0.93,0.1343,4,60,74,740,78,800
9481,2012-02-04,1,1,2,22,0,6,0,2,0.24,0.2576,0.87,0.0896,4,60,91,910,95,970
9482,2012-02-04,1,1,2,23,0,6,0,2,0.24,0.2424,0.87,0.1343,4,60,66,660,70,720
9483,2012-02-05,1,1,2,0,0,0,0,2,0.24,0.2424,0.87,0.1343,3,45,58,580,61,625
9484,2012-02-05,1,1,2,1,0,0,0,2,0.24,0.2576,0.93,0.1045,5,75,46,460,51,535
9485,2012-02-05,1,1,2,2,0,0,0,2,0.24,0.2576,0.93,0.1045,4,60,59,590,63,650
9486,2012-02-05,1,1,2,3,0,0,0,3,0.24,0.2576,0.87,0.0896,4,60,13,130,17,190
9487,2012-02-05,1,1,2,4,0,0,0,2,0.24,0.2424,0.87,0.1343,0,0,9,90,9,90
9488,2012-02-05,1,1,2,5,0,0,0,3,0.26,0.2576,0.81,0.194,0,0,4,40,4,40
9489,2012-02-05,1,1,2,6,0,0,0,2,0.26,0.2424,0.7,0.2537,0,0,4,40,4,40
9490,2012-02-05,1,1,2,7,0,0,0,2,0.24,0.2424,0.75,0.1642,0,0,16,160,16,160
9491,2012-02-05,1,1,2,8,0,0,0,2,0.24,0.2424,0.75,0.1642,4,60,58,580,62,640
9492,2012-02-05,1,1,2,9,0,0,0,2,0.24,0.2273,0.7,0.2239,9,135,83,830,92,965
9493,2012-02-05,1,1,2,10,0,0,0,2,0.26,0.2424,0.65,0.2836,10,150,138,1380,148,1530
9494,2012-02-05,1,1,2,11,0,0,0,2,0.26,0.2576,0.7,0.194,22,330,160,1600,182,1930
9495,2012-02-05,1,1,2,12,0,0,0,2,0.26,0.2576,0.65,0.194,25,375,223,2230,248,2605
9496,2012-02-05,1,1,2,13,0,0,0,2,0.28,0.2727,0.61,0.1642,33,495,241,2410,274,2905
9497,2012-02-05,1,1,2,14,0,0,0,1,0.3,0.303,0.61,0.1642,40,600,203,2030,243,2630
9498,2012-02-05,1,1,2,15,0,0,0,2,0.3,0.2879,0.56,0.2537,55,825,217,2170,272,2995
9499,2012-02-05,1,1,2,16,0,0,0,1,0.3,0.2879,0.56,0.2239,35,525,261,2610,296,3135
9500,2012-02-05,1,1,2,17,0,0,0,1,0.32,0.3182,0.53,0.1642,31,465,275,2750,306,3215
9501,2012-02-05,1,1,2,18,0,0,0,1,0.3,0.2879,0.52,0.2537,10,150,171,1710,181,1860
9502,2012-02-05,1,1,2,19,0,0,0,1,0.3,0.2879,0.52,0.2239,6,90,63,630,69,720
9503,2012-02-05,1,1,2,20,0,0,0,1,0.28,0.2727,0.56,0.194,3,45,47,470,50,515
9504,2012-02-05,1,1,2,21,0,0,0,1,0.28,0.2879,0.56,0.1045,6,90,60,600,66,690
9505,2012-02-05,1,1,2,22,0,0,0,1,0.26,0.2727,0.6,0.1045,9,135,182,1820,191,1955
9506,2012-02-05,1,1,2,23,0,0,0,1,0.24,0.2424,0.7,0.1343,4,60,38,380,42,440
9507,2012-02-06,1,1,2,0,0,1,1,1,0.24,0.2424,0.65,0.1343,7,105,14,140,21,245
9508,2012-02-06,1,1,2,1,0,1,1,1,0.22,0.2576,0.75,0.0896,0,0,6,60,6,60
9509,2012-02-06,1,1,2,2,0,1,1,1,0.22,0.2727,0.75,0.0,0,0,3,30,3,30
9510,2012-02-06,1,1,2,4,0,1,1,1,0.18,0.2121,0.8,0.1045,0,0,2,20,2,20
9511,2012-02-06,1,1,2,5,0,1,1,1,0.18,0.2121,0.8,0.1045,0,0,17,170,17,170
9512,2012-02-06,1,1,2,6,0,1,1,1,0.16,0.1818,0.86,0.1045,0,0,72,720,72,720
9513,2012-02-06,1,1,2,7,0,1,1,1,0.16,0.1818,0.86,0.1045,5,75,229,2290,234,2365
9514,2012-02-06,1,1,2,8,0,1,1,1,0.16,0.1818,0.86,0.1343,10,150,434,4340,444,4490
9515,2012-02-06,1,1,2,9,0,1,1,1,0.18,0.2121,0.8,0.1045,8,120,269,2690,277,2810
9516,2012-02-06,1,1,2,10,0,1,1,1,0.22,0.2424,0.75,0.1045,20,300,96,960,116,1260
9517,2012-02-06,1,1,2,11,0,1,1,1,0.26,0.2727,0.7,0.1343,12,180,104,1040,116,1220
9518,2012-02-06,1,1,2,12,0,1,1,1,0.32,0.3182,0.61,0.1642,19,285,131,1310,150,1595
9519,2012-02-06,1,1,2,13,0,1,1,1,0.38,0.3939,0.4,0.2239,17,255,124,1240,141,1495
9520,2012-02-06,1,1,2,14,0,1,1,1,0.4,0.4091,0.35,0.1642,14,210,126,1260,140,1470
9521,2012-02-06,1,1,2,15,0,1,1,1,0.42,0.4242,0.32,0.2836,25,375,146,1460,171,1835
9522,2012-02-06,1,1,2,16,0,1,1,1,0.4,0.4091,0.43,0.2537,13,195,215,2150,228,2345
9523,2012-02-06,1,1,2,17,0,1,1,1,0.4,0.4091,0.43,0.2537,13,195,417,4170,430,4365
9524,2012-02-06,1,1,2,18,0,1,1,1,0.38,0.3939,0.43,0.2239,11,165,426,4260,437,4425
9525,2012-02-06,1,1,2,19,0,1,1,1,0.36,0.3333,0.43,0.2537,7,105,284,2840,291,2945
9526,2012-02-06,1,1,2,20,0,1,1,1,0.34,0.3333,0.46,0.1642,7,105,194,1940,201,2045
9527,2012-02-06,1,1,2,21,0,1,1,1,0.32,0.3182,0.57,0.1642,11,165,143,1430,154,1595
9528,2012-02-06,1,1,2,22,0,1,1,1,0.3,0.303,0.65,0.1343,4,60,83,830,87,890
9529,2012-02-06,1,1,2,23,0,1,1,1,0.3,0.303,0.65,0.1343,3,45,43,430,46,475
9530,2012-02-07,1,1,2,0,0,2,1,1,0.3,0.2879,0.7,0.194,1,15,22,220,23,235
9531,2012-02-07,1,1,2,1,0,2,1,1,0.28,0.2879,0.61,0.1343,8,120,6,60,14,180
9532,2012-02-07,1,1,2,2,0,2,1,1,0.3,0.3333,0.61,0.0,0,0,4,40,4,40
9533,2012-02-07,1,1,2,3,0,2,1,2,0.3,0.3333,0.7,0.0,1,15,1,10,2,25
9534,2012-02-07,1,1,2,4,0,2,1,2,0.3,0.3333,0.7,0.0,0,0,3,30,3,30
9535,2012-02-07,1,1,2,5,0,2,1,1,0.32,0.3333,0.49,0.0896,0,0,15,150,15,150
9536,2012-02-07,1,1,2,6,0,2,1,1,0.32,0.303,0.45,0.2985,2,30,98,980,100,1010
9537,2012-02-07,1,1,2,7,0,2,1,1,0.32,0.3485,0.45,0.0,6,90,293,2930,299,3020
9538,2012-02-07,1,1,2,8,0,2,1,1,0.3,0.3182,0.49,0.0,7,105,522,5220,529,5325
9539,2012-02-07,1,1,2,9,0,2,1,1,0.32,0.3333,0.49,0.0,11,165,278,2780,289,2945
9540,2012-02-07,1,1,2,10,0,2,1,1,0.34,0.3333,0.46,0.1642,12,180,104,1040,116,1220
9541,2012-02-07,1,1,2,11,0,2,1,1,0.36,0.3485,0.46,0.194,9,135,120,1200,129,1335
9542,2012-02-07,1,1,2,12,0,2,1,1,0.4,0.4091,0.4,0.3284,9,135,163,1630,172,1765
9543,2012-02-07,1,1,2,13,0,2,1,1,0.44,0.4394,0.38,0.2537,15,225,169,1690,184,1915
9544,2012-02-07,1,1,2,14,0,2,1,1,0.44,0.4394,0.38,0.2537,11,165,127,1270,138,1435
9545,2012-02-07,1,1,2,15,0,2,1,1,0.44,0.4394,0.38,0.194,13,195,133,1330,146,1525
9546,2012-02-07,1,1,2,16,0,2,1,1,0.44,0.4394,0.35,0.2537,19,285,257,2570,276,2855
9547,2012-02-07,1,1,2,17,0,2,1,1,0.44,0.4394,0.35,0.194,15,225,494,4940,509,5165
9548,2012-02-07,1,1,2,18,0,2,1,1,0.42,0.4242,0.38,0.194,10,150,508,5080,518,5230
9549,2012-02-07,1,1,2,19,0,2,1,1,0.38,0.3939,0.43,0.2239,11,165,327,3270,338,3435
9550,2012-02-07,1,1,2,20,0,2,1,1,0.36,0.3485,0.5,0.1343,6,90,206,2060,212,2150
9551,2012-02-07,1,1,2,21,0,2,1,1,0.34,0.3485,0.61,0.1045,20,300,170,1700,190,2000
9552,2012-02-07,1,1,2,22,0,2,1,1,0.32,0.3182,0.57,0.194,11,165,107,1070,118,1235
9553,2012-02-07,1,1,2,23,0,2,1,1,0.32,0.3333,0.57,0.1343,2,30,49,490,51,520
9554,2012-02-08,1,1,2,0,0,3,1,1,0.3,0.2879,0.56,0.2239,2,30,21,210,23,240
9555,2012-02-08,1,1,2,1,0,3,1,1,0.28,0.2727,0.61,0.1642,1,15,9,90,10,105
9556,2012-02-08,1,1,2,2,0,3,1,1,0.26,0.303,0.65,0.0,0,0,1,10,1,10
9557,2012-02-08,1,1,2,3,0,3,1,1,0.26,0.303,0.65,0.0,0,0,1,10,1,10
9558,2012-02-08,1,1,2,4,0,3,1,1,0.24,0.2576,0.7,0.0896,0,0,1,10,1,10
9559,2012-02-08,1,1,2,5,0,3,1,1,0.24,0.2576,0.7,0.0896,0,0,20,200,20,200
9560,2012-02-08,1,1,2,6,0,3,1,2,0.24,0.2879,0.7,0.0,3,45,95,950,98,995
9561,2012-02-08,1,1,2,7,0,3,1,2,0.24,0.2576,0.7,0.1045,5,75,276,2760,281,2835
9562,2012-02-08,1,1,2,8,0,3,1,2,0.24,0.2273,0.7,0.2239,13,195,495,4950,508,5145
9563,2012-02-08,1,1,2,9,0,3,1,2,0.24,0.2576,0.7,0.1642,8,120,245,2450,253,2570
9564,2012-02-08,1,1,2,10,0,3,1,2,0.26,0.2576,0.7,0.2239,1,15,107,1070,108,1085
9565,2012-02-08,1,1,2,11,0,3,1,2,0.26,0.2576,0.65,0.2239,5,75,97,970,102,1045
9566,2012-02-08,1,1,2,12,0,3,1,2,0.28,0.2576,0.65,0.2836,14,210,124,1240,138,1450
9567,2012-02-08,1,1,2,13,0,3,1,2,0.28,0.2879,0.61,0.1045,15,225,111,1110,126,1335
9568,2012-02-08,1,1,2,14,0,3,1,2,0.3,0.303,0.56,0.1642,8,120,100,1000,108,1120
9569,2012-02-08,1,1,2,15,0,3,1,3,0.3,0.3182,0.61,0.1045,5,75,49,490,54,565
9570,2012-02-08,1,1,2,16,0,3,1,3,0.26,0.2727,0.81,0.1045,2,30,73,730,75,760
9571,2012-02-08,1,1,2,17,0,3,1,3,0.24,0.2576,0.87,0.1045,8,120,147,1470,155,1590
9572,2012-02-08,1,1,2,18,0,3,1,3,0.24,0.2576,0.87,0.1045,4,60,163,1630,167,1690
9573,2012-02-08,1,1,2,19,0,3,1,3,0.24,0.2576,0.87,0.1045,3,45,158,1580,161,1625
9574,2012-02-08,1,1,2,20,0,3,1,3,0.24,0.2424,0.87,0.1343,3,45,122,1220,125,1265
9575,2012-02-08,1,1,2,21,0,3,1,3,0.24,0.2273,0.87,0.194,3,45,126,1260,129,1305
9576,2012-02-08,1,1,2,22,0,3,1,2,0.24,0.2424,0.87,0.1343,3,45,95,950,98,995
9577,2012-02-08,1,1,2,23,0,3,1,2,0.24,0.2424,0.87,0.1642,3,45,57,570,60,615
9578,2012-02-09,1,1,2,0,0,4,1,2,0.24,0.2424,0.87,0.1642,3,45,23,230,26,275
9579,2012-02-09,1,1,2,1,0,4,1,2,0.24,0.2424,0.87,0.1343,2,30,10,100,12,130
9580,2012-02-09,1,1,2,2,0,4,1,1,0.22,0.2273,0.8,0.1343,0,0,2,20,2,20
9581,2012-02-09,1,1,2,3,0,4,1,1,0.22,0.2121,0.8,0.2836,0,0,4,40,4,40
9582,2012-02-09,1,1,2,4,0,4,1,2,0.22,0.197,0.75,0.4478,0,0,1,10,1,10
9583,2012-02-09,1,1,2,5,0,4,1,1,0.2,0.1818,0.75,0.2836,0,0,18,180,18,180
9584,2012-02-09,1,1,2,6,0,4,1,1,0.2,0.1818,0.75,0.2836,1,15,75,750,76,765
9585,2012-02-09,1,1,2,7,0,4,1,1,0.2,0.197,0.69,0.2537,4,60,263,2630,267,2690
9586,2012-02-09,1,1,2,8,0,4,1,1,0.2,0.197,0.64,0.2537,11,165,473,4730,484,4895
9587,2012-02-09,1,1,2,9,0,4,1,1,0.2,0.197,0.59,0.2239,9,135,229,2290,238,2425
9588,2012-02-09,1,1,2,10,0,4,1,1,0.22,0.2121,0.51,0.2239,7,105,90,900,97,1005
9589,2012-02-09,1,1,2,11,0,4,1,1,0.24,0.2273,0.52,0.2239,4,60,95,950,99,1010
9590,2012-02-09,1,1,2,12,0,4,1,1,0.26,0.2273,0.48,0.3284,10,150,148,1480,158,1630
9591,2012-02-09,1,1,2,13,0,4,1,1,0.3,0.2727,0.42,0.3284,10,150,144,1440,154,1590
9592,2012-02-09,1,1,2,14,0,4,1,1,0.32,0.303,0.39,0.2985,18,270,126,1260,144,1530
9593,2012-02-09,1,1,2,15,0,4,1,1,0.32,0.303,0.36,0.2985,14,210,120,1200,134,1410
9594,2012-02-09,1,1,2,16,0,4,1,1,0.34,0.3333,0.36,0.0,15,225,223,2230,238,2455
9595,2012-02-09,1,1,2,17,0,4,1,1,0.34,0.3333,0.34,0.1343,12,180,387,3870,399,4050
9596,2012-02-09,1,1,2,18,0,4,1,1,0.34,0.3333,0.31,0.1642,13,195,404,4040,417,4235
9597,2012-02-09,1,1,2,19,0,4,1,1,0.32,0.3333,0.33,0.1045,8,120,287,2870,295,2990
9598,2012-02-09,1,1,2,20,0,4,1,1,0.32,0.3485,0.36,0.0,2,30,197,1970,199,2000
9599,2012-02-09,1,1,2,21,0,4,1,1,0.3,0.3182,0.52,0.0896,8,120,169,1690,177,1810
9600,2012-02-09,1,1,2,22,0,4,1,2,0.3,0.3333,0.56,0.0,3,45,104,1040,107,1085
9601,2012-02-09,1,1,2,23,0,4,1,2,0.3,0.3333,0.52,0.0,9,135,75,750,84,885
9602,2012-02-10,1,1,2,0,0,5,1,2,0.28,0.303,0.65,0.0896,4,60,39,390,43,450
9603,2012-02-10,1,1,2,1,0,5,1,2,0.28,0.303,0.61,0.0896,2,30,11,110,13,140
9604,2012-02-10,1,1,2,2,0,5,1,1,0.26,0.2879,0.52,0.0896,7,105,9,90,16,195
9605,2012-02-10,1,1,2,3,0,5,1,1,0.26,0.2879,0.56,0.0896,0,0,5,50,5,50
9606,2012-02-10,1,1,2,4,0,5,1,1,0.26,0.2879,0.56,0.0896,0,0,2,20,2,20
9607,2012-02-10,1,1,2,5,0,5,1,1,0.24,0.2273,0.52,0.2239,0,0,17,170,17,170
9608,2012-02-10,1,1,2,6,0,5,1,1,0.2,0.197,0.59,0.194,3,45,61,610,64,655
9609,2012-02-10,1,1,2,7,0,5,1,1,0.2,0.2121,0.59,0.1642,5,75,225,2250,230,2325
9610,2012-02-10,1,1,2,8,0,5,1,1,0.2,0.2121,0.59,0.1642,1,15,447,4470,448,4485
9611,2012-02-10,1,1,2,9,0,5,1,1,0.22,0.2273,0.55,0.1642,10,150,265,2650,275,2800
9612,2012-02-10,1,1,2,10,0,5,1,2,0.26,0.2727,0.48,0.1343,5,75,119,1190,124,1265
9613,2012-02-10,1,1,2,11,0,5,1,2,0.28,0.2879,0.45,0.1045,19,285,134,1340,153,1625
9614,2012-02-10,1,1,2,12,0,5,1,2,0.3,0.303,0.42,0.1343,8,120,168,1680,176,1800
9615,2012-02-10,1,1,2,13,0,5,1,2,0.3,0.3182,0.42,0.0896,22,330,170,1700,192,2030
9616,2012-02-10,1,1,2,14,0,5,1,2,0.32,0.3333,0.39,0.0896,8,120,138,1380,146,1500
9617,2012-02-10,1,1,2,15,0,5,1,2,0.32,0.3333,0.45,0.1343,27,405,164,1640,191,2045
9618,2012-02-10,1,1,2,16,0,5,1,2,0.34,0.3182,0.42,0.2537,28,420,240,2400,268,2820
9619,2012-02-10,1,1,2,17,0,5,1,2,0.34,0.3333,0.42,0.194,15,225,381,3810,396,4035
9620,2012-02-10,1,1,2,18,0,5,1,3,0.3,0.303,0.61,0.1343,14,210,345,3450,359,3660
9621,2012-02-10,1,1,2,19,0,5,1,2,0.32,0.3485,0.57,0.0,16,240,246,2460,262,2700
9622,2012-02-10,1,1,2,20,0,5,1,2,0.32,0.3485,0.57,0.0,7,105,144,1440,151,1545
9623,2012-02-10,1,1,2,21,0,5,1,2,0.32,0.3333,0.66,0.0896,14,210,108,1080,122,1290
9624,2012-02-10,1,1,2,22,0,5,1,2,0.32,0.3485,0.66,0.0,11,165,102,1020,113,1185
9625,2012-02-10,1,1,2,23,0,5,1,2,0.3,0.3182,0.7,0.0896,1,15,64,640,65,655
9626,2012-02-11,1,1,2,0,0,6,0,2,0.3,0.303,0.7,0.1343,3,45,50,500,53,545
9627,2012-02-11,1,1,2,1,0,6,0,3,0.28,0.2879,0.81,0.1343,2,30,43,430,45,460
9628,2012-02-11,1,1,2,2,0,6,0,3,0.26,0.2576,0.81,0.194,2,30,24,240,26,270
9629,2012-02-11,1,1,2,3,0,6,0,3,0.24,0.2273,0.87,0.2239,0,0,9,90,9,90
9630,2012-02-11,1,1,2,4,0,6,0,3,0.24,0.2273,0.87,0.2239,0,0,4,40,4,40
9631,2012-02-11,1,1,2,5,0,6,0,3,0.22,0.2273,0.93,0.1642,0,0,2,20,2,20
9632,2012-02-11,1,1,2,6,0,6,0,3,0.22,0.2273,0.93,0.1343,1,15,8,80,9,95
9633,2012-02-11,1,1,2,7,0,6,0,3,0.22,0.2273,0.93,0.1343,0,0,19,190,19,190
9634,2012-02-11,1,1,2,8,0,6,0,3,0.22,0.2273,0.93,0.1343,1,15,77,770,78,785
9635,2012-02-11,1,1,2,9,0,6,0,3,0.22,0.2424,0.93,0.1045,5,75,85,850,90,925
9636,2012-02-11,1,1,2,10,0,6,0,3,0.22,0.2424,0.93,0.1045,23,345,143,1430,166,1775
9637,2012-02-11,1,1,2,11,0,6,0,2,0.24,0.2576,0.81,0.1045,26,390,157,1570,183,1960
9638,2012-02-11,1,1,2,12,0,6,0,2,0.26,0.2576,0.81,0.1642,25,375,196,1960,221,2335
9639,2012-02-11,1,1,2,13,0,6,0,2,0.26,0.2424,0.81,0.2836,18,270,217,2170,235,2440
9640,2012-02-11,1,1,2,14,0,6,0,2,0.26,0.2424,0.81,0.2537,38,570,205,2050,243,2620
9641,2012-02-11,1,1,2,15,0,6,0,2,0.3,0.2727,0.61,0.2985,12,180,112,1120,124,1300
9642,2012-02-11,1,1,2,16,0,6,0,3,0.22,0.197,0.75,0.4179,12,180,134,1340,146,1520
9643,2012-02-11,1,1,2,17,0,6,0,3,0.22,0.1818,0.69,0.4627,13,195,131,1310,144,1505
9644,2012-02-11,1,1,2,18,0,6,0,2,0.22,0.1818,0.47,0.6567,3,45,105,1050,108,1095
9645,2012-02-11,1,1,2,19,0,6,0,2,0.2,0.1515,0.4,0.5522,2,30,85,850,87,880
9646,2012-02-11,1,1,2,20,0,6,0,2,0.16,0.1212,0.43,0.5522,1,15,62,620,63,635
9647,2012-02-11,1,1,2,21,0,6,0,1,0.14,0.0758,0.43,0.6418,5,75,43,430,48,505
9648,2012-02-11,1,1,2,22,0,6,0,2,0.14,0.1061,0.39,0.3881,0,0,46,460,46,460
9649,2012-02-11,1,1,2,23,0,6,0,3,0.12,0.0758,0.5,0.4925,0,0,20,200,20,200
9650,2012-02-12,1,1,2,0,0,0,0,3,0.1,0.0758,0.68,0.3881,0,0,21,210,21,210
9651,2012-02-12,1,1,2,1,0,0,0,3,0.08,0.0455,0.79,0.4627,0,0,24,240,24,240
9652,2012-02-12,1,1,2,2,0,0,0,2,0.1,0.0606,0.58,0.5821,1,15,26,260,27,275
9653,2012-02-12,1,1,2,3,0,0,0,2,0.1,0.0455,0.46,0.6866,0,0,14,140,14,140
9654,2012-02-12,1,1,2,4,0,0,0,2,0.1,0.0455,0.46,0.7164,0,0,1,10,1,10
9655,2012-02-12,1,1,2,5,0,0,0,1,0.1,0.0758,0.49,0.3881,0,0,3,30,3,30
9656,2012-02-12,1,1,2,6,0,0,0,1,0.1,0.0758,0.49,0.3881,0,0,2,20,2,20
9657,2012-02-12,1,1,2,7,0,0,0,1,0.08,0.0909,0.53,0.194,0,0,18,180,18,180
9658,2012-02-12,1,1,2,8,0,0,0,1,0.08,0.0758,0.53,0.2537,0,0,26,260,26,260
9659,2012-02-12,1,1,2,9,0,0,0,1,0.1,0.0909,0.49,0.2985,3,45,60,600,63,645
9660,2012-02-12,1,1,2,10,0,0,0,1,0.12,0.1061,0.42,0.3582,8,120,83,830,91,950
9661,2012-02-12,1,1,2,11,0,0,0,1,0.12,0.1061,0.42,0.2985,3,45,121,1210,124,1255
9662,2012-02-12,1,1,2,12,0,0,0,1,0.14,0.0758,0.39,0.6418,7,105,133,1330,140,1435
9663,2012-02-12,1,1,2,13,0,0,0,1,0.16,0.1212,0.4,0.4478,10,150,128,1280,138,1430
9664,2012-02-12,1,1,2,14,0,0,0,1,0.16,0.1212,0.4,0.5224,9,135,102,1020,111,1155
9665,2012-02-12,1,1,2,15,0,0,0,1,0.16,0.1212,0.4,0.5522,5,75,150,1500,155,1575
9666,2012-02-12,1,1,2,16,0,0,0,1,0.2,0.1667,0.34,0.4627,16,240,148,1480,164,1720
9667,2012-02-12,1,1,2,17,0,0,0,1,0.18,0.1515,0.37,0.4179,4,60,83,830,87,890
9668,2012-02-12,1,1,2,18,0,0,0,1,0.16,0.1212,0.4,0.4627,4,60,92,920,96,980
9669,2012-02-12,1,1,2,19,0,0,0,1,0.16,0.1364,0.4,0.2836,2,30,78,780,80,810
9670,2012-02-12,1,1,2,20,0,0,0,1,0.14,0.1212,0.42,0.3284,1,15,56,560,57,575
9671,2012-02-12,1,1,2,21,0,0,0,1,0.14,0.1212,0.43,0.2985,0,0,36,360,36,360
9672,2012-02-12,1,1,2,22,0,0,0,1,0.14,0.1515,0.43,0.1642,0,0,28,280,28,280
9673,2012-02-12,1,1,2,23,0,0,0,1,0.14,0.1364,0.43,0.2239,0,0,23,230,23,230
9674,2012-02-13,1,1,2,0,0,1,1,1,0.14,0.1364,0.46,0.2239,0,0,9,90,9,90
9675,2012-02-13,1,1,2,1,0,1,1,1,0.12,0.1212,0.5,0.2239,0,0,6,60,6,60
9676,2012-02-13,1,1,2,2,0,1,1,1,0.14,0.1364,0.46,0.194,0,0,4,40,4,40
9677,2012-02-13,1,1,2,3,0,1,1,1,0.12,0.1515,0.54,0.1045,0,0,1,10,1,10
9678,2012-02-13,1,1,2,4,0,1,1,1,0.12,0.1667,0.54,0.0896,0,0,2,20,2,20
9679,2012-02-13,1,1,2,5,0,1,1,1,0.1,0.1212,0.58,0.1343,0,0,17,170,17,170
9680,2012-02-13,1,1,2,6,0,1,1,1,0.1,0.1061,0.54,0.2239,1,15,71,710,72,725
9681,2012-02-13,1,1,2,7,0,1,1,1,0.1,0.1061,0.54,0.194,1,15,194,1940,195,1955
9682,2012-02-13,1,1,2,8,0,1,1,1,0.1,0.1212,0.54,0.1343,4,60,413,4130,417,4190
9683,2012-02-13,1,1,2,9,0,1,1,1,0.12,0.1364,0.5,0.194,7,105,198,1980,205,2085
9684,2012-02-13,1,1,2,10,0,1,1,1,0.14,0.1515,0.5,0.1343,1,15,70,700,71,715
9685,2012-02-13,1,1,2,11,0,1,1,1,0.22,0.2273,0.37,0.194,5,75,85,850,90,925
9686,2012-02-13,1,1,2,12,0,1,1,1,0.28,0.2576,0.28,0.3284,7,105,111,1110,118,1215
9687,2012-02-13,1,1,2,13,0,1,1,1,0.32,0.303,0.22,0.2239,11,165,129,1290,140,1455
9688,2012-02-13,1,1,2,14,0,1,1,1,0.34,0.3485,0.23,0.1045,10,150,125,1250,135,1400
9689,2012-02-13,1,1,2,15,0,1,1,1,0.36,0.3485,0.27,0.1343,10,150,145,1450,155,1600
9690,2012-02-13,1,1,2,16,0,1,1,1,0.36,0.3485,0.23,0.194,5,75,206,2060,211,2135
9691,2012-02-13,1,1,2,17,0,1,1,1,0.36,0.3485,0.23,0.194,8,120,399,3990,407,4110
9692,2012-02-13,1,1,2,18,0,1,1,1,0.34,0.3182,0.25,0.2537,6,90,399,3990,405,4080
9693,2012-02-13,1,1,2,19,0,1,1,1,0.34,0.3333,0.25,0.1343,7,105,256,2560,263,2665
9694,2012-02-13,1,1,2,20,0,1,1,1,0.3,0.303,0.42,0.1642,4,60,210,2100,214,2160
9695,2012-02-13,1,1,2,21,0,1,1,1,0.28,0.2879,0.45,0.1343,2,30,145,1450,147,1480
9696,2012-02-13,1,1,2,22,0,1,1,1,0.26,0.2727,0.56,0.1045,3,45,99,990,102,1035
9697,2012-02-13,1,1,2,23,0,1,1,1,0.28,0.3182,0.41,0.0,2,30,34,340,36,370
9698,2012-02-14,1,1,2,0,0,2,1,2,0.26,0.303,0.6,0.0,0,0,14,140,14,140
9699,2012-02-14,1,1,2,1,0,2,1,2,0.26,0.303,0.56,0.0,0,0,6,60,6,60
9700,2012-02-14,1,1,2,2,0,2,1,2,0.28,0.3182,0.41,0.0,0,0,3,30,3,30
9701,2012-02-14,1,1,2,3,0,2,1,2,0.26,0.303,0.52,0.0,0,0,3,30,3,30
9702,2012-02-14,1,1,2,4,0,2,1,2,0.26,0.2727,0.65,0.1045,0,0,2,20,2,20
9703,2012-02-14,1,1,2,5,0,2,1,2,0.26,0.2727,0.65,0.1045,2,30,20,200,22,230
9704,2012-02-14,1,1,2,6,0,2,1,2,0.26,0.303,0.56,0.0,1,15,89,890,90,905
9705,2012-02-14,1,1,2,7,0,2,1,2,0.24,0.2576,0.6,0.0896,4,60,276,2760,280,2820
9706,2012-02-14,1,1,2,8,0,2,1,2,0.24,0.2879,0.7,0.0,3,45,510,5100,513,5145
9707,2012-02-14,1,1,2,9,0,2,1,2,0.26,0.2879,0.56,0.0896,6,90,256,2560,262,2650
9708,2012-02-14,1,1,2,10,0,2,1,2,0.26,0.2727,0.6,0.1343,8,120,90,900,98,1020
9709,2012-02-14,1,1,2,11,0,2,1,2,0.3,0.303,0.45,0.1642,5,75,107,1070,112,1145
9710,2012-02-14,1,1,2,12,0,2,1,2,0.3,0.2879,0.52,0.2239,10,150,162,1620,172,1770
9711,2012-02-14,1,1,2,13,0,2,1,2,0.36,0.3333,0.4,0.2537,6,90,167,1670,173,1760
9712,2012-02-14,1,1,2,14,0,2,1,1,0.4,0.4091,0.4,0.2239,13,195,111,1110,124,1305
9713,2012-02-14,1,1,2,15,0,2,1,2,0.42,0.4242,0.38,0.4478,7,105,138,1380,145,1485
9714,2012-02-14,1,1,2,16,0,2,1,1,0.42,0.4242,0.35,0.2985,15,225,251,2510,266,2735
9715,2012-02-14,1,1,2,17,0,2,1,1,0.42,0.4242,0.38,0.3582,19,285,504,5040,523,5325
9716,2012-02-14,1,1,2,18,0,2,1,2,0.38,0.3939,0.46,0.2985,8,120,398,3980,406,4100
9717,2012-02-14,1,1,2,19,0,2,1,2,0.36,0.3485,0.5,0.1642,11,165,270,2700,281,2865
9718,2012-02-14,1,1,2,20,0,2,1,2,0.38,0.3939,0.46,0.1343,6,90,178,1780,184,1870
9719,2012-02-14,1,1,2,21,0,2,1,2,0.36,0.3636,0.5,0.1045,4,60,105,1050,109,1110
9720,2012-02-14,1,1,2,22,0,2,1,2,0.36,0.3636,0.5,0.1045,5,75,72,720,77,795
9721,2012-02-14,1,1,2,23,0,2,1,2,0.36,0.3636,0.5,0.0896,2,30,55,550,57,580
9722,2012-02-15,1,1,2,0,0,3,1,1,0.32,0.3485,0.57,0.0,0,0,22,220,22,220
9723,2012-02-15,1,1,2,1,0,3,1,1,0.34,0.3636,0.53,0.0,0,0,5,50,5,50
9724,2012-02-15,1,1,2,2,0,3,1,1,0.3,0.3333,0.61,0.0,0,0,4,40,4,40
9725,2012-02-15,1,1,2,3,0,3,1,1,0.28,0.3182,0.75,0.0,0,0,3,30,3,30
9726,2012-02-15,1,1,2,4,0,3,1,1,0.28,0.2879,0.7,0.1045,0,0,1,10,1,10
9727,2012-02-15,1,1,2,5,0,3,1,1,0.28,0.2879,0.7,0.1045,0,0,25,250,25,250
9728,2012-02-15,1,1,2,6,0,3,1,1,0.3,0.303,0.61,0.1343,3,45,92,920,95,965
9729,2012-02-15,1,1,2,7,0,3,1,2,0.3,0.2879,0.65,0.194,3,45,318,3180,321,3225
9730,2012-02-15,1,1,2,8,0,3,1,1,0.32,0.2879,0.61,0.3582,7,105,508,5080,515,5185
9731,2012-02-15,1,1,2,9,0,3,1,1,0.32,0.303,0.61,0.3284,5,75,226,2260,231,2335
9732,2012-02-15,1,1,2,10,0,3,1,1,0.34,0.303,0.57,0.2985,12,180,108,1080,120,1260
9733,2012-02-15,1,1,2,11,0,3,1,1,0.36,0.3333,0.53,0.2836,13,195,125,1250,138,1445
9734,2012-02-15,1,1,2,12,0,3,1,1,0.38,0.3939,0.46,0.3881,11,165,152,1520,163,1685
9735,2012-02-15,1,1,2,13,0,3,1,1,0.4,0.4091,0.43,0.2836,11,165,159,1590,170,1755
9736,2012-02-15,1,1,2,14,0,3,1,1,0.42,0.4242,0.41,0.3582,6,90,128,1280,134,1370
9737,2012-02-15,1,1,2,15,0,3,1,1,0.42,0.4242,0.41,0.2239,7,105,164,1640,171,1745
9738,2012-02-15,1,1,2,16,0,3,1,1,0.42,0.4242,0.38,0.194,9,135,222,2220,231,2355
9739,2012-02-15,1,1,2,17,0,3,1,1,0.42,0.4242,0.38,0.194,17,255,470,4700,487,4955
9740,2012-02-15,1,1,2,18,0,3,1,1,0.4,0.4091,0.4,0.2239,9,135,459,4590,468,4725
9741,2012-02-15,1,1,2,19,0,3,1,1,0.38,0.3939,0.43,0.1642,9,135,302,3020,311,3155
9742,2012-02-15,1,1,2,20,0,3,1,1,0.36,0.3485,0.46,0.1642,4,60,207,2070,211,2130
9743,2012-02-15,1,1,2,21,0,3,1,1,0.34,0.3333,0.53,0.1642,8,120,170,1700,178,1820
9744,2012-02-15,1,1,2,22,0,3,1,1,0.34,0.3485,0.49,0.1045,3,45,104,1040,107,1085
9745,2012-02-15,1,1,2,23,0,3,1,1,0.34,0.3485,0.53,0.0896,4,60,54,540,58,600
9746,2012-02-16,1,1,2,0,0,4,1,2,0.3,0.303,0.7,0.1343,1,15,22,220,23,235
9747,2012-02-16,1,1,2,1,0,4,1,2,0.3,0.3333,0.7,0.0,0,0,5,50,5,50
9748,2012-02-16,1,1,2,2,0,4,1,2,0.3,0.3182,0.7,0.0896,1,15,6,60,7,75
9749,2012-02-16,1,1,2,3,0,4,1,2,0.3,0.3333,0.61,0.0,0,0,1,10,1,10
9750,2012-02-16,1,1,2,4,0,4,1,3,0.3,0.3182,0.7,0.0896,0,0,3,30,3,30
9751,2012-02-16,1,1,2,5,0,4,1,2,0.3,0.3333,0.7,0.0,0,0,20,200,20,200
9752,2012-02-16,1,1,2,6,0,4,1,2,0.3,0.3182,0.7,0.0896,4,60,83,830,87,890
9753,2012-02-16,1,1,2,7,0,4,1,2,0.3,0.303,0.7,0.1343,3,45,285,2850,288,2895
9754,2012-02-16,1,1,2,8,0,4,1,2,0.3,0.3182,0.7,0.0896,9,135,489,4890,498,5025
9755,2012-02-16,1,1,2,9,0,4,1,2,0.3,0.303,0.7,0.1642,3,45,199,1990,202,2035
9756,2012-02-16,1,1,2,10,0,4,1,3,0.32,0.3333,0.7,0.1343,2,30,42,420,44,450
9757,2012-02-16,1,1,2,11,0,4,1,3,0.32,0.3333,0.7,0.1045,2,30,69,690,71,720
9758,2012-02-16,1,1,2,12,0,4,1,3,0.32,0.3333,0.76,0.0896,1,15,44,440,45,455
9759,2012-02-16,1,1,2,13,0,4,1,3,0.34,0.3182,0.71,0.2537,2,30,62,620,64,650
9760,2012-02-16,1,1,2,14,0,4,1,3,0.32,0.3182,0.81,0.194,1,15,30,300,31,315
9761,2012-02-16,1,1,2,15,0,4,1,3,0.34,0.3636,0.76,0.0,3,45,50,500,53,545
9762,2012-02-16,1,1,2,16,0,4,1,3,0.34,0.3636,0.81,0.0,8,120,110,1100,118,1220
9763,2012-02-16,1,1,2,17,0,4,1,3,0.34,0.3636,0.87,0.0,8,120,281,2810,289,2930
9764,2012-02-16,1,1,2,18,0,4,1,3,0.34,0.3333,0.87,0.1343,8,120,345,3450,353,3570
9765,2012-02-16,1,1,2,19,0,4,1,2,0.32,0.3182,0.87,0.1642,4,60,254,2540,258,2600
9766,2012-02-16,1,1,2,20,0,4,1,2,0.32,0.3333,0.87,0.1343,5,75,211,2110,216,2185
9767,2012-02-16,1,1,2,21,0,4,1,2,0.34,0.3485,0.81,0.1045,3,45,142,1420,145,1465
9768,2012-02-16,1,1,2,22,0,4,1,2,0.32,0.3485,0.81,0.0,3,45,108,1080,111,1125
9769,2012-02-16,1,1,2,23,0,4,1,1,0.32,0.3333,0.81,0.0896,3,45,70,700,73,745
9770,2012-02-17,1,1,2,0,0,5,1,2,0.3,0.3333,0.87,0.0,2,30,32,320,34,350
9771,2012-02-17,1,1,2,1,0,5,1,2,0.3,0.3333,0.93,0.0,2,30,16,160,18,190
9772,2012-02-17,1,1,2,2,0,5,1,2,0.3,0.3182,0.93,0.1045,1,15,11,110,12,125
9773,2012-02-17,1,1,2,3,0,5,1,2,0.28,0.2879,0.93,0.1045,0,0,1,10,1,10
9774,2012-02-17,1,1,2,4,0,5,1,2,0.28,0.2727,0.93,0.194,0,0,1,10,1,10
9775,2012-02-17,1,1,2,5,0,5,1,2,0.28,0.2727,0.93,0.1642,0,0,16,160,16,160
9776,2012-02-17,1,1,2,6,0,5,1,2,0.28,0.2879,0.96,0.1343,1,15,70,700,71,715
9777,2012-02-17,1,1,2,7,0,5,1,2,0.28,0.2879,0.93,0.1045,4,60,222,2220,226,2280
9778,2012-02-17,1,1,2,8,0,5,1,2,0.26,0.303,1.0,0.0,4,60,516,5160,520,5220
9779,2012-02-17,1,1,2,9,0,5,1,2,0.26,0.303,1.0,0.0,8,120,275,2750,283,2870
9780,2012-02-17,1,1,2,10,0,5,1,1,0.34,0.3182,0.71,0.2836,13,195,103,1030,116,1225
9781,2012-02-17,1,1,2,11,0,5,1,1,0.36,0.3333,0.62,0.4179,9,135,133,1330,142,1465
9782,2012-02-17,1,1,2,12,0,5,1,1,0.38,0.3939,0.46,0.3881,21,315,177,1770,198,2085
9783,2012-02-17,1,1,2,13,0,5,1,1,0.4,0.4091,0.43,0.3582,34,510,171,1710,205,2220
9784,2012-02-17,1,1,2,14,0,5,1,1,0.4,0.4091,0.37,0.3582,33,495,137,1370,170,1865
9785,2012-02-17,1,1,2,15,0,5,1,1,0.42,0.4242,0.35,0.4179,41,615,180,1800,221,2415
9786,2012-02-17,1,1,2,16,0,5,1,1,0.42,0.4242,0.32,0.2985,56,840,251,2510,307,3350
9787,2012-02-17,1,1,2,17,0,5,1,1,0.42,0.4242,0.32,0.3284,36,540,429,4290,465,4830
9788,2012-02-17,1,1,2,18,0,5,1,1,0.4,0.4091,0.35,0.2537,15,225,362,3620,377,3845
9789,2012-02-17,1,1,2,19,0,5,1,1,0.38,0.3939,0.37,0.2239,16,240,266,2660,282,2900
9790,2012-02-17,1,1,2,20,0,5,1,1,0.4,0.4091,0.35,0.194,13,195,158,1580,171,1775
9791,2012-02-17,1,1,2,21,0,5,1,1,0.38,0.3939,0.37,0.194,15,225,114,1140,129,1365
9792,2012-02-17,1,1,2,22,0,5,1,1,0.36,0.3485,0.4,0.2239,15,225,92,920,107,1145
9793,2012-02-17,1,1,2,23,0,5,1,1,0.36,0.3485,0.4,0.194,10,150,72,720,82,870
9794,2012-02-18,1,1,2,0,0,6,0,1,0.34,0.3333,0.42,0.1642,5,75,81,810,86,885
9795,2012-02-18,1,1,2,1,0,6,0,1,0.32,0.3182,0.49,0.1642,7,105,38,380,45,485
9796,2012-02-18,1,1,2,2,0,6,0,1,0.3,0.2879,0.61,0.2537,6,90,39,390,45,480
9797,2012-02-18,1,1,2,3,0,6,0,1,0.28,0.2879,0.65,0.1045,3,45,15,150,18,195
9798,2012-02-18,1,1,2,4,0,6,0,1,0.26,0.303,0.7,0.0,3,45,4,40,7,85
9799,2012-02-18,1,1,2,5,0,6,0,1,0.24,0.2576,0.7,0.0896,0,0,1,10,1,10
9800,2012-02-18,1,1,2,6,0,6,0,1,0.24,0.2879,0.7,0.0,1,15,8,80,9,95
9801,2012-02-18,1,1,2,7,0,6,0,1,0.24,0.2879,0.7,0.0,8,120,33,330,41,450
9802,2012-02-18,1,1,2,8,0,6,0,1,0.22,0.2727,0.87,0.0,10,150,92,920,102,1070
9803,2012-02-18,1,1,2,9,0,6,0,1,0.22,0.2424,0.8,0.1045,22,330,116,1160,138,1490
9804,2012-02-18,1,1,2,10,0,6,0,1,0.26,0.2727,0.81,0.1045,48,720,157,1570,205,2290
9805,2012-02-18,1,1,2,11,0,6,0,1,0.32,0.3333,0.57,0.1343,102,1530,184,1840,286,3370
9806,2012-02-18,1,1,2,12,0,6,0,1,0.36,0.3485,0.43,0.194,128,1920,241,2410,369,4330
9807,2012-02-18,1,1,2,13,0,6,0,1,0.4,0.4091,0.43,0.2836,165,2475,219,2190,384,4665
9808,2012-02-18,1,1,2,14,0,6,0,1,0.44,0.4394,0.35,0.3582,183,2745,244,2440,427,5185
9809,2012-02-18,1,1,2,15,0,6,0,1,0.42,0.4242,0.41,0.2537,229,3435,270,2700,499,6135
9810,2012-02-18,1,1,2,16,0,6,0,1,0.44,0.4394,0.44,0.3284,186,2790,218,2180,404,4970
9811,2012-02-18,1,1,2,17,0,6,0,1,0.48,0.4697,0.36,0.2836,142,2130,222,2220,364,4350
9812,2012-02-18,1,1,2,18,0,6,0,1,0.46,0.4545,0.38,0.2985,70,1050,176,1760,246,2810
9813,2012-02-18,1,1,2,19,0,6,0,1,0.44,0.4394,0.44,0.1642,38,570,150,1500,188,2070
9814,2012-02-18,1,1,2,20,0,6,0,1,0.44,0.4394,0.44,0.1642,25,375,123,1230,148,1605
9815,2012-02-18,1,1,2,21,0,6,0,1,0.44,0.4394,0.33,0.2985,25,375,89,890,114,1265
9816,2012-02-18,1,1,2,22,0,6,0,1,0.4,0.4091,0.4,0.4478,17,255,101,1010,118,1265
9817,2012-02-18,1,1,2,23,0,6,0,2,0.36,0.3333,0.4,0.3881,12,180,62,620,74,800
9818,2012-02-19,1,1,2,0,0,0,0,2,0.34,0.303,0.39,0.3582,9,135,65,650,74,785
9819,2012-02-19,1,1,2,1,0,0,0,2,0.32,0.303,0.39,0.2537,10,150,62,620,72,770
9820,2012-02-19,1,1,2,2,0,0,0,2,0.3,0.2879,0.36,0.2836,3,45,45,450,48,495
9821,2012-02-19,1,1,2,3,0,0,0,2,0.3,0.2879,0.36,0.2239,3,45,12,120,15,165
9822,2012-02-19,1,1,2,4,0,0,0,2,0.28,0.2576,0.41,0.3881,0,0,3,30,3,30
9823,2012-02-19,1,1,2,5,0,0,0,2,0.26,0.2273,0.48,0.2985,1,15,1,10,2,25
9824,2012-02-19,1,1,2,6,0,0,0,1,0.24,0.2121,0.52,0.3284,0,0,5,50,5,50
9825,2012-02-19,1,1,2,7,0,0,0,2,0.24,0.2121,0.52,0.2836,2,30,12,120,14,150
9826,2012-02-19,1,1,2,8,0,0,0,2,0.24,0.2273,0.56,0.194,8,120,48,480,56,600
9827,2012-02-19,1,1,2,9,0,0,0,2,0.24,0.2273,0.56,0.2537,20,300,73,730,93,1030
9828,2012-02-19,1,1,2,10,0,0,0,2,0.26,0.2424,0.52,0.2537,49,735,142,1420,191,2155
9829,2012-02-19,1,1,2,11,0,0,0,2,0.26,0.2273,0.56,0.3284,82,1230,144,1440,226,2670
9830,2012-02-19,1,1,2,12,0,0,0,2,0.28,0.2727,0.52,0.2537,71,1065,184,1840,255,2905
9831,2012-02-19,1,1,2,13,0,0,0,1,0.3,0.303,0.49,0.1642,64,960,197,1970,261,2930
9832,2012-02-19,1,1,2,14,0,0,0,2,0.32,0.3182,0.45,0.194,48,720,189,1890,237,2610
9833,2012-02-19,1,1,2,15,0,0,0,2,0.3,0.2879,0.49,0.194,85,1275,168,1680,253,2955
9834,2012-02-19,1,1,2,16,0,0,0,2,0.32,0.303,0.45,0.2836,62,930,150,1500,212,2430
9835,2012-02-19,1,1,2,17,0,0,0,2,0.3,0.2879,0.49,0.2537,22,330,135,1350,157,1680
9836,2012-02-19,1,1,2,18,0,0,0,2,0.3,0.2727,0.49,0.3284,23,345,144,1440,167,1785
9837,2012-02-19,1,1,2,19,0,0,0,2,0.3,0.2879,0.52,0.2537,18,270,101,1010,119,1280
9838,2012-02-19,1,1,2,20,0,0,0,2,0.3,0.2879,0.52,0.2836,22,330,81,810,103,1140
9839,2012-02-19,1,1,2,21,0,0,0,3,0.26,0.2576,0.65,0.1642,3,45,33,330,36,375
9840,2012-02-19,1,1,2,22,0,0,0,3,0.24,0.2576,0.75,0.0896,8,120,47,470,55,590
9841,2012-02-19,1,1,2,23,0,0,0,2,0.22,0.2273,0.93,0.1642,5,75,30,300,35,375
9842,2012-02-20,1,1,2,0,1,1,0,2,0.24,0.2576,0.87,0.0896,5,75,36,360,41,435
9843,2012-02-20,1,1,2,1,1,1,0,2,0.24,0.2576,0.87,0.0896,3,45,12,120,15,165
9844,2012-02-20,1,1,2,2,1,1,0,2,0.24,0.2576,0.87,0.0896,1,15,19,190,20,205
9845,2012-02-20,1,1,2,3,1,1,0,2,0.24,0.2273,0.81,0.194,0,0,8,80,8,80
9846,2012-02-20,1,1,2,5,1,1,0,2,0.24,0.2121,0.6,0.3582,0,0,6,60,6,60
9847,2012-02-20,1,1,2,6,1,1,0,1,0.24,0.197,0.52,0.4179,1,15,9,90,10,105
9848,2012-02-20,1,1,2,7,1,1,0,2,0.22,0.197,0.55,0.3284,2,30,42,420,44,450
9849,2012-02-20,1,1,2,8,1,1,0,1,0.2,0.1818,0.59,0.3582,9,135,111,1110,120,1245
9850,2012-02-20,1,1,2,9,1,1,0,1,0.2,0.1818,0.59,0.3582,12,180,98,980,110,1160
9851,2012-02-20,1,1,2,10,1,1,0,1,0.22,0.197,0.55,0.4478,30,450,113,1130,143,1580
9852,2012-02-20,1,1,2,11,1,1,0,1,0.26,0.2273,0.48,0.3582,45,675,163,1630,208,2305
9853,2012-02-20,1,1,2,12,1,1,0,1,0.28,0.2727,0.45,0.2239,65,975,216,2160,281,3135
9854,2012-02-20,1,1,2,13,1,1,0,1,0.3,0.2879,0.42,0.2836,66,990,246,2460,312,3450
9855,2012-02-20,1,1,2,14,1,1,0,1,0.32,0.3182,0.36,0.194,57,855,206,2060,263,2915
9856,2012-02-20,1,1,2,15,1,1,0,1,0.34,0.3182,0.34,0.2239,54,810,235,2350,289,3160
9857,2012-02-20,1,1,2,16,1,1,0,1,0.36,0.3788,0.29,0.1045,64,960,216,2160,280,3120
9858,2012-02-20,1,1,2,17,1,1,0,1,0.38,0.3939,0.27,0.2537,27,405,226,2260,253,2665
9859,2012-02-20,1,1,2,18,1,1,0,1,0.34,0.3182,0.34,0.2239,27,405,215,2150,242,2555
9860,2012-02-20,1,1,2,19,1,1,0,1,0.34,0.3182,0.34,0.2239,8,120,164,1640,172,1760
9861,2012-02-20,1,1,2,20,1,1,0,1,0.34,0.3333,0.34,0.194,9,135,117,1170,126,1305
9862,2012-02-20,1,1,2,21,1,1,0,1,0.3,0.303,0.39,0.1642,8,120,90,900,98,1020
9863,2012-02-20,1,1,2,22,1,1,0,1,0.3,0.3182,0.45,0.0896,9,135,53,530,62,665
9864,2012-02-20,1,1,2,23,1,1,0,1,0.3,0.3333,0.39,0.0,0,0,26,260,26,260
9865,2012-02-21,1,1,2,0,0,2,1,1,0.26,0.303,0.65,0.0,1,15,11,110,12,125
9866,2012-02-21,1,1,2,1,0,2,1,1,0.26,0.303,0.56,0.0,0,0,7,70,7,70
9867,2012-02-21,1,1,2,2,0,2,1,1,0.24,0.2879,0.6,0.0,0,0,3,30,3,30
9868,2012-02-21,1,1,2,4,0,2,1,1,0.22,0.2727,0.64,0.0,0,0,2,20,2,20
9869,2012-02-21,1,1,2,5,0,2,1,1,0.2,0.2576,0.69,0.0,0,0,15,150,15,150
9870,2012-02-21,1,1,2,6,0,2,1,1,0.2,0.2576,0.75,0.0,3,45,83,830,86,875
9871,2012-02-21,1,1,2,7,0,2,1,1,0.22,0.2727,0.64,0.0,6,90,273,2730,279,2820
9872,2012-02-21,1,1,2,8,0,2,1,1,0.2,0.2273,0.69,0.0896,5,75,459,4590,464,4665
9873,2012-02-21,1,1,2,9,0,2,1,1,0.2,0.2273,0.75,0.1045,6,90,211,2110,217,2200
9874,2012-02-21,1,1,2,10,0,2,1,1,0.24,0.2273,0.7,0.194,8,120,77,770,85,890
9875,2012-02-21,1,1,2,11,0,2,1,2,0.26,0.2424,0.7,0.2836,5,75,81,810,86,885
9876,2012-02-21,1,1,2,12,0,2,1,2,0.3,0.2727,0.56,0.3881,16,240,147,1470,163,1710
9877,2012-02-21,1,1,2,13,0,2,1,1,0.34,0.303,0.49,0.4179,8,120,123,1230,131,1350
9878,2012-02-21,1,1,2,14,0,2,1,2,0.32,0.2879,0.53,0.3881,16,240,108,1080,124,1320
9879,2012-02-21,1,1,2,15,0,2,1,1,0.34,0.303,0.49,0.4179,23,345,137,1370,160,1715
9880,2012-02-21,1,1,2,16,0,2,1,1,0.36,0.3333,0.46,0.4179,14,210,240,2400,254,2610
9881,2012-02-21,1,1,2,17,0,2,1,1,0.38,0.3939,0.4,0.4478,21,315,411,4110,432,4425
9882,2012-02-21,1,1,2,18,0,2,1,1,0.38,0.3939,0.4,0.4478,11,165,414,4140,425,4305
9883,2012-02-21,1,1,2,19,0,2,1,1,0.36,0.3333,0.46,0.2985,5,75,299,2990,304,3065
9884,2012-02-21,1,1,2,20,0,2,1,1,0.34,0.3182,0.53,0.2537,4,60,223,2230,227,2290
9885,2012-02-21,1,1,2,21,0,2,1,1,0.34,0.3333,0.61,0.1642,7,105,147,1470,154,1575
9886,2012-02-21,1,1,2,22,0,2,1,2,0.34,0.3333,0.71,0.194,3,45,97,970,100,1015
9887,2012-02-21,1,1,2,23,0,2,1,1,0.32,0.303,0.66,0.2239,1,15,46,460,47,475
9888,2012-02-22,1,1,2,0,0,3,1,1,0.32,0.303,0.66,0.2239,5,75,19,190,24,265
9889,2012-02-22,1,1,2,1,0,3,1,1,0.32,0.3333,0.7,0.1343,3,45,4,40,7,85
9890,2012-02-22,1,1,2,2,0,3,1,1,0.34,0.3182,0.66,0.2836,1,15,5,50,6,65
9891,2012-02-22,1,1,2,3,0,3,1,2,0.34,0.3182,0.71,0.2239,1,15,3,30,4,45
9892,2012-02-22,1,1,2,4,0,3,1,1,0.34,0.3333,0.71,0.1642,0,0,2,20,2,20
9893,2012-02-22,1,1,2,5,0,3,1,1,0.32,0.3333,0.7,0.1045,1,15,29,290,30,305
9894,2012-02-22,1,1,2,6,0,3,1,1,0.32,0.3182,0.76,0.1642,5,75,85,850,90,925
9895,2012-02-22,1,1,2,7,0,3,1,1,0.32,0.3333,0.76,0.0896,10,150,292,2920,302,3070
9896,2012-02-22,1,1,2,8,0,3,1,1,0.3,0.3182,0.75,0.0896,9,135,567,5670,576,5805
9897,2012-02-22,1,1,2,9,0,3,1,1,0.32,0.3333,0.7,0.0896,11,165,241,2410,252,2575
9898,2012-02-22,1,1,2,10,0,3,1,1,0.34,0.3485,0.71,0.0896,17,255,122,1220,139,1475
9899,2012-02-22,1,1,2,11,0,3,1,1,0.36,0.3485,0.66,0.1642,22,330,149,1490,171,1820
9900,2012-02-22,1,1,2,12,0,3,1,1,0.4,0.4091,0.62,0.2836,21,315,186,1860,207,2175
9901,2012-02-22,1,1,2,13,0,3,1,1,0.42,0.4242,0.54,0.2985,15,225,175,1750,190,1975
9902,2012-02-22,1,1,2,14,0,3,1,1,0.44,0.4394,0.54,0.3284,35,525,142,1420,177,1945
9903,2012-02-22,1,1,2,15,0,3,1,1,0.5,0.4848,0.31,0.4179,34,510,161,1610,195,2120
9904,2012-02-22,1,1,2,16,0,3,1,1,0.52,0.5,0.29,0.4627,30,450,268,2680,298,3130
9905,2012-02-22,1,1,2,17,0,3,1,1,0.52,0.5,0.32,0.3881,43,645,486,4860,529,5505
9906,2012-02-22,1,1,2,18,0,3,1,2,0.48,0.4697,0.41,0.3284,42,630,483,4830,525,5460
9907,2012-02-22,1,1,2,19,0,3,1,2,0.46,0.4545,0.44,0.2836,22,330,305,3050,327,3380
9908,2012-02-22,1,1,2,20,0,3,1,2,0.44,0.4394,0.47,0.194,25,375,249,2490,274,2865
9909,2012-02-22,1,1,2,21,0,3,1,2,0.48,0.4697,0.33,0.2836,19,285,220,2200,239,2485
9910,2012-02-22,1,1,2,22,0,3,1,2,0.44,0.4394,0.47,0.2537,18,270,129,1290,147,1560
9911,2012-02-22,1,1,2,23,0,3,1,2,0.46,0.4545,0.41,0.2836,5,75,57,570,62,645
9912,2012-02-23,1,1,2,0,0,4,1,2,0.44,0.4394,0.47,0.2537,12,180,30,300,42,480
9913,2012-02-23,1,1,2,1,0,4,1,2,0.44,0.4394,0.58,0.2836,3,45,12,120,15,165
9914,2012-02-23,1,1,2,2,0,4,1,2,0.44,0.4394,0.62,0.2239,5,75,4,40,9,115
9915,2012-02-23,1,1,2,3,0,4,1,3,0.44,0.4394,0.67,0.194,2,30,4,40,6,70
9916,2012-02-23,1,1,2,4,0,4,1,1,0.4,0.4091,0.76,0.2239,0,0,1,10,1,10
9917,2012-02-23,1,1,2,5,0,4,1,1,0.4,0.4091,0.76,0.2239,2,30,30,300,32,330
9918,2012-02-23,1,1,2,6,0,4,1,1,0.36,0.3485,0.87,0.194,3,45,88,880,91,925
9919,2012-02-23,1,1,2,7,0,4,1,1,0.36,0.3485,0.81,0.2239,9,135,317,3170,326,3305
9920,2012-02-23,1,1,2,8,0,4,1,1,0.34,0.3333,0.87,0.194,11,165,549,5490,560,5655
9921,2012-02-23,1,1,2,9,0,4,1,1,0.36,0.3333,0.81,0.2537,14,210,228,2280,242,2490
9922,2012-02-23,1,1,2,10,0,4,1,1,0.42,0.4242,0.67,0.194,41,615,107,1070,148,1685
9923,2012-02-23,1,1,2,11,0,4,1,1,0.48,0.4697,0.48,0.2836,54,810,128,1280,182,2090
9924,2012-02-23,1,1,2,12,0,4,1,1,0.5,0.4848,0.42,0.2537,25,375,199,1990,224,2365
9925,2012-02-23,1,1,2,13,0,4,1,1,0.52,0.5,0.39,0.194,30,450,188,1880,218,2330
9926,2012-02-23,1,1,2,14,0,4,1,1,0.54,0.5152,0.37,0.2537,36,540,156,1560,192,2100
9927,2012-02-23,1,1,2,15,0,4,1,1,0.54,0.5152,0.33,0.1343,46,690,171,1710,217,2400
9928,2012-02-23,1,1,2,16,0,4,1,1,0.56,0.5303,0.32,0.0,45,675,298,2980,343,3655
9929,2012-02-23,1,1,2,17,0,4,1,1,0.54,0.5152,0.32,0.1642,49,735,561,5610,610,6345
9930,2012-02-23,1,1,2,18,0,4,1,1,0.54,0.5152,0.37,0.1343,36,540,486,4860,522,5400
9931,2012-02-23,1,1,2,19,0,4,1,1,0.5,0.4848,0.39,0.0896,20,300,349,3490,369,3790
9932,2012-02-23,1,1,2,20,0,4,1,1,0.46,0.4545,0.44,0.1343,23,345,246,2460,269,2805
9933,2012-02-23,1,1,2,21,0,4,1,1,0.44,0.4394,0.51,0.2239,17,255,205,2050,222,2305
9934,2012-02-23,1,1,2,22,0,4,1,1,0.44,0.4394,0.54,0.2537,19,285,118,1180,137,1465
9935,2012-02-23,1,1,2,23,0,4,1,1,0.44,0.4394,0.54,0.0,14,210,71,710,85,920
9936,2012-02-24,1,1,2,0,0,5,1,2,0.44,0.4394,0.58,0.0896,12,180,34,340,46,520
9937,2012-02-24,1,1,2,1,0,5,1,1,0.44,0.4394,0.62,0.194,3,45,15,150,18,195
9938,2012-02-24,1,1,2,2,0,5,1,3,0.42,0.4242,0.77,0.2836,1,15,4,40,5,55
9939,2012-02-24,1,1,2,3,0,5,1,1,0.42,0.4242,0.82,0.1343,0,0,5,50,5,50
9940,2012-02-24,1,1,2,4,0,5,1,1,0.4,0.4091,0.87,0.1343,0,0,2,20,2,20
9941,2012-02-24,1,1,2,5,0,5,1,2,0.4,0.4091,0.87,0.194,1,15,25,250,26,265
9942,2012-02-24,1,1,2,6,0,5,1,2,0.4,0.4091,0.87,0.1642,2,30,80,800,82,830
9943,2012-02-24,1,1,2,7,0,5,1,2,0.4,0.4091,0.76,0.2239,7,105,265,2650,272,2755
9944,2012-02-24,1,1,2,8,0,5,1,2,0.38,0.3939,0.76,0.3284,17,255,452,4520,469,4775
9945,2012-02-24,1,1,2,9,0,5,1,3,0.36,0.3333,0.81,0.2537,15,225,229,2290,244,2515
9946,2012-02-24,1,1,2,10,0,5,1,3,0.36,0.3485,0.81,0.1642,22,330,119,1190,141,1520
9947,2012-02-24,1,1,2,11,0,5,1,2,0.36,0.3636,0.81,0.1045,27,405,136,1360,163,1765
9948,2012-02-24,1,1,2,12,0,5,1,2,0.4,0.4091,0.76,0.1343,27,405,201,2010,228,2415
9949,2012-02-24,1,1,2,13,0,5,1,2,0.42,0.4242,0.71,0.1045,30,450,153,1530,183,1980
9950,2012-02-24,1,1,2,14,0,5,1,2,0.46,0.4545,0.67,0.1045,5,75,26,260,31,335
9951,2012-02-24,1,1,2,15,0,5,1,3,0.4,0.4091,0.87,0.194,11,165,83,830,94,995
9952,2012-02-24,1,1,2,16,0,5,1,3,0.4,0.4091,0.87,0.194,12,180,166,1660,178,1840
9953,2012-02-24,1,1,2,17,0,5,1,3,0.42,0.4242,0.94,0.1045,14,210,242,2420,256,2630
9954,2012-02-24,1,1,2,18,0,5,1,2,0.42,0.4242,0.94,0.0,11,165,289,2890,300,3055
9955,2012-02-24,1,1,2,19,0,5,1,2,0.44,0.4394,0.88,0.1045,6,90,227,2270,233,2360
9956,2012-02-24,1,1,2,20,0,5,1,1,0.44,0.4394,0.62,0.4179,8,120,159,1590,167,1710
9957,2012-02-24,1,1,2,21,0,5,1,1,0.42,0.4242,0.35,0.806,1,15,151,1510,152,1525
9958,2012-02-24,1,1,2,22,0,5,1,1,0.4,0.4091,0.37,0.5821,4,60,102,1020,106,1080
9959,2012-02-24,1,1,2,23,0,5,1,1,0.38,0.3939,0.37,0.6866,10,150,76,760,86,910
9960,2012-02-25,1,1,2,0,0,6,0,1,0.36,0.3333,0.43,0.3881,5,75,56,560,61,635
9961,2012-02-25,1,1,2,1,0,6,0,1,0.34,0.303,0.42,0.3582,4,60,42,420,46,480
9962,2012-02-25,1,1,2,2,0,6,0,1,0.32,0.303,0.45,0.2537,1,15,37,370,38,385
9963,2012-02-25,1,1,2,3,0,6,0,1,0.3,0.2727,0.45,0.2985,0,0,7,70,7,70
9964,2012-02-25,1,1,2,4,0,6,0,1,0.3,0.2727,0.42,0.3284,0,0,2,20,2,20
9965,2012-02-25,1,1,2,5,0,6,0,2,0.3,0.2727,0.42,0.2985,0,0,3,30,3,30
9966,2012-02-25,1,1,2,6,0,6,0,2,0.3,0.2727,0.42,0.2985,1,15,12,120,13,135
9967,2012-02-25,1,1,2,7,0,6,0,1,0.28,0.2424,0.45,0.4478,3,45,20,200,23,245
9968,2012-02-25,1,1,2,8,0,6,0,1,0.26,0.2273,0.48,0.2985,3,45,90,900,93,945
9969,2012-02-25,1,1,2,9,0,6,0,3,0.22,0.197,0.75,0.3284,15,225,107,1070,122,1295
9970,2012-02-25,1,1,2,10,0,6,0,1,0.26,0.2273,0.6,0.3582,24,360,159,1590,183,1950
9971,2012-02-25,1,1,2,11,0,6,0,1,0.3,0.2576,0.39,0.6119,23,345,187,1870,210,2215
9972,2012-02-25,1,1,2,12,0,6,0,1,0.32,0.2727,0.29,0.6567,41,615,217,2170,258,2785
9973,2012-02-25,1,1,2,13,0,6,0,1,0.32,0.2879,0.31,0.4925,48,720,178,1780,226,2500
9974,2012-02-25,1,1,2,14,0,6,0,1,0.32,0.2727,0.29,0.5522,35,525,181,1810,216,2335
9975,2012-02-25,1,1,2,15,0,6,0,1,0.32,0.2879,0.29,0.4179,21,315,211,2110,232,2425
9976,2012-02-25,1,1,2,16,0,6,0,1,0.32,0.2727,0.26,0.5821,32,480,163,1630,195,2110
9977,2012-02-25,1,1,2,17,0,6,0,1,0.3,0.2727,0.33,0.3582,16,240,143,1430,159,1670
9978,2012-02-25,1,1,2,18,0,6,0,1,0.3,0.2576,0.28,0.5821,7,105,126,1260,133,1365
9979,2012-02-25,1,1,2,19,0,6,0,1,0.26,0.2121,0.33,0.4478,12,180,137,1370,149,1550
9980,2012-02-25,1,1,2,20,0,6,0,1,0.26,0.2121,0.3,0.5522,10,150,95,950,105,1100
9981,2012-02-25,1,1,2,21,0,6,0,1,0.24,0.2121,0.35,0.3284,5,75,80,800,85,875
9982,2012-02-25,1,1,2,22,0,6,0,1,0.24,0.197,0.38,0.4627,4,60,78,780,82,840
9983,2012-02-25,1,1,2,23,0,6,0,1,0.24,0.197,0.41,0.4179,7,105,84,840,91,945
9984,2012-02-26,1,1,2,0,0,0,0,1,0.24,0.2121,0.41,0.3582,7,105,63,630,70,735
9985,2012-02-26,1,1,2,1,0,0,0,1,0.24,0.2121,0.44,0.3284,5,75,50,500,55,575
9986,2012-02-26,1,1,2,2,0,0,0,1,0.24,0.2121,0.44,0.3284,5,75,37,370,42,445
9987,2012-02-26,1,1,2,3,0,0,0,1,0.24,0.2273,0.41,0.194,0,0,21,210,21,210
9988,2012-02-26,1,1,2,4,0,0,0,1,0.24,0.2273,0.41,0.194,1,15,5,50,6,65
9989,2012-02-26,1,1,2,5,0,0,0,1,0.22,0.2121,0.44,0.2239,0,0,5,50,5,50
9990,2012-02-26,1,1,2,6,0,0,0,1,0.22,0.197,0.44,0.3284,0,0,2,20,2,20
9991,2012-02-26,1,1,2,7,0,0,0,1,0.2,0.1818,0.51,0.2985,2,30,20,200,22,230
9992,2012-02-26,1,1,2,8,0,0,0,1,0.2,0.197,0.51,0.2537,2,30,57,570,59,600
9993,2012-02-26,1,1,2,9,0,0,0,1,0.22,0.2121,0.47,0.2239,11,165,76,760,87,925
9994,2012-02-26,1,1,2,10,0,0,0,1,0.26,0.2576,0.41,0.1642,27,405,161,1610,188,2015
9995,2012-02-26,1,1,2,11,0,0,0,1,0.28,0.2576,0.41,0.2836,43,645,184,1840,227,2485
9996,2012-02-26,1,1,2,12,0,0,0,1,0.3,0.303,0.39,0.1343,49,735,256,2560,305,3295
9997,2012-02-26,1,1,2,13,0,0,0,1,0.32,0.3333,0.36,0.0,58,870,267,2670,325,3540
9998,2012-02-26,1,1,2,14,0,0,0,1,0.34,0.3485,0.31,0.0,68,1020,263,2630,331,3650
9999,2012-02-26,1,1,2,15,0,0,0,1,0.36,0.3485,0.29,0.0,72,1080,281,2810,353,3890
10000,2012-02-26,1,1,2,16,0,0,0,1,0.36,0.3333,0.32,0.2537,64,960,275,2750,339,3710
10001,2012-02-26,1,1,2,17,0,0,0,1,0.36,0.3485,0.32,0.2239,46,690,241,2410,287,3100
10002,2012-02-26,1,1,2,18,0,0,0,1,0.34,0.3182,0.36,0.2836,17,255,199,1990,216,2245
10003,2012-02-26,1,1,2,19,0,0,0,1,0.34,0.3333,0.34,0.1642,13,195,130,1300,143,1495
10004,2012-02-26,1,1,2,20,0,0,0,1,0.32,0.3182,0.42,0.1642,9,135,79,790,88,925
10005,2012-02-26,1,1,2,21,0,0,0,1,0.3,0.303,0.45,0.1343,8,120,75,750,83,870
10006,2012-02-26,1,1,2,22,0,0,0,1,0.3,0.2879,0.42,0.2239,3,45,68,680,71,725
10007,2012-02-26,1,1,2,23,0,0,0,1,0.26,0.2576,0.56,0.1642,5,75,59,590,64,665
10008,2012-02-27,1,1,2,0,0,1,1,1,0.26,0.2424,0.6,0.2537,2,30,27,270,29,300
10009,2012-02-27,1,1,2,1,0,1,1,1,0.26,0.2576,0.65,0.2239,0,0,6,60,6,60
10010,2012-02-27,1,1,2,2,0,1,1,1,0.26,0.2273,0.7,0.2985,0,0,4,40,4,40
10011,2012-02-27,1,1,2,3,0,1,1,1,0.24,0.2424,0.75,0.1642,0,0,2,20,2,20
10012,2012-02-27,1,1,2,4,0,1,1,1,0.22,0.2273,0.8,0.1343,0,0,1,10,1,10
10013,2012-02-27,1,1,2,5,0,1,1,1,0.22,0.2273,0.8,0.1343,0,0,16,160,16,160
10014,2012-02-27,1,1,2,6,0,1,1,1,0.24,0.2273,0.7,0.2537,1,15,89,890,90,905
10015,2012-02-27,1,1,2,7,0,1,1,1,0.24,0.2273,0.6,0.2239,2,30,278,2780,280,2810
10016,2012-02-27,1,1,2,8,0,1,1,1,0.24,0.2424,0.6,0.0,14,210,514,5140,528,5350
10017,2012-02-27,1,1,2,9,0,1,1,1,0.26,0.2576,0.6,0.194,11,165,219,2190,230,2355
10018,2012-02-27,1,1,2,10,0,1,1,1,0.32,0.303,0.45,0.2537,16,240,88,880,104,1120
10019,2012-02-27,1,1,2,11,0,1,1,1,0.36,0.3333,0.43,0.2537,11,165,92,920,103,1085
10020,2012-02-27,1,1,2,12,0,1,1,1,0.4,0.4091,0.37,0.2985,13,195,164,1640,177,1835
10021,2012-02-27,1,1,2,13,0,1,1,1,0.4,0.4091,0.43,0.2836,23,345,159,1590,182,1935
10022,2012-02-27,1,1,2,14,0,1,1,1,0.46,0.4545,0.36,0.2836,24,360,134,1340,158,1700
10023,2012-02-27,1,1,2,15,0,1,1,1,0.52,0.5,0.25,0.4179,24,360,150,1500,174,1860
10024,2012-02-27,1,1,2,16,0,1,1,1,0.54,0.5152,0.26,0.4478,20,300,266,2660,286,2960
10025,2012-02-27,1,1,2,17,0,1,1,1,0.54,0.5152,0.24,0.4478,26,390,503,5030,529,5420
10026,2012-02-27,1,1,2,18,0,1,1,1,0.52,0.5,0.27,0.4179,10,150,517,5170,527,5320
10027,2012-02-27,1,1,2,19,0,1,1,1,0.5,0.4848,0.29,0.3881,16,240,318,3180,334,3420
10028,2012-02-27,1,1,2,20,0,1,1,1,0.48,0.4697,0.33,0.3582,11,165,208,2080,219,2245
10029,2012-02-27,1,1,2,21,0,1,1,1,0.46,0.4545,0.36,0.2836,14,210,181,1810,195,2020
10030,2012-02-27,1,1,2,22,0,1,1,1,0.44,0.4394,0.44,0.2537,9,135,83,830,92,965
10031,2012-02-27,1,1,2,23,0,1,1,1,0.42,0.4242,0.5,0.1642,6,90,50,500,56,590
10032,2012-02-28,1,1,2,0,0,2,1,1,0.42,0.4242,0.54,0.1343,0,0,10,100,10,100
10033,2012-02-28,1,1,2,1,0,2,1,1,0.38,0.3939,0.62,0.1642,0,0,6,60,6,60
10034,2012-02-28,1,1,2,2,0,2,1,1,0.4,0.4091,0.54,0.1045,1,15,2,20,3,35
10035,2012-02-28,1,1,2,3,0,2,1,1,0.4,0.4091,0.32,0.3582,0,0,6,60,6,60
10036,2012-02-28,1,1,2,4,0,2,1,1,0.32,0.2879,0.42,0.3582,0,0,2,20,2,20
10037,2012-02-28,1,1,2,5,0,2,1,1,0.32,0.2879,0.42,0.3582,1,15,20,200,21,215
10038,2012-02-28,1,1,2,6,0,2,1,1,0.3,0.2727,0.45,0.3284,1,15,100,1000,101,1015
10039,2012-02-28,1,1,2,7,0,2,1,1,0.28,0.2576,0.45,0.2985,12,180,313,3130,325,3310
10040,2012-02-28,1,1,2,8,0,2,1,1,0.26,0.2424,0.48,0.2836,16,240,543,5430,559,5670
10041,2012-02-28,1,1,2,9,0,2,1,1,0.28,0.2576,0.45,0.3582,7,105,225,2250,232,2355
10042,2012-02-28,1,1,2,10,0,2,1,1,0.3,0.2727,0.42,0.2985,14,210,118,1180,132,1390
10043,2012-02-28,1,1,2,11,0,2,1,1,0.34,0.3182,0.36,0.2537,8,120,155,1550,163,1670
10044,2012-02-28,1,1,2,12,0,2,1,1,0.36,0.3485,0.34,0.1343,19,285,164,1640,183,1925
10045,2012-02-28,1,1,2,13,0,2,1,1,0.36,0.3636,0.32,0.1045,16,240,174,1740,190,1980
10046,2012-02-28,1,1,2,14,0,2,1,1,0.4,0.4091,0.28,0.1045,13,195,121,1210,134,1405
10047,2012-02-28,1,1,2,15,0,2,1,1,0.42,0.4242,0.26,0.0896,17,255,149,1490,166,1745
10048,2012-02-28,1,1,2,16,0,2,1,1,0.42,0.4242,0.28,0.0896,17,255,270,2700,287,2955
10049,2012-02-28,1,1,2,17,0,2,1,1,0.42,0.4242,0.26,0.0896,33,495,497,4970,530,5465
10050,2012-02-28,1,1,2,18,0,2,1,1,0.42,0.4242,0.28,0.1642,17,255,432,4320,449,4575
10051,2012-02-28,1,1,2,19,0,2,1,1,0.42,0.4242,0.26,0.0,15,225,291,2910,306,3135
10052,2012-02-28,1,1,2,20,0,2,1,1,0.4,0.4091,0.3,0.1343,2,30,202,2020,204,2050
10053,2012-02-28,1,1,2,21,0,2,1,1,0.34,0.3485,0.46,0.1045,10,150,178,1780,188,1930
10054,2012-02-28,1,1,2,22,0,2,1,1,0.34,0.3485,0.46,0.1045,6,90,95,950,101,1040
10055,2012-02-28,1,1,2,23,0,2,1,1,0.32,0.303,0.53,0.2239,4,60,61,610,65,670
10056,2012-02-29,1,1,2,0,0,3,1,1,0.32,0.3333,0.53,0.1045,2,30,30,300,32,330
10057,2012-02-29,1,1,2,1,0,3,1,1,0.32,0.3333,0.49,0.1045,0,0,6,60,6,60
10058,2012-02-29,1,1,2,2,0,3,1,1,0.3,0.2879,0.56,0.2239,0,0,4,40,4,40
10059,2012-02-29,1,1,2,3,0,3,1,1,0.28,0.303,0.7,0.0896,0,0,2,20,2,20
10060,2012-02-29,1,1,2,5,0,3,1,1,0.26,0.2879,0.75,0.0896,0,0,29,290,29,290
10061,2012-02-29,1,1,2,6,0,3,1,2,0.28,0.303,0.75,0.0896,4,60,100,1000,104,1060
10062,2012-02-29,1,1,2,7,0,3,1,2,0.26,0.2727,0.81,0.1343,11,165,242,2420,253,2585
10063,2012-02-29,1,1,2,8,0,3,1,2,0.28,0.2879,0.75,0.1045,2,30,114,1140,116,1170
10064,2012-02-29,1,1,2,9,0,3,1,3,0.3,0.303,0.81,0.1642,5,75,33,330,38,405
10065,2012-02-29,1,1,2,10,0,3,1,3,0.3,0.303,0.81,0.1642,0,0,10,100,10,100
10066,2012-02-29,1,1,2,11,0,3,1,3,0.3,0.2879,0.87,0.194,1,15,9,90,10,105
10067,2012-02-29,1,1,2,12,0,3,1,3,0.32,0.303,0.93,0.3284,1,15,69,690,70,705
10068,2012-02-29,1,1,2,13,0,3,1,2,0.36,0.3333,0.93,0.3582,4,60,72,720,76,780
10069,2012-02-29,1,1,2,14,0,3,1,2,0.36,0.3333,0.93,0.3582,2,30,54,540,56,570
10070,2012-02-29,1,1,2,15,0,3,1,2,0.4,0.4091,0.82,0.2836,3,45,87,870,90,915
10071,2012-02-29,1,1,2,16,0,3,1,3,0.4,0.4091,0.82,0.2239,5,75,162,1620,167,1695
10072,2012-02-29,1,1,2,17,0,3,1,2,0.4,0.4091,0.87,0.1642,7,105,246,2460,253,2565
10073,2012-02-29,1,1,2,18,0,3,1,3,0.4,0.4091,0.87,0.0,11,165,181,1810,192,1975
10074,2012-02-29,1,1,2,19,0,3,1,2,0.4,0.4091,0.87,0.1045,0,0,102,1020,102,1020
10075,2012-02-29,1,1,2,20,0,3,1,3,0.42,0.4242,0.88,0.1642,2,30,95,950,97,980
10076,2012-02-29,1,1,2,21,0,3,1,3,0.42,0.4242,0.88,0.1642,0,0,39,390,39,390
10077,2012-02-29,1,1,2,22,0,3,1,3,0.42,0.4242,0.94,0.2537,2,30,53,530,55,560
10078,2012-02-29,1,1,2,23,0,3,1,3,0.42,0.4242,0.94,0.2537,3,45,30,300,33,345
10079,2012-03-01,1,1,3,0,0,4,1,2,0.42,0.4242,0.94,0.0,1,15,10,100,11,115
10080,2012-03-01,1,1,3,1,0,4,1,3,0.46,0.4545,0.94,0.1045,0,0,12,120,12,120
10081,2012-03-01,1,1,3,2,0,4,1,2,0.46,0.4545,0.94,0.2836,0,0,6,60,6,60
10082,2012-03-01,1,1,3,3,0,4,1,1,0.46,0.4545,0.94,0.2239,0,0,3,30,3,30
10083,2012-03-01,1,1,3,4,0,4,1,1,0.48,0.4697,0.88,0.194,0,0,5,50,5,50
10084,2012-03-01,1,1,3,5,0,4,1,1,0.48,0.4697,0.88,0.1642,0,0,18,180,18,180
10085,2012-03-01,1,1,3,6,0,4,1,2,0.42,0.4242,0.94,0.0,2,30,107,1070,109,1100
10086,2012-03-01,1,1,3,7,0,4,1,2,0.44,0.4394,0.94,0.1343,8,120,296,2960,304,3080
10087,2012-03-01,1,1,3,8,0,4,1,1,0.42,0.4242,0.94,0.1343,15,225,579,5790,594,6015
10088,2012-03-01,1,1,3,9,0,4,1,1,0.46,0.4545,0.77,0.2537,5,75,281,2810,286,2885
10089,2012-03-01,1,1,3,10,0,4,1,1,0.52,0.5,0.55,0.1642,11,165,122,1220,133,1385
10090,2012-03-01,1,1,3,11,0,4,1,1,0.56,0.5303,0.43,0.194,19,285,149,1490,168,1775
10091,2012-03-01,1,1,3,12,0,4,1,1,0.56,0.5303,0.37,0.2239,16,240,204,2040,220,2280
10092,2012-03-01,1,1,3,13,0,4,1,1,0.58,0.5455,0.32,0.2537,24,360,187,1870,211,2230
10093,2012-03-01,1,1,3,14,0,4,1,1,0.58,0.5455,0.35,0.2239,37,555,174,1740,211,2295
10094,2012-03-01,1,1,3,15,0,4,1,1,0.6,0.6212,0.31,0.2537,31,465,192,1920,223,2385
10095,2012-03-01,1,1,3,16,0,4,1,1,0.58,0.5455,0.32,0.2985,38,570,323,3230,361,3800
10096,2012-03-01,1,1,3,17,0,4,1,1,0.56,0.5303,0.35,0.2985,49,735,551,5510,600,6245
10097,2012-03-01,1,1,3,18,0,4,1,1,0.54,0.5152,0.34,0.3582,27,405,498,4980,525,5385
10098,2012-03-01,1,1,3,19,0,4,1,1,0.48,0.4697,0.41,0.3284,11,165,317,3170,328,3335
10099,2012-03-01,1,1,3,20,0,4,1,1,0.44,0.4394,0.44,0.4179,12,180,242,2420,254,2600
10100,2012-03-01,1,1,3,21,0,4,1,1,0.42,0.4242,0.47,0.4627,7,105,190,1900,197,2005
10101,2012-03-01,1,1,3,22,0,4,1,1,0.38,0.3939,0.5,0.2537,3,45,123,1230,126,1275
10102,2012-03-01,1,1,3,23,0,4,1,1,0.36,0.3485,0.5,0.2239,9,135,76,760,85,895
10103,2012-03-02,1,1,3,0,0,5,1,1,0.34,0.3333,0.53,0.1642,1,15,45,450,46,465
10104,2012-03-02,1,1,3,1,0,5,1,1,0.34,0.3182,0.49,0.2239,2,30,18,180,20,210
10105,2012-03-02,1,1,3,2,0,5,1,1,0.34,0.3182,0.53,0.2836,2,30,4,40,6,70
10106,2012-03-02,1,1,3,3,0,5,1,1,0.32,0.3182,0.57,0.194,0,0,3,30,3,30
10107,2012-03-02,1,1,3,4,0,5,1,1,0.32,0.3485,0.61,0.0,0,0,2,20,2,20
10108,2012-03-02,1,1,3,5,0,5,1,1,0.3,0.3333,0.7,0.0,0,0,24,240,24,240
10109,2012-03-02,1,1,3,6,0,5,1,1,0.3,0.3333,0.7,0.0,4,60,88,880,92,940
10110,2012-03-02,1,1,3,7,0,5,1,1,0.3,0.3333,0.7,0.0,4,60,258,2580,262,2640
10111,2012-03-02,1,1,3,8,0,5,1,1,0.28,0.303,0.75,0.0896,16,240,533,5330,549,5570
10112,2012-03-02,1,1,3,9,0,5,1,1,0.3,0.3333,0.81,0.0,15,225,299,2990,314,3215
10113,2012-03-02,1,1,3,10,0,5,1,1,0.36,0.3485,0.5,0.1642,14,210,118,1180,132,1390
10114,2012-03-02,1,1,3,11,0,5,1,1,0.38,0.3939,0.46,0.194,40,600,154,1540,194,2140
10115,2012-03-02,1,1,3,12,0,5,1,1,0.4,0.4091,0.43,0.1642,40,600,194,1940,234,2540
10116,2012-03-02,1,1,3,13,0,5,1,1,0.42,0.4242,0.44,0.2239,31,465,191,1910,222,2375
10117,2012-03-02,1,1,3,14,0,5,1,2,0.44,0.4394,0.44,0.2836,29,435,176,1760,205,2195
10118,2012-03-02,1,1,3,15,0,5,1,2,0.42,0.4242,0.5,0.2985,5,75,73,730,78,805
10119,2012-03-02,1,1,3,16,0,5,1,3,0.4,0.4091,0.58,0.2985,1,15,49,490,50,505
10120,2012-03-02,1,1,3,17,0,5,1,3,0.36,0.3485,0.81,0.2239,5,75,123,1230,128,1305
10121,2012-03-02,1,1,3,18,0,5,1,3,0.36,0.3485,0.87,0.194,6,90,154,1540,160,1630
10122,2012-03-02,1,1,3,19,0,5,1,3,0.36,0.3485,0.87,0.194,12,180,162,1620,174,1800
10123,2012-03-02,1,1,3,20,0,5,1,2,0.36,0.3485,0.87,0.194,7,105,93,930,100,1035
10124,2012-03-02,1,1,3,21,0,5,1,3,0.36,0.3636,0.87,0.0896,2,30,99,990,101,1020
10125,2012-03-02,1,1,3,22,0,5,1,2,0.36,0.3788,0.87,0.0,6,90,69,690,75,780
10126,2012-03-02,1,1,3,23,0,5,1,2,0.36,0.3788,0.87,0.0,4,60,19,190,23,250
10127,2012-03-03,1,1,3,0,0,6,0,3,0.36,0.3636,0.93,0.0896,1,15,21,210,22,225
10128,2012-03-03,1,1,3,1,0,6,0,3,0.36,0.3788,0.93,0.0,0,0,44,440,44,440
10129,2012-03-03,1,1,3,2,0,6,0,3,0.36,0.3636,0.93,0.0896,4,60,34,340,38,400
10130,2012-03-03,1,1,3,3,0,6,0,2,0.36,0.3485,0.93,0.1642,1,15,20,200,21,215
10131,2012-03-03,1,1,3,4,0,6,0,2,0.36,0.3485,0.93,0.194,0,0,2,20,2,20
10132,2012-03-03,1,1,3,5,0,6,0,2,0.36,0.3636,0.93,0.0896,1,15,1,10,2,25
10133,2012-03-03,1,1,3,6,0,6,0,2,0.36,0.3636,0.93,0.0896,1,15,6,60,7,75
10134,2012-03-03,1,1,3,7,0,6,0,2,0.36,0.3485,0.93,0.1343,2,30,14,140,16,170
10135,2012-03-03,1,1,3,8,0,6,0,3,0.36,0.3788,0.93,0.0,2,30,46,460,48,490
10136,2012-03-03,1,1,3,9,0,6,0,3,0.38,0.3939,0.87,0.0896,7,105,87,870,94,975
10137,2012-03-03,1,1,3,10,0,6,0,2,0.4,0.4091,0.87,0.0,31,465,137,1370,168,1835
10138,2012-03-03,1,1,3,11,0,6,0,2,0.4,0.4091,0.87,0.0896,33,495,181,1810,214,2305
10139,2012-03-03,1,1,3,12,0,6,0,2,0.42,0.4242,0.67,0.2537,47,705,252,2520,299,3225
10140,2012-03-03,1,1,3,13,0,6,0,1,0.44,0.4394,0.51,0.2836,87,1305,252,2520,339,3825
10141,2012-03-03,1,1,3,14,0,6,0,2,0.46,0.4545,0.44,0.3582,151,2265,279,2790,430,5055
10142,2012-03-03,1,1,3,15,0,6,0,1,0.48,0.4697,0.29,0.2985,145,2175,254,2540,399,4715
10143,2012-03-03,1,1,3,16,0,6,0,1,0.5,0.4848,0.27,0.2985,167,2505,300,3000,467,5505
10144,2012-03-03,1,1,3,17,0,6,0,1,0.5,0.4848,0.23,0.3284,106,1590,279,2790,385,4380
10145,2012-03-03,1,1,3,18,0,6,0,1,0.5,0.4848,0.25,0.2537,53,795,250,2500,303,3295
10146,2012-03-03,1,1,3,19,0,6,0,1,0.46,0.4545,0.33,0.1642,34,510,191,1910,225,2420
10147,2012-03-03,1,1,3,20,0,6,0,1,0.44,0.4394,0.3,0.1343,28,420,121,1210,149,1630
10148,2012-03-03,1,1,3,21,0,6,0,1,0.46,0.4545,0.19,0.3284,24,360,130,1300,154,1660
10149,2012-03-03,1,1,3,22,0,6,0,1,0.44,0.4394,0.21,0.1343,19,285,115,1150,134,1435
10150,2012-03-03,1,1,3,23,0,6,0,1,0.42,0.4242,0.24,0.0,12,180,94,940,106,1120
10151,2012-03-04,1,1,3,0,0,0,0,2,0.4,0.4091,0.3,0.3582,5,75,67,670,72,745
10152,2012-03-04,1,1,3,1,0,0,0,2,0.38,0.3939,0.34,0.194,16,240,60,600,76,840
10153,2012-03-04,1,1,3,2,0,0,0,2,0.36,0.3485,0.4,0.1642,14,210,66,660,80,870
10154,2012-03-04,1,1,3,3,0,0,0,2,0.36,0.3485,0.43,0.1343,5,75,21,210,26,285
10155,2012-03-04,1,1,3,4,0,0,0,2,0.34,0.3333,0.46,0.194,3,45,11,110,14,155
10156,2012-03-04,1,1,3,5,0,0,0,2,0.34,0.3182,0.46,0.2239,0,0,5,50,5,50
10157,2012-03-04,1,1,3,6,0,0,0,2,0.3,0.2727,0.52,0.2985,0,0,5,50,5,50
10158,2012-03-04,1,1,3,7,0,0,0,2,0.3,0.2727,0.52,0.2985,2,30,21,210,23,240
10159,2012-03-04,1,1,3,8,0,0,0,1,0.3,0.2727,0.52,0.3284,12,180,54,540,66,720
10160,2012-03-04,1,1,3,9,0,0,0,1,0.3,0.2727,0.49,0.4478,14,210,104,1040,118,1250
10161,2012-03-04,1,1,3,10,0,0,0,1,0.3,0.2727,0.49,0.3284,31,465,161,1610,192,2075
10162,2012-03-04,1,1,3,11,0,0,0,1,0.32,0.2879,0.45,0.3881,64,960,192,1920,256,2880
10163,2012-03-04,1,1,3,12,0,0,0,1,0.34,0.303,0.42,0.3582,71,1065,256,2560,327,3625
10164,2012-03-04,1,1,3,13,0,0,0,1,0.36,0.3333,0.37,0.3582,108,1620,256,2560,364,4180
10165,2012-03-04,1,1,3,14,0,0,0,1,0.36,0.3333,0.34,0.3582,106,1590,226,2260,332,3850
10166,2012-03-04,1,1,3,15,0,0,0,1,0.36,0.3182,0.32,0.5224,82,1230,252,2520,334,3750
10167,2012-03-04,1,1,3,16,0,0,0,1,0.36,0.3182,0.29,0.4925,68,1020,231,2310,299,3330
10168,2012-03-04,1,1,3,17,0,0,0,1,0.34,0.2879,0.31,0.5522,49,735,214,2140,263,2875
10169,2012-03-04,1,1,3,18,0,0,0,1,0.32,0.2727,0.33,0.6119,20,300,164,1640,184,1940
10170,2012-03-04,1,1,3,19,0,0,0,1,0.3,0.2576,0.36,0.4925,12,180,120,1200,132,1380
10171,2012-03-04,1,1,3,20,0,0,0,1,0.28,0.2727,0.38,0.2537,8,120,80,800,88,920
10172,2012-03-04,1,1,3,21,0,0,0,1,0.28,0.2727,0.36,0.2239,9,135,70,700,79,835
10173,2012-03-04,1,1,3,22,0,0,0,1,0.26,0.2424,0.41,0.2537,9,135,53,530,62,665
10174,2012-03-04,1,1,3,23,0,0,0,1,0.26,0.2576,0.41,0.194,2,30,24,240,26,270
10175,2012-03-05,1,1,3,0,0,1,1,1,0.24,0.2273,0.44,0.194,2,30,15,150,17,180
10176,2012-03-05,1,1,3,1,0,1,1,1,0.24,0.2424,0.48,0.1343,3,45,3,30,6,75
10177,2012-03-05,1,1,3,2,0,1,1,1,0.24,0.2424,0.48,0.1343,1,15,3,30,4,45
10178,2012-03-05,1,1,3,3,0,1,1,1,0.22,0.2273,0.51,0.1642,0,0,1,10,1,10
10179,2012-03-05,1,1,3,4,0,1,1,1,0.2,0.2273,0.55,0.0896,0,0,1,10,1,10
10180,2012-03-05,1,1,3,5,0,1,1,1,0.2,0.2273,0.55,0.0896,1,15,17,170,18,185
10181,2012-03-05,1,1,3,6,0,1,1,1,0.18,0.197,0.59,0.1343,2,30,89,890,91,920
10182,2012-03-05,1,1,3,7,0,1,1,1,0.18,0.197,0.59,0.1343,7,105,253,2530,260,2635
10183,2012-03-05,1,1,3,8,0,1,1,1,0.2,0.2273,0.59,0.1045,13,195,415,4150,428,4345
10184,2012-03-05,1,1,3,9,0,1,1,2,0.22,0.2576,0.6,0.0896,11,165,186,1860,197,2025
10185,2012-03-05,1,1,3,10,0,1,1,2,0.24,0.2576,0.6,0.0,12,180,74,740,86,920
10186,2012-03-05,1,1,3,11,0,1,1,2,0.26,0.2727,0.56,0.1343,17,255,86,860,103,1115
10187,2012-03-05,1,1,3,12,0,1,1,2,0.26,0.303,0.52,0.0,15,225,122,1220,137,1445
10188,2012-03-05,1,1,3,13,0,1,1,2,0.26,0.2576,0.55,0.2985,11,165,109,1090,120,1255
10189,2012-03-05,1,1,3,14,0,1,1,2,0.28,0.2576,0.57,0.3582,13,195,115,1150,128,1345
10190,2012-03-05,1,1,3,15,0,1,1,2,0.3,0.2879,0.53,0.194,20,300,110,1100,130,1400
10191,2012-03-05,1,1,3,16,0,1,1,1,0.3,0.2727,0.45,0.2985,30,450,180,1800,210,2250
10192,2012-03-05,1,1,3,17,0,1,1,3,0.3,0.2727,0.45,0.2985,11,165,376,3760,387,3925
10193,2012-03-05,1,1,3,18,0,1,1,3,0.28,0.2273,0.55,0.6567,12,180,363,3630,375,3810
10194,2012-03-05,1,1,3,19,0,1,1,1,0.26,0.2576,0.53,0.2239,6,90,220,2200,226,2290
10195,2012-03-05,1,1,3,20,0,1,1,1,0.26,0.2273,0.37,0.4627,8,120,171,1710,179,1830
10196,2012-03-05,1,1,3,21,0,1,1,1,0.26,0.2273,0.37,0.3881,4,60,116,1160,120,1220
10197,2012-03-05,1,1,3,22,0,1,1,1,0.24,0.2121,0.35,0.3284,2,30,76,760,78,790
10198,2012-03-05,1,1,3,23,0,1,1,1,0.22,0.1818,0.37,0.5821,2,30,29,290,31,320
10199,2012-03-06,1,1,3,0,0,2,1,1,0.22,0.2121,0.37,0.2985,0,0,8,80,8,80
10200,2012-03-06,1,1,3,1,0,2,1,1,0.2,0.197,0.44,0.2537,0,0,6,60,6,60
10201,2012-03-06,1,1,3,2,0,2,1,1,0.2,0.197,0.44,0.2239,0,0,4,40,4,40
10202,2012-03-06,1,1,3,3,0,2,1,1,0.18,0.1667,0.51,0.2836,0,0,1,10,1,10
10203,2012-03-06,1,1,3,4,0,2,1,1,0.18,0.1667,0.51,0.2985,0,0,3,30,3,30
10204,2012-03-06,1,1,3,5,0,2,1,1,0.18,0.1818,0.51,0.2239,0,0,25,250,25,250
10205,2012-03-06,1,1,3,6,0,2,1,1,0.18,0.2121,0.51,0.1045,3,45,99,990,102,1035
10206,2012-03-06,1,1,3,7,0,2,1,1,0.16,0.1818,0.55,0.1343,5,75,270,2700,275,2775
10207,2012-03-06,1,1,3,8,0,2,1,1,0.16,0.1818,0.59,0.1045,14,210,487,4870,501,5080
10208,2012-03-06,1,1,3,9,0,2,1,1,0.22,0.2727,0.47,0.0,11,165,222,2220,233,2385
10209,2012-03-06,1,1,3,10,0,2,1,1,0.24,0.2576,0.44,0.0,16,240,113,1130,129,1370
10210,2012-03-06,1,1,3,11,0,2,1,1,0.26,0.2576,0.41,0.1642,20,300,110,1100,130,1400
10211,2012-03-06,1,1,3,12,0,2,1,1,0.26,0.2727,0.41,0.1045,9,135,129,1290,138,1425
10212,2012-03-06,1,1,3,13,0,2,1,1,0.3,0.303,0.39,0.1343,16,240,148,1480,164,1720
10213,2012-03-06,1,1,3,14,0,2,1,1,0.32,0.303,0.36,0.2239,20,300,116,1160,136,1460
10214,2012-03-06,1,1,3,15,0,2,1,1,0.34,0.303,0.36,0.2985,24,360,142,1420,166,1780
10215,2012-03-06,1,1,3,16,0,2,1,1,0.36,0.3333,0.32,0.2836,22,330,228,2280,250,2610
10216,2012-03-06,1,1,3,17,0,2,1,1,0.36,0.3333,0.34,0.2836,21,315,425,4250,446,4565
10217,2012-03-06,1,1,3,18,0,2,1,1,0.34,0.303,0.42,0.3284,15,225,442,4420,457,4645
10218,2012-03-06,1,1,3,19,0,2,1,1,0.34,0.303,0.46,0.2985,9,135,278,2780,287,2915
10219,2012-03-06,1,1,3,20,0,2,1,1,0.32,0.3182,0.49,0.194,3,45,184,1840,187,1885
10220,2012-03-06,1,1,3,21,0,2,1,1,0.32,0.3182,0.49,0.194,5,75,143,1430,148,1505
10221,2012-03-06,1,1,3,22,0,2,1,1,0.28,0.2727,0.56,0.1642,5,75,101,1010,106,1085
10222,2012-03-06,1,1,3,23,0,2,1,1,0.28,0.2727,0.61,0.2239,3,45,51,510,54,555
10223,2012-03-07,1,1,3,0,0,3,1,1,0.28,0.2576,0.65,0.2836,3,45,12,120,15,165
10224,2012-03-07,1,1,3,1,0,3,1,1,0.3,0.2727,0.61,0.2985,1,15,4,40,5,55
10225,2012-03-07,1,1,3,2,0,3,1,1,0.3,0.2879,0.56,0.2836,0,0,4,40,4,40
10226,2012-03-07,1,1,3,3,0,3,1,1,0.3,0.2727,0.56,0.3582,1,15,2,20,3,35
10227,2012-03-07,1,1,3,4,0,3,1,1,0.28,0.2576,0.61,0.3284,0,0,3,30,3,30
10228,2012-03-07,1,1,3,5,0,3,1,1,0.28,0.2576,0.56,0.2985,0,0,18,180,18,180
10229,2012-03-07,1,1,3,6,0,3,1,1,0.28,0.2576,0.61,0.3881,4,60,104,1040,108,1100
10230,2012-03-07,1,1,3,7,0,3,1,1,0.26,0.2273,0.65,0.3881,12,180,332,3320,344,3500
10231,2012-03-07,1,1,3,8,0,3,1,1,0.28,0.2576,0.61,0.2985,12,180,554,5540,566,5720
10232,2012-03-07,1,1,3,9,0,3,1,1,0.3,0.2727,0.61,0.3284,12,180,252,2520,264,2700
10233,2012-03-07,1,1,3,10,0,3,1,1,0.36,0.3333,0.5,0.2985,20,300,127,1270,147,1570
10234,2012-03-07,1,1,3,11,0,3,1,1,0.42,0.4242,0.38,0.2985,33,495,128,1280,161,1775
10235,2012-03-07,1,1,3,12,0,3,1,1,0.44,0.4394,0.38,0.3881,40,600,175,1750,215,2350
10236,2012-03-07,1,1,3,13,0,3,1,1,0.5,0.4848,0.34,0.4179,26,390,179,1790,205,2180
10237,2012-03-07,1,1,3,14,0,3,1,1,0.52,0.5,0.36,0.3284,38,570,137,1370,175,1940
10238,2012-03-07,1,1,3,15,0,3,1,1,0.54,0.5152,0.37,0.4478,44,660,165,1650,209,2310
10239,2012-03-07,1,1,3,16,0,3,1,1,0.56,0.5303,0.37,0.4179,34,510,254,2540,288,3050
10240,2012-03-07,1,1,3,17,0,3,1,1,0.56,0.5303,0.43,0.4925,58,870,554,5540,612,6410
10241,2012-03-07,1,1,3,18,0,3,1,1,0.56,0.5303,0.4,0.4627,35,525,509,5090,544,5615
10242,2012-03-07,1,1,3,19,0,3,1,1,0.54,0.5152,0.42,0.3582,16,240,345,3450,361,3690
10243,2012-03-07,1,1,3,20,0,3,1,1,0.5,0.4848,0.51,0.2537,18,270,242,2420,260,2690
10244,2012-03-07,1,1,3,21,0,3,1,1,0.44,0.4394,0.62,0.2537,11,165,177,1770,188,1935
10245,2012-03-07,1,1,3,22,0,3,1,1,0.46,0.4545,0.59,0.2985,10,150,149,1490,159,1640
10246,2012-03-07,1,1,3,23,0,3,1,1,0.44,0.4394,0.62,0.3284,4,60,58,580,62,640
10247,2012-03-08,1,1,3,0,0,4,1,1,0.44,0.4394,0.62,0.3284,11,165,35,350,46,515
10248,2012-03-08,1,1,3,1,0,4,1,1,0.46,0.4545,0.63,0.3284,4,60,17,170,21,230
10249,2012-03-08,1,1,3,2,0,4,1,1,0.46,0.4545,0.63,0.3881,6,90,5,50,11,140
10250,2012-03-08,1,1,3,3,0,4,1,1,0.46,0.4545,0.63,0.3881,0,0,3,30,3,30
10251,2012-03-08,1,1,3,4,0,4,1,1,0.44,0.4394,0.72,0.2836,0,0,2,20,2,20
10252,2012-03-08,1,1,3,5,0,4,1,1,0.42,0.4242,0.77,0.2239,1,15,28,280,29,295
10253,2012-03-08,1,1,3,6,0,4,1,1,0.42,0.4242,0.77,0.2537,4,60,105,1050,109,1110
10254,2012-03-08,1,1,3,7,0,4,1,1,0.42,0.4242,0.77,0.3582,8,120,326,3260,334,3380
10255,2012-03-08,1,1,3,8,0,4,1,1,0.44,0.4394,0.77,0.3881,12,180,573,5730,585,5910
10256,2012-03-08,1,1,3,9,0,4,1,1,0.46,0.4545,0.72,0.4627,19,285,282,2820,301,3105
10257,2012-03-08,1,1,3,10,0,4,1,1,0.5,0.4848,0.68,0.4627,19,285,119,1190,138,1475
10258,2012-03-08,1,1,3,11,0,4,1,2,0.54,0.5152,0.6,0.4627,48,720,156,1560,204,2280
10259,2012-03-08,1,1,3,12,0,4,1,2,0.56,0.5303,0.6,0.4478,27,405,224,2240,251,2645
10260,2012-03-08,1,1,3,13,0,4,1,2,0.6,0.6212,0.49,0.6418,35,525,198,1980,233,2505
10261,2012-03-08,1,1,3,14,0,4,1,2,0.62,0.6212,0.43,0.6418,48,720,155,1550,203,2270
10262,2012-03-08,1,1,3,15,0,4,1,1,0.64,0.6212,0.38,0.6866,24,360,161,1610,185,1970
10263,2012-03-08,1,1,3,16,0,4,1,2,0.62,0.6212,0.41,0.6418,37,555,305,3050,342,3605
10264,2012-03-08,1,1,3,17,0,4,1,1,0.62,0.6212,0.38,0.6567,52,780,545,5450,597,6230
10265,2012-03-08,1,1,3,18,0,4,1,2,0.62,0.6212,0.38,0.5522,45,675,545,5450,590,6125
10266,2012-03-08,1,1,3,19,0,4,1,2,0.6,0.6212,0.4,0.4478,21,315,395,3950,416,4265
10267,2012-03-08,1,1,3,20,0,4,1,2,0.6,0.6212,0.43,0.3881,20,300,282,2820,302,3120
10268,2012-03-08,1,1,3,21,0,4,1,1,0.6,0.6212,0.43,0.3881,27,405,206,2060,233,2465
10269,2012-03-08,1,1,3,22,0,4,1,1,0.56,0.5303,0.49,0.3284,12,180,141,1410,153,1590
10270,2012-03-08,1,1,3,23,0,4,1,2,0.56,0.5303,0.49,0.4478,6,90,88,880,94,970
10271,2012-03-09,1,1,3,0,0,5,1,2,0.58,0.5455,0.49,0.4627,3,45,51,510,54,555
10272,2012-03-09,1,1,3,1,0,5,1,3,0.56,0.5303,0.52,0.4925,4,60,22,220,26,280
10273,2012-03-09,1,1,3,2,0,5,1,3,0.48,0.4697,0.77,0.4179,2,30,9,90,11,120
10274,2012-03-09,1,1,3,3,0,5,1,1,0.46,0.4545,0.77,0.5224,0,0,7,70,7,70
10275,2012-03-09,1,1,3,4,0,5,1,3,0.4,0.4091,0.66,0.2836,0,0,1,10,1,10
10276,2012-03-09,1,1,3,5,0,5,1,3,0.4,0.4091,0.66,0.2836,2,30,27,270,29,300
10277,2012-03-09,1,1,3,6,0,5,1,2,0.4,0.4091,0.5,0.3582,2,30,83,830,85,860
10278,2012-03-09,1,1,3,7,0,5,1,2,0.38,0.3939,0.4,0.2985,6,90,262,2620,268,2710
10279,2012-03-09,1,1,3,8,0,5,1,2,0.34,0.2879,0.42,0.5224,17,255,484,4840,501,5095
10280,2012-03-09,1,1,3,9,0,5,1,2,0.34,0.2879,0.42,0.5224,17,255,267,2670,284,2925
10281,2012-03-09,1,1,3,10,0,5,1,2,0.34,0.2879,0.36,0.4925,14,210,145,1450,159,1660
10282,2012-03-09,1,1,3,11,0,5,1,2,0.36,0.3333,0.34,0.3582,17,255,170,1700,187,1955
10283,2012-03-09,1,1,3,12,0,5,1,1,0.36,0.3333,0.34,0.4179,27,405,174,1740,201,2145
10284,2012-03-09,1,1,3,13,0,5,1,2,0.38,0.3939,0.29,0.3881,49,735,175,1750,224,2485
10285,2012-03-09,1,1,3,14,0,5,1,1,0.42,0.4242,0.28,0.4627,49,735,129,1290,178,2025
10286,2012-03-09,1,1,3,15,0,5,1,1,0.46,0.4545,0.24,0.2537,50,750,188,1880,238,2630
10287,2012-03-09,1,1,3,16,0,5,1,1,0.48,0.4697,0.23,0.4179,51,765,292,2920,343,3685
10288,2012-03-09,1,1,3,17,0,5,1,1,0.46,0.4545,0.24,0.3881,68,1020,498,4980,566,6000
10289,2012-03-09,1,1,3,18,0,5,1,1,0.44,0.4394,0.26,0.5224,30,450,440,4400,470,4850
10290,2012-03-09,1,1,3,19,0,5,1,1,0.42,0.4242,0.28,0.6119,12,180,232,2320,244,2500
10291,2012-03-09,1,1,3,20,0,5,1,1,0.38,0.3939,0.32,0.3582,3,45,156,1560,159,1605
10292,2012-03-09,1,1,3,21,0,5,1,1,0.36,0.3333,0.34,0.3284,8,120,133,1330,141,1450
10293,2012-03-09,1,1,3,22,0,5,1,1,0.34,0.2879,0.31,0.4925,7,105,100,1000,107,1105
10294,2012-03-09,1,1,3,23,0,5,1,1,0.32,0.303,0.33,0.2985,9,135,77,770,86,905
10295,2012-03-10,1,1,3,0,0,6,0,1,0.3,0.2727,0.36,0.3582,9,135,68,680,77,815
10296,2012-03-10,1,1,3,1,0,6,0,1,0.3,0.2879,0.36,0.2537,1,15,50,500,51,515
10297,2012-03-10,1,1,3,2,0,6,0,1,0.26,0.2424,0.41,0.2537,12,180,30,300,42,480
10298,2012-03-10,1,1,3,3,0,6,0,1,0.26,0.2273,0.41,0.2985,0,0,16,160,16,160
10299,2012-03-10,1,1,3,4,0,6,0,1,0.24,0.2121,0.41,0.3582,1,15,3,30,4,45
10300,2012-03-10,1,1,3,5,0,6,0,1,0.22,0.2121,0.42,0.2836,3,45,7,70,10,115
10301,2012-03-10,1,1,3,6,0,6,0,1,0.22,0.2121,0.44,0.2836,1,15,11,110,12,125
10302,2012-03-10,1,1,3,7,0,6,0,1,0.22,0.2121,0.44,0.2537,4,60,36,360,40,420
10303,2012-03-10,1,1,3,8,0,6,0,1,0.22,0.2121,0.44,0.2985,15,225,96,960,111,1185
10304,2012-03-10,1,1,3,9,0,6,0,1,0.24,0.2121,0.41,0.3284,21,315,127,1270,148,1585
10305,2012-03-10,1,1,3,10,0,6,0,1,0.26,0.2273,0.35,0.4179,47,705,176,1760,223,2465
10306,2012-03-10,1,1,3,11,0,6,0,1,0.3,0.2727,0.33,0.3284,56,840,218,2180,274,3020
10307,2012-03-10,1,1,3,12,0,6,0,1,0.3,0.2727,0.33,0.3284,88,1320,241,2410,329,3730
10308,2012-03-10,1,1,3,13,0,6,0,1,0.32,0.303,0.29,0.2836,89,1335,268,2680,357,4015
10309,2012-03-10,1,1,3,14,0,6,0,1,0.34,0.3182,0.27,0.2836,117,1755,262,2620,379,4375
10310,2012-03-10,1,1,3,15,0,6,0,1,0.34,0.3636,0.25,0.0,132,1980,274,2740,406,4720
10311,2012-03-10,1,1,3,16,0,6,0,1,0.36,0.3636,0.23,0.0,115,1725,275,2750,390,4475
10312,2012-03-10,1,1,3,17,0,6,0,1,0.36,0.3788,0.23,0.0,104,1560,250,2500,354,4060
10313,2012-03-10,1,1,3,18,0,6,0,1,0.36,0.3636,0.21,0.0896,67,1005,230,2300,297,3305
10314,2012-03-10,1,1,3,19,0,6,0,1,0.34,0.3636,0.25,0.0,25,375,159,1590,184,1965
10315,2012-03-10,1,1,3,20,0,6,0,1,0.32,0.3333,0.33,0.1343,20,300,101,1010,121,1310
10316,2012-03-10,1,1,3,21,0,6,0,1,0.3,0.2879,0.39,0.2239,16,240,94,940,110,1180
10317,2012-03-10,1,1,3,22,0,6,0,1,0.26,0.2576,0.44,0.1642,19,285,81,810,100,1095
10318,2012-03-10,1,1,3,23,0,6,0,1,0.26,0.2576,0.41,0.194,6,90,77,770,83,860
10319,2012-03-11,1,1,3,0,0,0,0,1,0.26,0.2879,0.44,0.0896,7,105,62,620,69,725
10320,2012-03-11,1,1,3,1,0,0,0,1,0.24,0.2424,0.52,0.1642,4,60,57,570,61,630
10321,2012-03-11,1,1,3,3,0,0,0,1,0.24,0.2424,0.6,0.1343,15,225,51,510,66,735
10322,2012-03-11,1,1,3,4,0,0,0,1,0.24,0.2424,0.6,0.1343,7,105,15,150,22,255
10323,2012-03-11,1,1,3,5,0,0,0,1,0.24,0.2424,0.6,0.1642,2,30,5,50,7,80
10324,2012-03-11,1,1,3,6,0,0,0,1,0.24,0.2424,0.7,0.1642,2,30,8,80,10,110
10325,2012-03-11,1,1,3,7,0,0,0,1,0.22,0.2273,0.69,0.1343,2,30,15,150,17,180
10326,2012-03-11,1,1,3,8,0,0,0,1,0.22,0.2273,0.69,0.1343,4,60,68,680,72,740
10327,2012-03-11,1,1,3,9,0,0,0,1,0.26,0.2576,0.6,0.2239,20,300,70,700,90,1000
10328,2012-03-11,1,1,3,10,0,0,0,1,0.32,0.303,0.49,0.2836,71,1065,147,1470,218,2535
10329,2012-03-11,1,1,3,11,0,0,0,1,0.36,0.3333,0.43,0.2836,90,1350,209,2090,299,3440
10330,2012-03-11,1,1,3,12,0,0,0,1,0.4,0.4091,0.37,0.2985,146,2190,264,2640,410,4830
10331,2012-03-11,1,1,3,13,0,0,0,1,0.42,0.4242,0.41,0.2985,176,2640,288,2880,464,5520
10332,2012-03-11,1,1,3,14,0,0,0,1,0.46,0.4545,0.31,0.2836,212,3180,289,2890,501,6070
10333,2012-03-11,1,1,3,15,0,0,0,1,0.5,0.4848,0.29,0.2985,201,3015,286,2860,487,5875
10334,2012-03-11,1,1,3,16,0,0,0,1,0.5,0.4848,0.31,0.3582,208,3120,301,3010,509,6130
10335,2012-03-11,1,1,3,17,0,0,0,1,0.52,0.5,0.27,0.2985,199,2985,299,2990,498,5975
10336,2012-03-11,1,1,3,18,0,0,0,1,0.52,0.5,0.29,0.2836,133,1995,256,2560,389,4555
10337,2012-03-11,1,1,3,19,0,0,0,1,0.5,0.4848,0.31,0.2836,55,825,203,2030,258,2855
10338,2012-03-11,1,1,3,20,0,0,0,1,0.44,0.4394,0.47,0.2239,42,630,129,1290,171,1920
10339,2012-03-11,1,1,3,21,0,0,0,1,0.42,0.4242,0.54,0.2239,37,555,110,1100,147,1655
10340,2012-03-11,1,1,3,22,0,0,0,1,0.4,0.4091,0.54,0.194,13,195,81,810,94,1005
10341,2012-03-11,1,1,3,23,0,0,0,1,0.4,0.4091,0.5,0.1642,12,180,40,400,52,580
10342,2012-03-12,1,1,3,0,0,1,1,1,0.38,0.3939,0.54,0.194,4,60,20,200,24,260
10343,2012-03-12,1,1,3,1,0,1,1,1,0.38,0.3939,0.5,0.1343,1,15,9,90,10,105
10344,2012-03-12,1,1,3,2,0,1,1,1,0.38,0.3939,0.54,0.1045,4,60,5,50,9,110
10345,2012-03-12,1,1,3,3,0,1,1,1,0.36,0.3485,0.5,0.1343,0,0,2,20,2,20
10346,2012-03-12,1,1,3,4,0,1,1,1,0.34,0.3333,0.61,0.194,0,0,3,30,3,30
10347,2012-03-12,1,1,3,5,0,1,1,1,0.34,0.3333,0.61,0.194,1,15,15,150,16,165
10348,2012-03-12,1,1,3,6,0,1,1,1,0.34,0.3485,0.57,0.1045,2,30,86,860,88,890
10349,2012-03-12,1,1,3,7,0,1,1,1,0.34,0.3485,0.53,0.1045,9,135,259,2590,268,2725
10350,2012-03-12,1,1,3,8,0,1,1,1,0.34,0.3333,0.61,0.1343,17,255,547,5470,564,5725
10351,2012-03-12,1,1,3,9,0,1,1,1,0.38,0.3939,0.54,0.1642,21,315,260,2600,281,2915
10352,2012-03-12,1,1,3,10,0,1,1,1,0.4,0.4091,0.5,0.2239,39,585,98,980,137,1565
10353,2012-03-12,1,1,3,11,0,1,1,1,0.44,0.4394,0.44,0.2239,39,585,111,1110,150,1695
10354,2012-03-12,1,1,3,12,0,1,1,1,0.48,0.4697,0.39,0.2239,59,885,162,1620,221,2505
10355,2012-03-12,1,1,3,13,0,1,1,2,0.54,0.5152,0.32,0.2537,74,1110,176,1760,250,2870
10356,2012-03-12,1,1,3,14,0,1,1,2,0.58,0.5455,0.32,0.2836,76,1140,145,1450,221,2590
10357,2012-03-12,1,1,3,15,0,1,1,1,0.56,0.5303,0.4,0.1343,74,1110,159,1590,233,2700
10358,2012-03-12,1,1,3,16,0,1,1,1,0.62,0.6212,0.35,0.4478,77,1155,255,2550,332,3705
10359,2012-03-12,1,1,3,17,0,1,1,2,0.62,0.6212,0.38,0.4179,87,1305,557,5570,644,6875
10360,2012-03-12,1,1,3,18,0,1,1,2,0.6,0.6212,0.43,0.194,89,1335,623,6230,712,7565
10361,2012-03-12,1,1,3,19,0,1,1,2,0.56,0.5303,0.49,0.2239,67,1005,379,3790,446,4795
10362,2012-03-12,1,1,3,20,0,1,1,2,0.56,0.5303,0.49,0.2239,49,735,237,2370,286,3105
10363,2012-03-12,1,1,3,21,0,1,1,2,0.54,0.5152,0.56,0.2239,22,330,183,1830,205,2160
10364,2012-03-12,1,1,3,22,0,1,1,2,0.56,0.5303,0.56,0.2239,17,255,116,1160,133,1415
10365,2012-03-12,1,1,3,23,0,1,1,1,0.56,0.5303,0.56,0.2239,10,150,53,530,63,680
10366,2012-03-13,1,1,3,0,0,2,1,2,0.56,0.5303,0.52,0.194,5,75,21,210,26,285
10367,2012-03-13,1,1,3,1,0,2,1,2,0.52,0.5,0.59,0.2239,2,30,14,140,16,170
10368,2012-03-13,1,1,3,2,0,2,1,3,0.52,0.5,0.72,0.2985,0,0,1,10,1,10
10369,2012-03-13,1,1,3,3,0,2,1,3,0.52,0.5,0.72,0.2985,0,0,2,20,2,20
10370,2012-03-13,1,1,3,4,0,2,1,2,0.46,0.4545,0.82,0.194,0,0,1,10,1,10
10371,2012-03-13,1,1,3,5,0,2,1,2,0.46,0.4545,0.82,0.194,0,0,24,240,24,240
10372,2012-03-13,1,1,3,6,0,2,1,3,0.46,0.4545,0.82,0.194,5,75,108,1080,113,1155
10373,2012-03-13,1,1,3,7,0,2,1,2,0.46,0.4545,0.82,0.2836,16,240,292,2920,308,3160
10374,2012-03-13,1,1,3,8,0,2,1,1,0.46,0.4545,0.82,0.2836,22,330,571,5710,593,6040
10375,2012-03-13,1,1,3,9,0,2,1,1,0.48,0.4697,0.82,0.2836,18,270,324,3240,342,3510
10376,2012-03-13,1,1,3,10,0,2,1,1,0.52,0.5,0.77,0.2239,28,420,115,1150,143,1570
10377,2012-03-13,1,1,3,11,0,2,1,1,0.54,0.5152,0.73,0.2836,64,960,155,1550,219,2510
10378,2012-03-13,1,1,3,12,0,2,1,1,0.6,0.6061,0.6,0.2836,47,705,197,1970,244,2675
10379,2012-03-13,1,1,3,13,0,2,1,1,0.6,0.6061,0.6,0.3881,53,795,180,1800,233,2595
10380,2012-03-13,1,1,3,14,0,2,1,1,0.64,0.6212,0.53,0.3284,52,780,160,1600,212,2380
10381,2012-03-13,1,1,3,15,0,2,1,1,0.7,0.6364,0.39,0.2239,68,1020,196,1960,264,2980
10382,2012-03-13,1,1,3,16,0,2,1,1,0.72,0.6515,0.34,0.3881,53,795,312,3120,365,3915
10383,2012-03-13,1,1,3,17,0,2,1,1,0.7,0.6364,0.37,0.1045,62,930,614,6140,676,7070
10384,2012-03-13,1,1,3,18,0,2,1,1,0.7,0.6364,0.34,0.2985,96,1440,638,6380,734,7820
10385,2012-03-13,1,1,3,19,0,2,1,1,0.64,0.6212,0.47,0.2239,50,750,429,4290,479,5040
10386,2012-03-13,1,1,3,20,0,2,1,1,0.6,0.6212,0.49,0.1642,45,675,306,3060,351,3735
10387,2012-03-13,1,1,3,21,0,2,1,1,0.58,0.5455,0.56,0.1045,44,660,200,2000,244,2660
10388,2012-03-13,1,1,3,22,0,2,1,1,0.56,0.5303,0.6,0.0896,24,360,146,1460,170,1820
10389,2012-03-13,1,1,3,23,0,2,1,1,0.56,0.5303,0.56,0.1343,8,120,79,790,87,910
10390,2012-03-14,1,1,3,0,0,3,1,1,0.54,0.5152,0.6,0.1045,5,75,34,340,39,415
10391,2012-03-14,1,1,3,1,0,3,1,1,0.52,0.5,0.63,0.0896,2,30,25,250,27,280
10392,2012-03-14,1,1,3,2,0,3,1,1,0.5,0.4848,0.68,0.194,0,0,2,20,2,20
10393,2012-03-14,1,1,3,3,0,3,1,1,0.48,0.4697,0.72,0.194,1,15,3,30,4,45
10394,2012-03-14,1,1,3,4,0,3,1,1,0.48,0.4697,0.67,0.0896,1,15,4,40,5,55
10395,2012-03-14,1,1,3,5,0,3,1,1,0.44,0.4394,0.82,0.1343,2,30,25,250,27,280
10396,2012-03-14,1,1,3,6,0,3,1,1,0.44,0.4394,0.82,0.0896,1,15,120,1200,121,1215
10397,2012-03-14,1,1,3,7,0,3,1,1,0.44,0.4394,0.82,0.1045,20,300,348,3480,368,3780
10398,2012-03-14,1,1,3,8,0,3,1,1,0.44,0.4394,0.82,0.0,34,510,628,6280,662,6790
10399,2012-03-14,1,1,3,9,0,3,1,1,0.52,0.5,0.68,0.0,26,390,325,3250,351,3640
10400,2012-03-14,1,1,3,10,0,3,1,1,0.56,0.5303,0.56,0.1045,38,570,150,1500,188,2070
10401,2012-03-14,1,1,3,11,0,3,1,2,0.62,0.6212,0.41,0.1642,65,975,155,1550,220,2525
10402,2012-03-14,1,1,3,12,0,3,1,2,0.64,0.6212,0.29,0.0,55,825,212,2120,267,2945
10403,2012-03-14,1,1,3,13,0,3,1,1,0.66,0.6212,0.27,0.2239,57,855,197,1970,254,2825
10404,2012-03-14,1,1,3,14,0,3,1,1,0.7,0.6364,0.23,0.3284,61,915,163,1630,224,2545
10405,2012-03-14,1,1,3,15,0,3,1,1,0.7,0.6364,0.24,0.0,86,1290,197,1970,283,3260
10406,2012-03-14,1,1,3,16,0,3,1,1,0.72,0.6364,0.25,0.194,78,1170,278,2780,356,3950
10407,2012-03-14,1,1,3,17,0,3,1,1,0.7,0.6364,0.28,0.0896,140,2100,642,6420,782,8520
10408,2012-03-14,1,1,3,18,0,3,1,1,0.7,0.6364,0.32,0.0,102,1530,647,6470,749,8000
10409,2012-03-14,1,1,3,19,0,3,1,1,0.64,0.6212,0.33,0.1642,70,1050,402,4020,472,5070
10410,2012-03-14,1,1,3,20,0,3,1,1,0.62,0.6212,0.35,0.1045,44,660,286,2860,330,3520
10411,2012-03-14,1,1,3,21,0,3,1,1,0.6,0.6212,0.4,0.0896,47,705,241,2410,288,3115
10412,2012-03-14,1,1,3,22,0,3,1,1,0.52,0.5,0.55,0.1343,43,645,159,1590,202,2235
10413,2012-03-14,1,1,3,23,0,3,1,1,0.56,0.5303,0.43,0.1642,19,285,72,720,91,1005
10414,2012-03-15,1,1,3,0,0,4,1,1,0.54,0.5152,0.49,0.1343,14,210,46,460,60,670
10415,2012-03-15,1,1,3,1,0,4,1,1,0.5,0.4848,0.59,0.1045,15,225,8,80,23,305
10416,2012-03-15,1,1,3,2,0,4,1,1,0.5,0.4848,0.59,0.0,14,210,5,50,19,260
10417,2012-03-15,1,1,3,3,0,4,1,1,0.5,0.4848,0.63,0.0,0,0,7,70,7,70
10418,2012-03-15,1,1,3,4,0,4,1,1,0.44,0.4394,0.77,0.1045,11,165,3,30,14,195
10419,2012-03-15,1,1,3,5,0,4,1,1,0.46,0.4545,0.67,0.0,2,30,24,240,26,270
10420,2012-03-15,1,1,3,6,0,4,1,1,0.44,0.4394,0.72,0.0896,4,60,113,1130,117,1190
10421,2012-03-15,1,1,3,7,0,4,1,1,0.44,0.4394,0.72,0.0896,14,210,367,3670,381,3880
10422,2012-03-15,1,1,3,8,0,4,1,1,0.44,0.4394,0.77,0.1045,21,315,602,6020,623,6335
10423,2012-03-15,1,1,3,9,0,4,1,1,0.48,0.4697,0.77,0.0896,30,450,285,2850,315,3300
10424,2012-03-15,1,1,3,10,0,4,1,1,0.52,0.5,0.68,0.1045,34,510,130,1300,164,1810
10425,2012-03-15,1,1,3,11,0,4,1,1,0.56,0.5303,0.6,0.1343,60,900,151,1510,211,2410
10426,2012-03-15,1,1,3,12,0,4,1,2,0.62,0.6212,0.5,0.1343,59,885,206,2060,265,2945
10427,2012-03-15,1,1,3,13,0,4,1,2,0.66,0.6212,0.41,0.0896,62,930,211,2110,273,3040
10428,2012-03-15,1,1,3,14,0,4,1,2,0.72,0.6515,0.3,0.1045,81,1215,177,1770,258,2985
10429,2012-03-15,1,1,3,15,0,4,1,1,0.72,0.6515,0.32,0.2239,100,1500,187,1870,287,3370
10430,2012-03-15,1,1,3,16,0,4,1,1,0.72,0.6515,0.37,0.3881,95,1425,331,3310,426,4735
10431,2012-03-15,1,1,3,17,0,4,1,1,0.7,0.6364,0.39,0.2537,79,1185,634,6340,713,7525
10432,2012-03-15,1,1,3,18,0,4,1,1,0.66,0.6212,0.44,0.2836,98,1470,648,6480,746,7950
10433,2012-03-15,1,1,3,19,0,4,1,2,0.64,0.6212,0.5,0.194,72,1080,353,3530,425,4610
10434,2012-03-15,1,1,3,20,0,4,1,2,0.58,0.5455,0.6,0.3582,60,900,270,2700,330,3600
10435,2012-03-15,1,1,3,21,0,4,1,1,0.54,0.5152,0.68,0.2836,36,540,207,2070,243,2610
10436,2012-03-15,1,1,3,22,0,4,1,1,0.52,0.5,0.68,0.1343,32,480,137,1370,169,1850
10437,2012-03-15,1,1,3,23,0,4,1,1,0.48,0.4697,0.72,0.194,12,180,85,850,97,1030
10438,2012-03-16,1,1,3,0,0,5,1,1,0.44,0.4394,0.77,0.2537,8,120,49,490,57,610
10439,2012-03-16,1,1,3,1,0,5,1,2,0.42,0.4242,0.82,0.3284,4,60,22,220,26,280
10440,2012-03-16,1,1,3,2,0,5,1,2,0.42,0.4242,0.82,0.194,0,0,4,40,4,40
10441,2012-03-16,1,1,3,3,0,5,1,2,0.4,0.4091,0.87,0.2836,0,0,3,30,3,30
10442,2012-03-16,1,1,3,4,0,5,1,2,0.4,0.4091,0.87,0.2537,0,0,3,30,3,30
10443,2012-03-16,1,1,3,5,0,5,1,2,0.4,0.4091,0.87,0.2239,2,30,30,300,32,330
10444,2012-03-16,1,1,3,6,0,5,1,2,0.4,0.4091,0.87,0.1642,3,45,96,960,99,1005
10445,2012-03-16,1,1,3,7,0,5,1,2,0.4,0.4091,0.87,0.194,13,195,265,2650,278,2845
10446,2012-03-16,1,1,3,8,0,5,1,2,0.4,0.4091,0.87,0.2239,28,420,534,5340,562,5760
10447,2012-03-16,1,1,3,9,0,5,1,2,0.42,0.4242,0.82,0.0,35,525,277,2770,312,3295
10448,2012-03-16,1,1,3,10,0,5,1,2,0.4,0.4091,0.87,0.0896,44,660,136,1360,180,2020
10449,2012-03-16,1,1,3,11,0,5,1,2,0.44,0.4394,0.77,0.0,40,600,167,1670,207,2270
10450,2012-03-16,1,1,3,12,0,5,1,2,0.44,0.4394,0.82,0.1343,72,1080,222,2220,294,3300
10451,2012-03-16,1,1,3,13,0,5,1,2,0.46,0.4545,0.77,0.0896,52,780,208,2080,260,2860
10452,2012-03-16,1,1,3,14,0,5,1,2,0.48,0.4697,0.72,0.0,56,840,146,1460,202,2300
10453,2012-03-16,1,1,3,15,0,5,1,3,0.46,0.4545,0.82,0.1045,19,285,88,880,107,1165
10454,2012-03-16,1,1,3,16,0,5,1,3,0.48,0.4697,0.77,0.0,18,270,111,1110,129,1380
10455,2012-03-16,1,1,3,17,0,5,1,3,0.48,0.4697,0.82,0.0896,23,345,235,2350,258,2695
10456,2012-03-16,1,1,3,18,0,5,1,3,0.48,0.4697,0.82,0.0896,31,465,377,3770,408,4235
10457,2012-03-16,1,1,3,19,0,5,1,2,0.46,0.4545,0.88,0.0,23,345,273,2730,296,3075
10458,2012-03-16,1,1,3,20,0,5,1,1,0.46,0.4545,0.88,0.0,31,465,204,2040,235,2505
10459,2012-03-16,1,1,3,21,0,5,1,2,0.44,0.4394,0.94,0.0,8,120,144,1440,152,1560
10460,2012-03-16,1,1,3,22,0,5,1,2,0.44,0.4394,0.94,0.0,16,240,132,1320,148,1560
10461,2012-03-16,1,1,3,23,0,5,1,2,0.44,0.4394,0.94,0.0,22,330,104,1040,126,1370
10462,2012-03-17,1,1,3,0,0,6,0,2,0.44,0.4394,0.94,0.0896,13,195,87,870,100,1065
10463,2012-03-17,1,1,3,1,0,6,0,2,0.44,0.4394,0.94,0.0,12,180,57,570,69,750
10464,2012-03-17,1,1,3,2,0,6,0,2,0.44,0.4394,0.88,0.0,10,150,32,320,42,470
10465,2012-03-17,1,1,3,3,0,6,0,2,0.44,0.4394,0.88,0.0,2,30,24,240,26,270
10466,2012-03-17,1,1,3,4,0,6,0,2,0.42,0.4242,0.94,0.0,0,0,2,20,2,20
10467,2012-03-17,1,1,3,5,0,6,0,2,0.42,0.4242,0.94,0.0896,5,75,3,30,8,105
10468,2012-03-17,1,1,3,6,0,6,0,2,0.42,0.4242,0.94,0.194,1,15,29,290,30,305
10469,2012-03-17,1,1,3,7,0,6,0,2,0.4,0.4091,1.0,0.1343,29,435,57,570,86,1005
10470,2012-03-17,1,1,3,8,0,6,0,2,0.42,0.4242,0.94,0.1045,63,945,155,1550,218,2495
10471,2012-03-17,1,1,3,9,0,6,0,2,0.44,0.4394,0.88,0.0896,104,1560,217,2170,321,3730
10472,2012-03-17,1,1,3,10,0,6,0,2,0.5,0.4848,0.77,0.0896,140,2100,303,3030,443,5130
10473,2012-03-17,1,1,3,11,0,6,0,2,0.52,0.5,0.77,0.1343,226,3390,359,3590,585,6980
10474,2012-03-17,1,1,3,12,0,6,0,1,0.56,0.5303,0.68,0.1642,286,4290,365,3650,651,7940
10475,2012-03-17,1,1,3,13,0,6,0,1,0.6,0.6061,0.6,0.1045,286,4290,400,4000,686,8290
10476,2012-03-17,1,1,3,14,0,6,0,1,0.62,0.6212,0.53,0.0896,352,5280,338,3380,690,8660
10477,2012-03-17,1,1,3,15,0,6,0,1,0.64,0.6212,0.53,0.1343,357,5355,322,3220,679,8575
10478,2012-03-17,1,1,3,16,0,6,0,1,0.64,0.6212,0.5,0.0,367,5505,318,3180,685,8685
10479,2012-03-17,1,1,3,17,0,6,0,1,0.64,0.6212,0.5,0.1343,291,4365,357,3570,648,7935
10480,2012-03-17,1,1,3,18,0,6,0,1,0.62,0.6212,0.57,0.2985,221,3315,339,3390,560,6705
10481,2012-03-17,1,1,3,19,0,6,0,1,0.58,0.5455,0.64,0.2836,155,2325,262,2620,417,4945
10482,2012-03-17,1,1,3,20,0,6,0,1,0.56,0.5303,0.64,0.194,89,1335,182,1820,271,3155
10483,2012-03-17,1,1,3,21,0,6,0,1,0.54,0.5152,0.68,0.1642,54,810,169,1690,223,2500
10484,2012-03-17,1,1,3,22,0,6,0,1,0.54,0.5152,0.68,0.0,58,870,153,1530,211,2400
10485,2012-03-17,1,1,3,23,0,6,0,1,0.5,0.4848,0.77,0.1642,34,510,151,1510,185,2020
10486,2012-03-18,1,1,3,0,0,0,0,1,0.46,0.4545,0.88,0.194,27,405,80,800,107,1205
10487,2012-03-18,1,1,3,1,0,0,0,1,0.46,0.4545,0.82,0.1343,25,375,88,880,113,1255
10488,2012-03-18,1,1,3,2,0,0,0,2,0.46,0.4545,0.82,0.1045,15,225,41,410,56,635
10489,2012-03-18,1,1,3,3,0,0,0,2,0.44,0.4394,0.88,0.1343,3,45,15,150,18,195
10490,2012-03-18,1,1,3,4,0,0,0,2,0.42,0.4242,0.94,0.1642,6,90,8,80,14,170
10491,2012-03-18,1,1,3,5,0,0,0,2,0.4,0.4091,0.94,0.1045,0,0,6,60,6,60
10492,2012-03-18,1,1,3,6,0,0,0,2,0.4,0.4091,0.94,0.1045,2,30,9,90,11,120
10493,2012-03-18,1,1,3,7,0,0,0,3,0.42,0.4242,0.88,0.1642,17,255,25,250,42,505
10494,2012-03-18,1,1,3,8,0,0,0,2,0.42,0.4242,0.88,0.1045,25,375,71,710,96,1085
10495,2012-03-18,1,1,3,9,0,0,0,2,0.42,0.4242,0.88,0.0896,65,975,113,1130,178,2105
10496,2012-03-18,1,1,3,10,0,0,0,2,0.42,0.4242,0.88,0.1045,139,2085,212,2120,351,4205
10497,2012-03-18,1,1,3,11,0,0,0,2,0.44,0.4394,0.82,0.1642,129,1935,239,2390,368,4325
10498,2012-03-18,1,1,3,12,0,0,0,2,0.44,0.4394,0.88,0.1343,222,3330,281,2810,503,6140
10499,2012-03-18,1,1,3,13,0,0,0,2,0.46,0.4545,0.82,0.1642,198,2970,346,3460,544,6430
10500,2012-03-18,1,1,3,14,0,0,0,2,0.5,0.4848,0.77,0.0896,218,3270,303,3030,521,6300
10501,2012-03-18,1,1,3,15,0,0,0,1,0.54,0.5152,0.68,0.0896,240,3600,314,3140,554,6740
10502,2012-03-18,1,1,3,16,0,0,0,1,0.54,0.5152,0.73,0.0896,229,3435,312,3120,541,6555
10503,2012-03-18,1,1,3,17,0,0,0,1,0.56,0.5303,0.64,0.0896,233,3495,308,3080,541,6575
10504,2012-03-18,1,1,3,18,0,0,0,1,0.56,0.5303,0.64,0.1642,165,2475,294,2940,459,5415
10505,2012-03-18,1,1,3,19,0,0,0,1,0.56,0.5303,0.64,0.1642,118,1770,234,2340,352,4110
10506,2012-03-18,1,1,3,20,0,0,0,1,0.52,0.5,0.77,0.1343,59,885,139,1390,198,2275
10507,2012-03-18,1,1,3,21,0,0,0,1,0.52,0.5,0.72,0.0896,44,660,129,1290,173,1950
10508,2012-03-18,1,1,3,22,0,0,0,1,0.5,0.4848,0.77,0.1045,21,315,79,790,100,1105
10509,2012-03-18,1,1,3,23,0,0,0,1,0.48,0.4697,0.82,0.1642,7,105,39,390,46,495
10510,2012-03-19,1,1,3,0,0,1,1,1,0.48,0.4697,0.82,0.1045,4,60,19,190,23,250
10511,2012-03-19,1,1,3,1,0,1,1,1,0.46,0.4545,0.88,0.1045,0,0,15,150,15,150
10512,2012-03-19,1,1,3,2,0,1,1,1,0.46,0.4545,0.88,0.1642,1,15,7,70,8,85
10513,2012-03-19,1,1,3,3,0,1,1,1,0.46,0.4545,0.88,0.0896,0,0,2,20,2,20
10514,2012-03-19,1,1,3,4,0,1,1,1,0.44,0.4394,0.94,0.0,0,0,3,30,3,30
10515,2012-03-19,1,1,3,5,0,1,1,1,0.44,0.4394,0.94,0.0,0,0,31,310,31,310
10516,2012-03-19,1,1,3,6,0,1,1,1,0.46,0.4545,0.88,0.1343,2,30,118,1180,120,1210
10517,2012-03-19,1,1,3,7,0,1,1,1,0.46,0.4545,0.88,0.194,25,375,329,3290,354,3665
10518,2012-03-19,1,1,3,8,0,1,1,1,0.46,0.4545,0.88,0.1045,16,240,563,5630,579,5870
10519,2012-03-19,1,1,3,9,0,1,1,1,0.5,0.4848,0.72,0.1642,55,825,276,2760,331,3585
10520,2012-03-19,1,1,3,10,0,1,1,1,0.52,0.5,0.72,0.1343,56,840,128,1280,184,2120
10521,2012-03-19,1,1,3,11,0,1,1,1,0.56,0.5303,0.68,0.1642,56,840,145,1450,201,2290
10522,2012-03-19,1,1,3,12,0,1,1,1,0.6,0.6061,0.64,0.2537,71,1065,211,2110,282,3175
10523,2012-03-19,1,1,3,13,0,1,1,1,0.62,0.6061,0.61,0.2537,69,1035,194,1940,263,2975
10524,2012-03-19,1,1,3,14,0,1,1,2,0.64,0.6212,0.57,0.194,60,900,200,2000,260,2900
10525,2012-03-19,1,1,3,15,0,1,1,1,0.64,0.6212,0.57,0.2239,97,1455,189,1890,286,3345
10526,2012-03-19,1,1,3,16,0,1,1,1,0.66,0.6212,0.5,0.2239,65,975,320,3200,385,4175
10527,2012-03-19,1,1,3,17,0,1,1,1,0.64,0.6212,0.53,0.2239,106,1590,615,6150,721,7740
10528,2012-03-19,1,1,3,18,0,1,1,1,0.64,0.6212,0.57,0.2537,120,1800,681,6810,801,8610
10529,2012-03-19,1,1,3,19,0,1,1,1,0.62,0.6061,0.61,0.2239,86,1290,463,4630,549,5920
10530,2012-03-19,1,1,3,20,0,1,1,1,0.6,0.6061,0.64,0.2239,34,510,296,2960,330,3470
10531,2012-03-19,1,1,3,21,0,1,1,1,0.6,0.6061,0.64,0.1642,33,495,190,1900,223,2395
10532,2012-03-19,1,1,3,22,0,1,1,2,0.56,0.5303,0.73,0.1642,17,255,131,1310,148,1565
10533,2012-03-19,1,1,3,23,0,1,1,2,0.56,0.5303,0.78,0.1343,9,135,45,450,54,585
10534,2012-03-20,1,1,3,0,0,2,1,2,0.56,0.5303,0.78,0.0896,5,75,24,240,29,315
10535,2012-03-20,1,1,3,1,0,2,1,1,0.54,0.5152,0.88,0.0,6,90,9,90,15,180
10536,2012-03-20,1,1,3,2,0,2,1,1,0.54,0.5152,0.88,0.0896,2,30,8,80,10,110
10537,2012-03-20,1,1,3,3,0,2,1,2,0.54,0.5152,0.88,0.0,0,0,3,30,3,30
10538,2012-03-20,1,1,3,4,0,2,1,2,0.52,0.5,0.88,0.1343,0,0,6,60,6,60
10539,2012-03-20,1,1,3,5,0,2,1,2,0.52,0.5,0.94,0.0,0,0,20,200,20,200
10540,2012-03-20,1,1,3,6,0,2,1,2,0.52,0.5,0.94,0.1642,6,90,94,940,100,1030
10541,2012-03-20,1,1,3,7,0,2,1,3,0.52,0.5,0.94,0.2239,3,45,167,1670,170,1715
10542,2012-03-20,1,1,3,8,0,2,1,2,0.52,0.5,0.88,0.1045,28,420,488,4880,516,5300
10543,2012-03-20,1,1,3,9,0,2,1,2,0.54,0.5152,0.88,0.1642,41,615,284,2840,325,3455
10544,2012-03-20,1,1,3,10,0,2,1,1,0.54,0.5152,0.88,0.194,44,660,119,1190,163,1850
10545,2012-03-20,1,1,3,11,0,2,1,1,0.58,0.5455,0.83,0.1343,74,1110,156,1560,230,2670
10546,2012-03-20,1,1,3,12,0,2,1,1,0.6,0.5758,0.78,0.2537,56,840,205,2050,261,2890
10547,2012-03-20,1,1,3,13,0,2,1,1,0.6,0.5758,0.78,0.194,77,1155,207,2070,284,3225
10548,2012-03-20,1,1,3,14,0,2,1,2,0.6,0.5909,0.73,0.1642,66,990,182,1820,248,2810
10549,2012-03-20,1,1,3,15,0,2,1,2,0.62,0.6061,0.69,0.1045,67,1005,177,1770,244,2775
10550,2012-03-20,1,1,3,16,0,2,1,1,0.62,0.6061,0.66,0.2239,99,1485,332,3320,431,4805
10551,2012-03-20,1,1,3,17,0,2,1,1,0.6,0.5909,0.73,0.194,108,1620,642,6420,750,8040
10552,2012-03-20,1,1,3,18,0,2,1,1,0.6,0.5909,0.69,0.2537,136,2040,665,6650,801,8690
10553,2012-03-20,1,1,3,19,0,2,1,1,0.58,0.5455,0.73,0.1343,75,1125,480,4800,555,5925
10554,2012-03-20,1,1,3,20,0,2,1,1,0.58,0.5455,0.68,0.0896,78,1170,299,2990,377,4160
10555,2012-03-20,1,1,3,21,0,2,1,1,0.56,0.5303,0.73,0.0,38,570,239,2390,277,2960
10556,2012-03-20,1,1,3,22,0,2,1,1,0.54,0.5152,0.77,0.0,32,480,156,1560,188,2040
10557,2012-03-20,1,1,3,23,0,2,1,1,0.52,0.5,0.83,0.0,10,150,80,800,90,950
10558,2012-03-21,2,1,3,0,0,3,1,1,0.52,0.5,0.88,0.0,4,60,29,290,33,350
10559,2012-03-21,2,1,3,1,0,3,1,1,0.52,0.5,0.83,0.0896,4,60,22,220,26,280
10560,2012-03-21,2,1,3,2,0,3,1,1,0.5,0.4848,0.88,0.1343,2,30,8,80,10,110
10561,2012-03-21,2,1,3,3,0,3,1,2,0.5,0.4848,0.88,0.194,1,15,7,70,8,85
10562,2012-03-21,2,1,3,4,0,3,1,2,0.5,0.4848,0.88,0.1343,0,0,4,40,4,40
10563,2012-03-21,2,1,3,5,0,3,1,2,0.5,0.4848,0.88,0.1343,4,60,35,350,39,410
10564,2012-03-21,2,1,3,6,0,3,1,2,0.48,0.4697,0.94,0.2239,10,150,139,1390,149,1540
10565,2012-03-21,2,1,3,7,0,3,1,3,0.48,0.4697,0.94,0.194,34,510,338,3380,372,3890
10566,2012-03-21,2,1,3,8,0,3,1,3,0.48,0.4697,0.94,0.1045,33,495,502,5020,535,5515
10567,2012-03-21,2,1,3,9,0,3,1,2,0.5,0.4848,0.88,0.1642,38,570,255,2550,293,3120
10568,2012-03-21,2,1,3,10,0,3,1,2,0.52,0.5,0.83,0.1642,30,450,124,1240,154,1690
10569,2012-03-21,2,1,3,11,0,3,1,2,0.52,0.5,0.83,0.1642,38,570,154,1540,192,2110
10570,2012-03-21,2,1,3,12,0,3,1,2,0.54,0.5152,0.77,0.0,58,870,171,1710,229,2580
10571,2012-03-21,2,1,3,13,0,3,1,2,0.54,0.5152,0.83,0.0,81,1215,222,2220,303,3435
10572,2012-03-21,2,1,3,14,0,3,1,2,0.56,0.5303,0.78,0.0,74,1110,151,1510,225,2620
10573,2012-03-21,2,1,3,15,0,3,1,2,0.56,0.5303,0.78,0.0,68,1020,175,1750,243,2770
10574,2012-03-21,2,1,3,16,0,3,1,1,0.58,0.5455,0.73,0.0,91,1365,287,2870,378,4235
10575,2012-03-21,2,1,3,17,0,3,1,1,0.6,0.5909,0.69,0.0896,113,1695,616,6160,729,7855
10576,2012-03-21,2,1,3,18,0,3,1,1,0.6,0.5909,0.69,0.0,152,2280,627,6270,779,8550
10577,2012-03-21,2,1,3,19,0,3,1,1,0.6,0.6061,0.64,0.0,86,1290,496,4960,582,6250
10578,2012-03-21,2,1,3,20,0,3,1,1,0.56,0.5303,0.78,0.0896,76,1140,298,2980,374,4120
10579,2012-03-21,2,1,3,21,0,3,1,1,0.54,0.5152,0.83,0.1045,47,705,204,2040,251,2745
10580,2012-03-21,2,1,3,22,0,3,1,1,0.52,0.5,0.83,0.1642,41,615,156,1560,197,2175
10581,2012-03-21,2,1,3,23,0,3,1,1,0.54,0.5152,0.77,0.0,37,555,88,880,125,1435
10582,2012-03-22,2,1,3,0,0,4,1,1,0.52,0.5,0.83,0.0896,9,135,32,320,41,455
10583,2012-03-22,2,1,3,1,0,4,1,1,0.52,0.5,0.83,0.0896,14,210,16,160,30,370
10584,2012-03-22,2,1,3,2,0,4,1,1,0.52,0.5,0.83,0.0896,1,15,5,50,6,65
10585,2012-03-22,2,1,3,3,0,4,1,1,0.52,0.5,0.83,0.0896,0,0,7,70,7,70
10586,2012-03-22,2,1,3,4,0,4,1,2,0.48,0.4697,1.0,0.0896,0,0,6,60,6,60
10587,2012-03-22,2,1,3,5,0,4,1,2,0.48,0.4697,1.0,0.0896,2,30,32,320,34,350
10588,2012-03-22,2,1,3,6,0,4,1,2,0.48,0.4697,1.0,0.0896,10,150,126,1260,136,1410
10589,2012-03-22,2,1,3,7,0,4,1,2,0.48,0.4697,1.0,0.0896,29,435,332,3320,361,3755
10590,2012-03-22,2,1,3,8,0,4,1,2,0.5,0.4848,0.94,0.0896,51,765,598,5980,649,6745
10591,2012-03-22,2,1,3,9,0,4,1,2,0.5,0.4848,0.94,0.0896,41,615,277,2770,318,3385
10592,2012-03-22,2,1,3,10,0,4,1,2,0.5,0.4848,1.0,0.0896,32,480,110,1100,142,1580
10593,2012-03-22,2,1,3,11,0,4,1,2,0.52,0.5,0.94,0.0,53,795,166,1660,219,2455
10594,2012-03-22,2,1,3,12,0,4,1,2,0.54,0.5152,0.88,0.194,48,720,224,2240,272,2960
10595,2012-03-22,2,1,3,13,0,4,1,1,0.58,0.5455,0.78,0.0896,83,1245,215,2150,298,3395
10596,2012-03-22,2,1,3,14,0,4,1,1,0.6,0.5909,0.73,0.1045,96,1440,161,1610,257,3050
10597,2012-03-22,2,1,3,15,0,4,1,1,0.62,0.6061,0.69,0.194,102,1530,202,2020,304,3550
10598,2012-03-22,2,1,3,16,0,4,1,1,0.64,0.6061,0.65,0.194,125,1875,300,3000,425,4875
10599,2012-03-22,2,1,3,17,0,4,1,1,0.66,0.6212,0.65,0.1642,154,2310,656,6560,810,8870
10600,2012-03-22,2,1,3,18,0,4,1,1,0.66,0.6212,0.65,0.1642,147,2205,654,6540,801,8745
10601,2012-03-22,2,1,3,19,0,4,1,1,0.66,0.6212,0.61,0.0,117,1755,469,4690,586,6445
10602,2012-03-22,2,1,3,20,0,4,1,1,0.62,0.5909,0.73,0.2836,64,960,360,3600,424,4560
10603,2012-03-22,2,1,3,21,0,4,1,1,0.58,0.5455,0.78,0.1642,66,990,308,3080,374,4070
10604,2012-03-22,2,1,3,22,0,4,1,1,0.56,0.5303,0.83,0.194,56,840,164,1640,220,2480
10605,2012-03-22,2,1,3,23,0,4,1,1,0.56,0.5303,0.83,0.0896,34,510,117,1170,151,1680
10606,2012-03-23,2,1,3,0,0,5,1,1,0.56,0.5303,0.83,0.0,30,450,65,650,95,1100
10607,2012-03-23,2,1,3,1,0,5,1,1,0.54,0.5152,0.88,0.0,18,270,32,320,50,590
10608,2012-03-23,2,1,3,2,0,5,1,1,0.54,0.5152,0.88,0.0896,12,180,20,200,32,380
10609,2012-03-23,2,1,3,3,0,5,1,1,0.52,0.5,0.88,0.1045,4,60,6,60,10,120
10610,2012-03-23,2,1,3,4,0,5,1,2,0.5,0.4848,0.94,0.1045,0,0,3,30,3,30
10611,2012-03-23,2,1,3,5,0,5,1,2,0.5,0.4848,0.94,0.0,5,75,29,290,34,365
10612,2012-03-23,2,1,3,6,0,5,1,2,0.5,0.4848,0.88,0.0,6,90,110,1100,116,1190
10613,2012-03-23,2,1,3,7,0,5,1,2,0.5,0.4848,0.93,0.1343,28,420,318,3180,346,3600
10614,2012-03-23,2,1,3,8,0,5,1,2,0.5,0.4848,0.94,0.1343,47,705,615,6150,662,6855
10615,2012-03-23,2,1,3,9,0,5,1,2,0.52,0.5,0.9,0.0896,75,1125,305,3050,380,4175
10616,2012-03-23,2,1,3,10,0,5,1,2,0.56,0.5303,0.88,0.1045,125,1875,150,1500,275,3375
10617,2012-03-23,2,1,3,11,0,5,1,2,0.62,0.5909,0.73,0.1045,131,1965,187,1870,318,3835
10618,2012-03-23,2,1,3,12,0,5,1,2,0.66,0.6212,0.61,0.2239,199,2985,272,2720,471,5705
10619,2012-03-23,2,1,3,13,0,5,1,2,0.7,0.6515,0.48,0.0,172,2580,256,2560,428,5140
10620,2012-03-23,2,1,3,14,0,5,1,2,0.72,0.6515,0.42,0.1045,208,3120,224,2240,432,5360
10621,2012-03-23,2,1,3,15,0,5,1,2,0.72,0.6515,0.42,0.1343,191,2865,281,2810,472,5675
10622,2012-03-23,2,1,3,16,0,5,1,2,0.72,0.6515,0.42,0.1642,219,3285,370,3700,589,6985
10623,2012-03-23,2,1,3,17,0,5,1,2,0.72,0.6515,0.42,0.1642,264,3960,693,6930,957,10890
10624,2012-03-23,2,1,3,18,0,5,1,1,0.7,0.6364,0.45,0.1642,237,3555,593,5930,830,9485
10625,2012-03-23,2,1,3,19,0,5,1,1,0.66,0.6212,0.5,0.194,213,3195,473,4730,686,7925
10626,2012-03-23,2,1,3,20,0,5,1,1,0.66,0.6212,0.47,0.1343,117,1755,328,3280,445,5035
10627,2012-03-23,2,1,3,21,0,5,1,1,0.62,0.6212,0.53,0.1045,64,960,220,2200,284,3160
10628,2012-03-23,2,1,3,22,0,5,1,1,0.6,0.6061,0.64,0.2836,53,795,218,2180,271,2975
10629,2012-03-23,2,1,3,23,0,5,1,1,0.6,0.5909,0.69,0.2537,51,765,125,1250,176,2015
10630,2012-03-24,2,1,3,0,0,6,0,1,0.58,0.5455,0.68,0.0,45,675,111,1110,156,1785
10631,2012-03-24,2,1,3,1,0,6,0,1,0.56,0.5303,0.73,0.0896,20,300,108,1080,128,1380
10632,2012-03-24,2,1,3,2,0,6,0,1,0.54,0.5152,0.77,0.1045,14,210,55,550,69,760
10633,2012-03-24,2,1,3,3,0,6,0,1,0.54,0.5152,0.77,0.1045,10,150,22,220,32,370
10634,2012-03-24,2,1,3,4,0,6,0,1,0.52,0.5,0.83,0.0896,1,15,6,60,7,75
10635,2012-03-24,2,1,3,5,0,6,0,2,0.52,0.5,0.83,0.1642,0,0,4,40,4,40
10636,2012-03-24,2,1,3,6,0,6,0,2,0.52,0.5,0.83,0.1642,4,60,24,240,28,300
10637,2012-03-24,2,1,3,7,0,6,0,2,0.5,0.4848,0.88,0.1343,25,375,45,450,70,825
10638,2012-03-24,2,1,3,8,0,6,0,2,0.5,0.4848,0.94,0.194,41,615,113,1130,154,1745
10639,2012-03-24,2,1,3,9,0,6,0,2,0.52,0.5,0.83,0.1343,96,1440,153,1530,249,2970
10640,2012-03-24,2,1,3,10,0,6,0,2,0.52,0.5,0.88,0.194,148,2220,197,1970,345,4190
10641,2012-03-24,2,1,3,11,0,6,0,2,0.5,0.4848,0.94,0.194,98,1470,175,1750,273,3220
10642,2012-03-24,2,1,3,12,0,6,0,3,0.52,0.5,0.94,0.2239,61,915,122,1220,183,2135
10643,2012-03-24,2,1,3,13,0,6,0,3,0.52,0.5,0.94,0.2537,62,930,134,1340,196,2270
10644,2012-03-24,2,1,3,14,0,6,0,3,0.52,0.5,0.88,0.3582,63,945,160,1600,223,2545
10645,2012-03-24,2,1,3,15,0,6,0,3,0.5,0.4848,0.94,0.4179,118,1770,172,1720,290,3490
10646,2012-03-24,2,1,3,16,0,6,0,3,0.5,0.4848,0.94,0.2985,49,735,128,1280,177,2015
10647,2012-03-24,2,1,3,17,0,6,0,3,0.5,0.4848,0.88,0.2239,47,705,68,680,115,1385
10648,2012-03-24,2,1,3,18,0,6,0,3,0.46,0.4545,0.94,0.2239,27,405,110,1100,137,1505
10649,2012-03-24,2,1,3,19,0,6,0,3,0.46,0.4545,0.94,0.1343,28,420,105,1050,133,1470
10650,2012-03-24,2,1,3,20,0,6,0,3,0.44,0.4394,1.0,0.194,31,465,80,800,111,1265
10651,2012-03-24,2,1,3,21,0,6,0,3,0.44,0.4394,1.0,0.194,16,240,88,880,104,1120
10652,2012-03-24,2,1,3,22,0,6,0,3,0.44,0.4394,1.0,0.2537,12,180,71,710,83,890
10653,2012-03-24,2,1,3,23,0,6,0,2,0.44,0.4394,0.94,0.2836,17,255,88,880,105,1135
10654,2012-03-25,2,1,3,0,0,0,0,2,0.44,0.4394,0.94,0.2836,18,270,62,620,80,890
10655,2012-03-25,2,1,3,1,0,0,0,2,0.42,0.4242,1.0,0.2537,24,360,65,650,89,1010
10656,2012-03-25,2,1,3,2,0,0,0,3,0.42,0.4242,1.0,0.2985,6,90,29,290,35,380
10657,2012-03-25,2,1,3,3,0,0,0,3,0.42,0.4242,0.94,0.2985,8,120,10,100,18,220
10658,2012-03-25,2,1,3,4,0,0,0,2,0.42,0.4242,0.94,0.3284,1,15,7,70,8,85
10659,2012-03-25,2,1,3,5,0,0,0,2,0.4,0.4091,1.0,0.2537,0,0,6,60,6,60
10660,2012-03-25,2,1,3,6,0,0,0,2,0.4,0.4091,1.0,0.2537,5,75,13,130,18,205
10661,2012-03-25,2,1,3,7,0,0,0,2,0.4,0.4091,0.94,0.3284,14,210,25,250,39,460
10662,2012-03-25,2,1,3,8,0,0,0,2,0.4,0.4091,0.94,0.3284,21,315,68,680,89,995
10663,2012-03-25,2,1,3,9,0,0,0,2,0.4,0.4091,0.94,0.2537,26,390,92,920,118,1310
10664,2012-03-25,2,1,3,10,0,0,0,2,0.4,0.4091,0.87,0.3284,78,1170,172,1720,250,2890
10665,2012-03-25,2,1,3,11,0,0,0,2,0.4,0.4091,0.94,0.2537,106,1590,217,2170,323,3760
10666,2012-03-25,2,1,3,12,0,0,0,2,0.4,0.4091,0.94,0.2239,122,1830,238,2380,360,4210
10667,2012-03-25,2,1,3,13,0,0,0,2,0.42,0.4242,0.88,0.1642,110,1650,257,2570,367,4220
10668,2012-03-25,2,1,3,14,0,0,0,2,0.44,0.4394,0.88,0.1642,123,1845,291,2910,414,4755
10669,2012-03-25,2,1,3,15,0,0,0,2,0.44,0.4394,0.88,0.194,139,2085,282,2820,421,4905
10670,2012-03-25,2,1,3,16,0,0,0,1,0.48,0.4697,0.77,0.0,153,2295,339,3390,492,5685
10671,2012-03-25,2,1,3,17,0,0,0,1,0.5,0.4848,0.72,0.0896,146,2190,273,2730,419,4920
10672,2012-03-25,2,1,3,18,0,0,0,1,0.5,0.4848,0.72,0.0896,202,3030,289,2890,491,5920
10673,2012-03-25,2,1,3,19,0,0,0,1,0.5,0.4848,0.72,0.2537,114,1710,261,2610,375,4320
10674,2012-03-25,2,1,3,20,0,0,0,1,0.48,0.4697,0.77,0.2239,63,945,196,1960,259,2905
10675,2012-03-25,2,1,3,21,0,0,0,1,0.48,0.4697,0.77,0.1642,25,375,124,1240,149,1615
10676,2012-03-25,2,1,3,22,0,0,0,1,0.46,0.4545,0.82,0.1343,19,285,92,920,111,1205
10677,2012-03-25,2,1,3,23,0,0,0,1,0.48,0.4697,0.82,0.1343,9,135,56,560,65,695
10678,2012-03-26,2,1,3,0,0,1,1,2,0.48,0.4697,0.82,0.1642,10,150,23,230,33,380
10679,2012-03-26,2,1,3,1,0,1,1,1,0.48,0.4697,0.82,0.2537,18,270,10,100,28,370
10680,2012-03-26,2,1,3,2,0,1,1,1,0.46,0.4545,0.88,0.2239,14,210,6,60,20,270
10681,2012-03-26,2,1,3,3,0,1,1,1,0.46,0.4545,0.82,0.194,0,0,1,10,1,10
10682,2012-03-26,2,1,3,4,0,1,1,1,0.44,0.4394,0.82,0.1642,0,0,4,40,4,40
10683,2012-03-26,2,1,3,5,0,1,1,1,0.44,0.4394,0.77,0.1642,0,0,36,360,36,360
10684,2012-03-26,2,1,3,6,0,1,1,1,0.42,0.4242,0.82,0.194,7,105,110,1100,117,1205
10685,2012-03-26,2,1,3,7,0,1,1,1,0.44,0.4394,0.72,0.194,15,225,355,3550,370,3775
10686,2012-03-26,2,1,3,8,0,1,1,1,0.44,0.4394,0.62,0.2239,32,480,625,6250,657,6730
10687,2012-03-26,2,1,3,9,0,1,1,1,0.46,0.4545,0.47,0.2836,37,555,245,2450,282,3005
10688,2012-03-26,2,1,3,10,0,1,1,1,0.5,0.4848,0.36,0.5821,55,825,98,980,153,1805
10689,2012-03-26,2,1,3,11,0,1,1,1,0.48,0.4697,0.31,0.5821,47,705,131,1310,178,2015
10690,2012-03-26,2,1,3,12,0,1,1,1,0.48,0.4697,0.33,0.5224,63,945,216,2160,279,3105
10691,2012-03-26,2,1,3,13,0,1,1,1,0.48,0.4697,0.29,0.6866,79,1185,222,2220,301,3405
10692,2012-03-26,2,1,3,14,0,1,1,1,0.48,0.4697,0.33,0.4478,58,870,159,1590,217,2460
10693,2012-03-26,2,1,3,15,0,1,1,1,0.48,0.4697,0.29,0.6119,66,990,157,1570,223,2560
10694,2012-03-26,2,1,3,16,0,1,1,1,0.48,0.4697,0.25,0.6418,60,900,245,2450,305,3350
10695,2012-03-26,2,1,3,17,0,1,1,1,0.46,0.4545,0.24,0.4478,65,975,599,5990,664,6965
10696,2012-03-26,2,1,3,18,0,1,1,1,0.44,0.4394,0.26,0.4478,90,1350,594,5940,684,7290
10697,2012-03-26,2,1,3,19,0,1,1,1,0.42,0.4242,0.24,0.3582,41,615,417,4170,458,4785
10698,2012-03-26,2,1,3,20,0,1,1,1,0.4,0.4091,0.26,0.5224,12,180,209,2090,221,2270
10699,2012-03-26,2,1,3,21,0,1,1,1,0.38,0.3939,0.25,0.4925,11,165,175,1750,186,1915
10700,2012-03-26,2,1,3,22,0,1,1,1,0.36,0.3333,0.25,0.3582,13,195,80,800,93,995
10701,2012-03-26,2,1,3,23,0,1,1,1,0.34,0.2879,0.25,0.5224,2,30,46,460,48,490
10702,2012-03-27,2,1,3,0,0,2,1,1,0.32,0.2879,0.26,0.5224,1,15,9,90,10,105
10703,2012-03-27,2,1,3,1,0,2,1,1,0.3,0.2727,0.26,0.4627,1,15,4,40,5,55
10704,2012-03-27,2,1,3,2,0,2,1,1,0.26,0.2273,0.3,0.2985,1,15,6,60,7,75
10705,2012-03-27,2,1,3,3,0,2,1,1,0.26,0.2273,0.3,0.3284,0,0,4,40,4,40
10706,2012-03-27,2,1,3,4,0,2,1,1,0.24,0.2121,0.32,0.3582,0,0,3,30,3,30
10707,2012-03-27,2,1,3,5,0,2,1,1,0.22,0.2121,0.37,0.2836,1,15,16,160,17,175
10708,2012-03-27,2,1,3,6,0,2,1,1,0.22,0.2273,0.37,0.194,5,75,96,960,101,1035
10709,2012-03-27,2,1,3,7,0,2,1,1,0.22,0.2273,0.37,0.194,9,135,277,2770,286,2905
10710,2012-03-27,2,1,3,8,0,2,1,1,0.22,0.2121,0.37,0.2985,14,210,567,5670,581,5880
10711,2012-03-27,2,1,3,9,0,2,1,1,0.24,0.2273,0.38,0.194,8,120,259,2590,267,2710
10712,2012-03-27,2,1,3,10,0,2,1,1,0.26,0.2576,0.35,0.2239,20,300,118,1180,138,1480
10713,2012-03-27,2,1,3,11,0,2,1,1,0.3,0.303,0.31,0.1642,34,510,141,1410,175,1920
10714,2012-03-27,2,1,3,12,0,2,1,1,0.32,0.3182,0.31,0.1642,34,510,186,1860,220,2370
10715,2012-03-27,2,1,3,13,0,2,1,1,0.36,0.3485,0.27,0.0,46,690,165,1650,211,2340
10716,2012-03-27,2,1,3,14,0,2,1,1,0.4,0.4091,0.24,0.1343,37,555,147,1470,184,2025
10717,2012-03-27,2,1,3,15,0,2,1,1,0.42,0.4242,0.2,0.0,42,630,158,1580,200,2210
10718,2012-03-27,2,1,3,16,0,2,1,1,0.42,0.4242,0.2,0.0,38,570,267,2670,305,3240
10719,2012-03-27,2,1,3,17,0,2,1,1,0.44,0.4394,0.16,0.0,72,1080,542,5420,614,6500
10720,2012-03-27,2,1,3,18,0,2,1,1,0.42,0.4242,0.17,0.0896,67,1005,577,5770,644,6775
10721,2012-03-27,2,1,3,19,0,2,1,1,0.42,0.4242,0.17,0.0,40,600,377,3770,417,4370
10722,2012-03-27,2,1,3,20,0,2,1,1,0.42,0.4242,0.17,0.0896,28,420,266,2660,294,3080
10723,2012-03-27,2,1,3,21,0,2,1,1,0.36,0.3485,0.37,0.1642,21,315,200,2000,221,2315
10724,2012-03-27,2,1,3,22,0,2,1,1,0.36,0.3485,0.37,0.1343,7,105,127,1270,134,1375
10725,2012-03-27,2,1,3,23,0,2,1,1,0.36,0.3485,0.37,0.194,5,75,59,590,64,665
10726,2012-03-28,2,1,3,0,0,3,1,1,0.36,0.3333,0.4,0.2836,1,15,29,290,30,305
10727,2012-03-28,2,1,3,1,0,3,1,1,0.36,0.3333,0.46,0.2985,0,0,8,80,8,80
10728,2012-03-28,2,1,3,2,0,3,1,1,0.34,0.303,0.49,0.2985,0,0,3,30,3,30
10729,2012-03-28,2,1,3,3,0,3,1,1,0.34,0.303,0.42,0.3284,1,15,4,40,5,55
10730,2012-03-28,2,1,3,4,0,3,1,1,0.36,0.3333,0.43,0.2985,1,15,0,0,1,15
10731,2012-03-28,2,1,3,5,0,3,1,1,0.36,0.3333,0.43,0.2985,2,30,38,380,40,410
10732,2012-03-28,2,1,3,6,0,3,1,1,0.36,0.3333,0.46,0.3582,4,60,111,1110,115,1170
10733,2012-03-28,2,1,3,7,0,3,1,1,0.36,0.3333,0.46,0.3284,10,150,348,3480,358,3630
10734,2012-03-28,2,1,3,8,0,3,1,1,0.38,0.3939,0.46,0.3582,19,285,639,6390,658,6675
10735,2012-03-28,2,1,3,9,0,3,1,1,0.4,0.4091,0.43,0.4478,16,240,298,2980,314,3220
10736,2012-03-28,2,1,3,10,0,3,1,1,0.46,0.4545,0.41,0.4179,33,495,140,1400,173,1895
10737,2012-03-28,2,1,3,11,0,3,1,1,0.5,0.4848,0.42,0.3881,54,810,168,1680,222,2490
10738,2012-03-28,2,1,3,12,0,3,1,2,0.54,0.5152,0.39,0.3582,50,750,218,2180,268,2930
10739,2012-03-28,2,1,3,13,0,3,1,1,0.56,0.5303,0.43,0.3284,60,900,213,2130,273,3030
10740,2012-03-28,2,1,3,14,0,3,1,1,0.62,0.6212,0.38,0.3582,52,780,169,1690,221,2470
10741,2012-03-28,2,1,3,15,0,3,1,2,0.62,0.6212,0.41,0.2985,47,705,152,1520,199,2225
10742,2012-03-28,2,1,3,16,0,3,1,3,0.62,0.6212,0.43,0.0896,51,765,170,1700,221,2465
10743,2012-03-28,2,1,3,17,0,3,1,1,0.6,0.6061,0.6,0.2239,72,1080,532,5320,604,6400
10744,2012-03-28,2,1,3,18,0,3,1,1,0.6,0.6061,0.6,0.2239,61,915,580,5800,641,6715
10745,2012-03-28,2,1,3,19,0,3,1,1,0.6,0.6212,0.56,0.194,41,615,415,4150,456,4765
10746,2012-03-28,2,1,3,20,0,3,1,1,0.6,0.6212,0.56,0.2985,38,570,324,3240,362,3810
10747,2012-03-28,2,1,3,21,0,3,1,1,0.58,0.5455,0.6,0.2537,28,420,233,2330,261,2750
10748,2012-03-28,2,1,3,22,0,3,1,1,0.56,0.5303,0.64,0.1343,21,315,151,1510,172,1825
10749,2012-03-28,2,1,3,23,0,3,1,1,0.54,0.5152,0.68,0.1343,12,180,81,810,93,990
10750,2012-03-29,2,1,3,0,0,4,1,1,0.54,0.5152,0.68,0.194,10,150,38,380,48,530
10751,2012-03-29,2,1,3,1,0,4,1,1,0.56,0.5303,0.6,0.1343,15,225,18,180,33,405
10752,2012-03-29,2,1,3,2,0,4,1,1,0.6,0.6061,0.28,0.2985,0,0,6,60,6,60
10753,2012-03-29,2,1,3,3,0,4,1,1,0.58,0.5455,0.28,0.2537,1,15,4,40,5,55
10754,2012-03-29,2,1,3,4,0,4,1,1,0.52,0.5,0.36,0.2537,1,15,8,80,9,95
10755,2012-03-29,2,1,3,5,0,4,1,1,0.5,0.4848,0.45,0.2239,2,30,30,300,32,330
10756,2012-03-29,2,1,3,6,0,4,1,1,0.46,0.4545,0.59,0.2537,3,45,114,1140,117,1185
10757,2012-03-29,2,1,3,7,0,4,1,1,0.46,0.4545,0.51,0.3582,14,210,353,3530,367,3740
10758,2012-03-29,2,1,3,8,0,4,1,1,0.46,0.4545,0.47,0.4179,26,390,628,6280,654,6670
10759,2012-03-29,2,1,3,9,0,4,1,1,0.48,0.4697,0.48,0.4179,22,330,299,2990,321,3320
10760,2012-03-29,2,1,3,10,0,4,1,1,0.46,0.4545,0.47,0.4478,42,630,124,1240,166,1870
10761,2012-03-29,2,1,3,11,0,4,1,1,0.5,0.4848,0.45,0.4179,54,810,166,1660,220,2470
10762,2012-03-29,2,1,3,12,0,4,1,1,0.5,0.4848,0.42,0.4925,64,960,228,2280,292,3240
10763,2012-03-29,2,1,3,13,0,4,1,1,0.46,0.4545,0.44,0.3284,50,750,223,2230,273,2980
10764,2012-03-29,2,1,3,14,0,4,1,1,0.5,0.4848,0.42,0.3582,63,945,175,1750,238,2695
10765,2012-03-29,2,1,3,15,0,4,1,1,0.52,0.5,0.39,0.3582,109,1635,198,1980,307,3615
10766,2012-03-29,2,1,3,16,0,4,1,1,0.52,0.5,0.36,0.3284,67,1005,321,3210,388,4215
10767,2012-03-29,2,1,3,17,0,4,1,1,0.52,0.5,0.38,0.3881,83,1245,620,6200,703,7445
10768,2012-03-29,2,1,3,18,0,4,1,1,0.5,0.4848,0.39,0.2985,83,1245,598,5980,681,7225
10769,2012-03-29,2,1,3,19,0,4,1,1,0.48,0.4697,0.39,0.2836,47,705,421,4210,468,4915
10770,2012-03-29,2,1,3,20,0,4,1,1,0.46,0.4545,0.38,0.2985,34,510,301,3010,335,3520
10771,2012-03-29,2,1,3,21,0,4,1,1,0.44,0.4394,0.44,0.2836,10,150,214,2140,224,2290
10772,2012-03-29,2,1,3,22,0,4,1,1,0.42,0.4242,0.44,0.2836,17,255,135,1350,152,1605
10773,2012-03-29,2,1,3,23,0,4,1,1,0.42,0.4242,0.47,0.2985,17,255,77,770,94,1025
10774,2012-03-30,2,1,3,0,0,5,1,1,0.4,0.4091,0.47,0.2985,10,150,49,490,59,640
10775,2012-03-30,2,1,3,1,0,5,1,1,0.38,0.3939,0.5,0.2836,6,90,21,210,27,300
10776,2012-03-30,2,1,3,2,0,5,1,1,0.36,0.3333,0.53,0.2985,1,15,6,60,7,75
10777,2012-03-30,2,1,3,3,0,5,1,1,0.34,0.3333,0.61,0.1343,0,0,7,70,7,70
10778,2012-03-30,2,1,3,4,0,5,1,1,0.34,0.3485,0.53,0.0896,1,15,1,10,2,25
10779,2012-03-30,2,1,3,5,0,5,1,1,0.32,0.3333,0.61,0.0896,0,0,26,260,26,260
10780,2012-03-30,2,1,3,6,0,5,1,1,0.32,0.3333,0.57,0.1343,5,75,81,810,86,885
10781,2012-03-30,2,1,3,7,0,5,1,1,0.32,0.3182,0.57,0.1642,9,135,280,2800,289,2935
10782,2012-03-30,2,1,3,8,0,5,1,1,0.32,0.3182,0.66,0.1642,38,570,555,5550,593,6120
10783,2012-03-30,2,1,3,9,0,5,1,1,0.34,0.3333,0.57,0.1642,29,435,292,2920,321,3355
10784,2012-03-30,2,1,3,10,0,5,1,2,0.36,0.3636,0.57,0.1045,50,750,137,1370,187,2120
10785,2012-03-30,2,1,3,11,0,5,1,2,0.36,0.3788,0.53,0.0,48,720,153,1530,201,2250
10786,2012-03-30,2,1,3,12,0,5,1,2,0.38,0.3939,0.54,0.0,62,930,208,2080,270,3010
10787,2012-03-30,2,1,3,13,0,5,1,3,0.4,0.4091,0.5,0.0,44,660,198,1980,242,2640
10788,2012-03-30,2,1,3,14,0,5,1,3,0.4,0.4091,0.54,0.0,56,840,173,1730,229,2570
10789,2012-03-30,2,1,3,15,0,5,1,3,0.42,0.4242,0.54,0.0,73,1095,207,2070,280,3165
10790,2012-03-30,2,1,3,16,0,5,1,3,0.4,0.4091,0.62,0.2836,75,1125,292,2920,367,4045
10791,2012-03-30,2,1,3,17,0,5,1,2,0.4,0.4091,0.62,0.2239,93,1395,513,5130,606,6525
10792,2012-03-30,2,1,3,18,0,5,1,1,0.42,0.4242,0.54,0.194,68,1020,492,4920,560,5940
10793,2012-03-30,2,1,3,19,0,5,1,1,0.4,0.4091,0.62,0.2239,42,630,353,3530,395,4160
10794,2012-03-30,2,1,3,20,0,5,1,1,0.4,0.4091,0.62,0.1642,17,255,192,1920,209,2175
10795,2012-03-30,2,1,3,21,0,5,1,1,0.38,0.3939,0.66,0.1343,30,450,190,1900,220,2350
10796,2012-03-30,2,1,3,22,0,5,1,1,0.36,0.3485,0.71,0.1642,23,345,130,1300,153,1645
10797,2012-03-30,2,1,3,23,0,5,1,1,0.36,0.3788,0.71,0.0,16,240,107,1070,123,1310
10798,2012-03-31,2,1,3,0,0,6,0,1,0.38,0.3939,0.82,0.194,12,180,80,800,92,980
10799,2012-03-31,2,1,3,1,0,6,0,2,0.4,0.4091,0.76,0.194,17,255,65,650,82,905
10800,2012-03-31,2,1,3,2,0,6,0,2,0.42,0.4242,0.77,0.2537,14,210,55,550,69,760
10801,2012-03-31,2,1,3,3,0,6,0,1,0.4,0.4091,0.82,0.2537,10,150,21,210,31,360
10802,2012-03-31,2,1,3,4,0,6,0,1,0.42,0.4242,0.77,0.4179,4,60,4,40,8,100
10803,2012-03-31,2,1,3,5,0,6,0,1,0.4,0.4091,0.82,0.2239,0,0,5,50,5,50
10804,2012-03-31,2,1,3,6,0,6,0,2,0.36,0.3485,0.87,0.1642,7,105,16,160,23,265
10805,2012-03-31,2,1,3,7,0,6,0,2,0.36,0.3485,0.87,0.1642,5,75,39,390,44,465
10806,2012-03-31,2,1,3,8,0,6,0,2,0.36,0.3485,0.87,0.194,19,285,126,1260,145,1545
10807,2012-03-31,2,1,3,9,0,6,0,2,0.4,0.4091,0.76,0.194,62,930,161,1610,223,2540
10808,2012-03-31,2,1,3,10,0,6,0,2,0.4,0.4091,0.76,0.1343,108,1620,205,2050,313,3670
10809,2012-03-31,2,1,3,11,0,6,0,1,0.46,0.4545,0.72,0.1343,184,2760,279,2790,463,5550
10810,2012-03-31,2,1,3,12,0,6,0,1,0.48,0.4697,0.67,0.0,263,3945,358,3580,621,7525
10811,2012-03-31,2,1,3,13,0,6,0,1,0.54,0.5152,0.6,0.1343,265,3975,373,3730,638,7705
10812,2012-03-31,2,1,3,14,0,6,0,2,0.5,0.4848,0.63,0.2537,240,3600,311,3110,551,6710
10813,2012-03-31,2,1,3,15,0,6,0,2,0.52,0.5,0.59,0.2836,275,4125,330,3300,605,7425
10814,2012-03-31,2,1,3,16,0,6,0,2,0.5,0.4848,0.63,0.2985,243,3645,292,2920,535,6565
10815,2012-03-31,2,1,3,17,0,6,0,1,0.48,0.4697,0.67,0.4179,238,3570,305,3050,543,6620
10816,2012-03-31,2,1,3,18,0,6,0,2,0.44,0.4394,0.72,0.4627,102,1530,239,2390,341,3920
10817,2012-03-31,2,1,3,19,0,6,0,1,0.42,0.4242,0.71,0.4478,93,1395,191,1910,284,3305
10818,2012-03-31,2,1,3,20,0,6,0,2,0.4,0.4091,0.71,0.3284,52,780,156,1560,208,2340
10819,2012-03-31,2,1,3,21,0,6,0,2,0.4,0.4091,0.71,0.3284,36,540,107,1070,143,1610
10820,2012-03-31,2,1,3,22,0,6,0,2,0.38,0.3939,0.71,0.2537,40,600,116,1160,156,1760
10821,2012-03-31,2,1,3,23,0,6,0,2,0.36,0.3333,0.76,0.2836,12,180,100,1000,112,1180
10822,2012-04-01,2,1,4,0,0,0,0,2,0.36,0.3333,0.76,0.2537,8,120,59,590,67,710
10823,2012-04-01,2,1,4,1,0,0,0,2,0.36,0.3485,0.76,0.1642,13,195,49,490,62,685
10824,2012-04-01,2,1,4,2,0,0,0,2,0.36,0.3485,0.76,0.1642,20,300,61,610,81,910
10825,2012-04-01,2,1,4,3,0,0,0,2,0.34,0.3333,0.81,0.1343,4,60,21,210,25,270
10826,2012-04-01,2,1,4,4,0,0,0,2,0.34,0.3485,0.81,0.0896,3,45,9,90,12,135
10827,2012-04-01,2,1,4,5,0,0,0,2,0.34,0.3485,0.81,0.0896,8,120,10,100,18,220
10828,2012-04-01,2,1,4,6,0,0,0,2,0.36,0.3485,0.76,0.1343,9,135,88,880,97,1015
10829,2012-04-01,2,1,4,7,0,0,0,2,0.36,0.3485,0.71,0.1343,29,435,55,550,84,985
10830,2012-04-01,2,1,4,8,0,0,0,2,0.36,0.3636,0.76,0.0896,37,555,88,880,125,1435
10831,2012-04-01,2,1,4,9,0,0,0,2,0.36,0.3485,0.81,0.1343,102,1530,173,1730,275,3260
10832,2012-04-01,2,1,4,10,0,0,0,2,0.4,0.4091,0.71,0.1045,132,1980,228,2280,360,4260
10833,2012-04-01,2,1,4,11,0,0,0,2,0.4,0.4091,0.71,0.194,180,2700,271,2710,451,5410
10834,2012-04-01,2,1,4,12,0,0,0,2,0.42,0.4242,0.67,0.2239,187,2805,258,2580,445,5385
10835,2012-04-01,2,1,4,13,0,0,0,2,0.44,0.4394,0.62,0.194,190,2850,274,2740,464,5590
10836,2012-04-01,2,1,4,14,0,0,0,2,0.48,0.4697,0.55,0.2239,283,4245,278,2780,561,7025
10837,2012-04-01,2,1,4,15,0,0,0,1,0.5,0.4848,0.55,0.2537,295,4425,278,2780,573,7205
10838,2012-04-01,2,1,4,16,0,0,0,1,0.52,0.5,0.52,0.2537,236,3540,275,2750,511,6290
10839,2012-04-01,2,1,4,17,0,0,0,1,0.52,0.5,0.55,0.2836,232,3480,323,3230,555,6710
10840,2012-04-01,2,1,4,18,0,0,0,1,0.52,0.5,0.52,0.2985,153,2295,279,2790,432,5085
10841,2012-04-01,2,1,4,19,0,0,0,1,0.52,0.5,0.55,0.2239,110,1650,236,2360,346,4010
10842,2012-04-01,2,1,4,20,0,0,0,2,0.5,0.4848,0.59,0.2239,66,990,166,1660,232,2650
10843,2012-04-01,2,1,4,21,0,0,0,2,0.5,0.4848,0.59,0.1642,33,495,101,1010,134,1505
10844,2012-04-01,2,1,4,22,0,0,0,3,0.5,0.4848,0.63,0.1045,7,105,61,610,68,715
10845,2012-04-01,2,1,4,23,0,0,0,3,0.46,0.4545,0.72,0.0,10,150,53,530,63,680
10846,2012-04-02,2,1,4,0,0,1,1,3,0.44,0.4394,0.82,0.1045,6,90,11,110,17,200
10847,2012-04-02,2,1,4,1,0,1,1,3,0.42,0.4242,0.88,0.0896,0,0,5,50,5,50
10848,2012-04-02,2,1,4,2,0,1,1,3,0.44,0.4394,0.94,0.1343,2,30,3,30,5,60
10849,2012-04-02,2,1,4,4,0,1,1,1,0.4,0.4091,0.76,0.4925,2,30,2,20,4,50
10850,2012-04-02,2,1,4,5,0,1,1,1,0.4,0.4091,0.76,0.4925,2,30,22,220,24,250
10851,2012-04-02,2,1,4,6,0,1,1,1,0.36,0.3182,0.71,0.4627,6,90,104,1040,110,1130
10852,2012-04-02,2,1,4,7,0,1,1,1,0.34,0.303,0.66,0.3881,12,180,294,2940,306,3120
10853,2012-04-02,2,1,4,8,0,1,1,1,0.36,0.3333,0.57,0.3284,36,540,553,5530,589,6070
10854,2012-04-02,2,1,4,9,0,1,1,1,0.38,0.3939,0.54,0.3582,52,780,265,2650,317,3430
10855,2012-04-02,2,1,4,10,0,1,1,1,0.4,0.4091,0.5,0.5224,85,1275,119,1190,204,2465
10856,2012-04-02,2,1,4,11,0,1,1,1,0.42,0.4242,0.47,0.4478,81,1215,128,1280,209,2495
10857,2012-04-02,2,1,4,12,0,1,1,1,0.44,0.4394,0.44,0.4478,100,1500,181,1810,281,3310
10858,2012-04-02,2,1,4,13,0,1,1,1,0.46,0.4545,0.36,0.2985,97,1455,184,1840,281,3295
10859,2012-04-02,2,1,4,14,0,1,1,1,0.46,0.4545,0.31,0.4179,127,1905,141,1410,268,3315
10860,2012-04-02,2,1,4,15,0,1,1,1,0.48,0.4697,0.33,0.4179,132,1980,192,1920,324,3900
10861,2012-04-02,2,1,4,16,0,1,1,1,0.5,0.4848,0.34,0.3284,104,1560,291,2910,395,4470
10862,2012-04-02,2,1,4,17,0,1,1,1,0.5,0.4848,0.29,0.2836,128,1920,601,6010,729,7930
10863,2012-04-02,2,1,4,18,0,1,1,1,0.5,0.4848,0.27,0.2537,75,1125,543,5430,618,6555
10864,2012-04-02,2,1,4,19,0,1,1,1,0.5,0.4848,0.27,0.2537,66,990,428,4280,494,5270
10865,2012-04-02,2,1,4,20,0,1,1,1,0.46,0.4545,0.31,0.1642,48,720,281,2810,329,3530
10866,2012-04-02,2,1,4,21,0,1,1,1,0.46,0.4545,0.28,0.1343,24,360,214,2140,238,2500
10867,2012-04-02,2,1,4,22,0,1,1,1,0.42,0.4242,0.44,0.194,17,255,106,1060,123,1315
10868,2012-04-02,2,1,4,23,0,1,1,1,0.44,0.4394,0.35,0.1642,6,90,60,600,66,690
10869,2012-04-03,2,1,4,0,0,2,1,1,0.4,0.4091,0.43,0.1343,1,15,32,320,33,335
10870,2012-04-03,2,1,4,1,0,2,1,1,0.38,0.3939,0.46,0.2239,0,0,11,110,11,110
10871,2012-04-03,2,1,4,2,0,2,1,1,0.36,0.3485,0.53,0.1642,0,0,5,50,5,50
10872,2012-04-03,2,1,4,3,0,2,1,1,0.38,0.3939,0.46,0.0,0,0,3,30,3,30
10873,2012-04-03,2,1,4,4,0,2,1,1,0.32,0.3333,0.66,0.0896,0,0,1,10,1,10
10874,2012-04-03,2,1,4,5,0,2,1,1,0.32,0.3333,0.66,0.0896,2,30,25,250,27,280
10875,2012-04-03,2,1,4,6,0,2,1,1,0.3,0.3182,0.61,0.0896,2,30,98,980,100,1010
10876,2012-04-03,2,1,4,7,0,2,1,1,0.32,0.3333,0.66,0.0896,14,210,327,3270,341,3480
10877,2012-04-03,2,1,4,8,0,2,1,1,0.34,0.3636,0.57,0.0,27,405,577,5770,604,6175
10878,2012-04-03,2,1,4,9,0,2,1,1,0.42,0.4242,0.38,0.0896,54,810,354,3540,408,4350
10879,2012-04-03,2,1,4,10,0,2,1,1,0.44,0.4394,0.33,0.0,77,1155,142,1420,219,2575
10880,2012-04-03,2,1,4,11,0,2,1,1,0.48,0.4697,0.23,0.0,91,1365,167,1670,258,3035
10881,2012-04-03,2,1,4,12,0,2,1,1,0.52,0.5,0.25,0.0,101,1515,230,2300,331,3815
10882,2012-04-03,2,1,4,13,0,2,1,1,0.56,0.5303,0.19,0.2537,120,1800,225,2250,345,4050
10883,2012-04-03,2,1,4,14,0,2,1,1,0.56,0.5303,0.21,0.2239,120,1800,191,1910,311,3710
10884,2012-04-03,2,1,4,15,0,2,1,1,0.6,0.5909,0.2,0.194,109,1635,207,2070,316,3705
10885,2012-04-03,2,1,4,16,0,2,1,1,0.62,0.6061,0.21,0.1642,145,2175,340,3400,485,5575
10886,2012-04-03,2,1,4,17,0,2,1,1,0.62,0.6061,0.17,0.194,123,1845,634,6340,757,8185
10887,2012-04-03,2,1,4,18,0,2,1,1,0.6,0.6061,0.26,0.1642,139,2085,661,6610,800,8695
10888,2012-04-03,2,1,4,19,0,2,1,1,0.56,0.5303,0.26,0.1045,98,1470,460,4600,558,6070
10889,2012-04-03,2,1,4,20,0,2,1,1,0.56,0.5303,0.24,0.1343,54,810,325,3250,379,4060
10890,2012-04-03,2,1,4,21,0,2,1,1,0.54,0.5152,0.45,0.0,33,495,210,2100,243,2595
10891,2012-04-03,2,1,4,22,0,2,1,1,0.5,0.4848,0.51,0.0,25,375,133,1330,158,1705
10892,2012-04-03,2,1,4,23,0,2,1,1,0.5,0.4848,0.59,0.0,13,195,66,660,79,855
10893,2012-04-04,2,1,4,0,0,3,1,1,0.48,0.4697,0.48,0.0,18,270,23,230,41,500
10894,2012-04-04,2,1,4,1,0,3,1,1,0.46,0.4545,0.59,0.0,0,0,11,110,11,110
10895,2012-04-04,2,1,4,2,0,3,1,1,0.46,0.4545,0.51,0.0,0,0,5,50,5,50
10896,2012-04-04,2,1,4,3,0,3,1,1,0.44,0.4394,0.58,0.0896,0,0,3,30,3,30
10897,2012-04-04,2,1,4,4,0,3,1,1,0.42,0.4242,0.67,0.0896,0,0,1,10,1,10
10898,2012-04-04,2,1,4,5,0,3,1,1,0.42,0.4242,0.67,0.0896,0,0,27,270,27,270
10899,2012-04-04,2,1,4,6,0,3,1,2,0.42,0.4242,0.58,0.0,6,90,120,1200,126,1290
10900,2012-04-04,2,1,4,7,0,3,1,2,0.44,0.4394,0.62,0.0,12,180,354,3540,366,3720
10901,2012-04-04,2,1,4,8,0,3,1,2,0.44,0.4394,0.72,0.1045,31,465,653,6530,684,6995
10902,2012-04-04,2,1,4,9,0,3,1,2,0.48,0.4697,0.55,0.1343,47,705,316,3160,363,3865
10903,2012-04-04,2,1,4,10,0,3,1,2,0.54,0.5152,0.45,0.1343,68,1020,99,990,167,2010
10904,2012-04-04,2,1,4,11,0,3,1,2,0.6,0.6212,0.43,0.3582,61,915,152,1520,213,2435
10905,2012-04-04,2,1,4,12,0,3,1,2,0.6,0.6212,0.46,0.4179,73,1095,210,2100,283,3195
10906,2012-04-04,2,1,4,13,0,3,1,2,0.6,0.6212,0.46,0.2537,70,1050,181,1810,251,2860
10907,2012-04-04,2,1,4,14,0,3,1,2,0.62,0.6212,0.46,0.194,82,1230,176,1760,258,2990
10908,2012-04-04,2,1,4,15,0,3,1,2,0.64,0.6212,0.44,0.2836,86,1290,182,1820,268,3110
10909,2012-04-04,2,1,4,16,0,3,1,2,0.64,0.6212,0.44,0.2836,86,1290,304,3040,390,4330
10910,2012-04-04,2,1,4,17,0,3,1,1,0.66,0.6212,0.41,0.2985,99,1485,645,6450,744,7935
10911,2012-04-04,2,1,4,18,0,3,1,1,0.66,0.6212,0.41,0.2537,113,1695,646,6460,759,8155
10912,2012-04-04,2,1,4,19,0,3,1,1,0.66,0.6212,0.39,0.2239,75,1125,419,4190,494,5315
10913,2012-04-04,2,1,4,20,0,3,1,1,0.64,0.6212,0.27,0.2239,39,585,333,3330,372,3915
10914,2012-04-04,2,1,4,21,0,3,1,1,0.6,0.6061,0.23,0.3284,43,645,255,2550,298,3195
10915,2012-04-04,2,1,4,22,0,3,1,1,0.56,0.5303,0.22,0.1642,30,450,151,1510,181,1960
10916,2012-04-04,2,1,4,23,0,3,1,1,0.52,0.5,0.23,0.4179,19,285,112,1120,131,1405
10917,2012-04-05,2,1,4,0,0,4,1,1,0.52,0.5,0.23,0.4179,12,180,33,330,45,510
10918,2012-04-05,2,1,4,1,0,4,1,1,0.48,0.4697,0.27,0.3284,4,60,9,90,13,150
10919,2012-04-05,2,1,4,2,0,4,1,1,0.46,0.4545,0.33,0.4478,7,105,11,110,18,215
10920,2012-04-05,2,1,4,3,0,4,1,1,0.42,0.4242,0.41,0.2985,0,0,5,50,5,50
10921,2012-04-05,2,1,4,4,0,4,1,1,0.38,0.3939,0.43,0.2836,0,0,1,10,1,10
10922,2012-04-05,2,1,4,5,0,4,1,1,0.38,0.3939,0.43,0.2836,1,15,28,280,29,295
10923,2012-04-05,2,1,4,6,0,4,1,1,0.36,0.3333,0.46,0.3284,8,120,118,1180,126,1300
10924,2012-04-05,2,1,4,7,0,4,1,1,0.34,0.3333,0.49,0.194,15,225,339,3390,354,3615
10925,2012-04-05,2,1,4,8,0,4,1,1,0.36,0.3485,0.46,0.2239,28,420,610,6100,638,6520
10926,2012-04-05,2,1,4,9,0,4,1,1,0.4,0.4091,0.37,0.2537,61,915,290,2900,351,3815
10927,2012-04-05,2,1,4,10,0,4,1,1,0.42,0.4242,0.35,0.2836,88,1320,158,1580,246,2900
10928,2012-04-05,2,1,4,11,0,4,1,2,0.42,0.4242,0.38,0.2239,109,1635,159,1590,268,3225
10929,2012-04-05,2,1,4,12,0,4,1,1,0.44,0.4394,0.33,0.0,66,990,210,2100,276,3090
10930,2012-04-05,2,1,4,13,0,4,1,1,0.46,0.4545,0.31,0.0,89,1335,202,2020,291,3355
10931,2012-04-05,2,1,4,14,0,4,1,1,0.46,0.4545,0.33,0.1642,143,2145,144,1440,287,3585
10932,2012-04-05,2,1,4,15,0,4,1,1,0.5,0.4848,0.31,0.1045,98,1470,171,1710,269,3180
10933,2012-04-05,2,1,4,16,0,4,1,1,0.5,0.4848,0.31,0.194,84,1260,318,3180,402,4440
10934,2012-04-05,2,1,4,17,0,4,1,1,0.5,0.4848,0.31,0.1642,145,2175,677,6770,822,8945
10935,2012-04-05,2,1,4,18,0,4,1,1,0.5,0.4848,0.31,0.1045,80,1200,618,6180,698,7380
10936,2012-04-05,2,1,4,19,0,4,1,1,0.48,0.4697,0.31,0.2537,64,960,423,4230,487,5190
10937,2012-04-05,2,1,4,20,0,4,1,1,0.44,0.4394,0.41,0.194,33,495,279,2790,312,3285
10938,2012-04-05,2,1,4,21,0,4,1,1,0.42,0.4242,0.47,0.194,25,375,209,2090,234,2465
10939,2012-04-05,2,1,4,22,0,4,1,1,0.4,0.4091,0.47,0.194,20,300,129,1290,149,1590
10940,2012-04-05,2,1,4,23,0,4,1,1,0.4,0.4091,0.5,0.1343,12,180,124,1240,136,1420
10941,2012-04-06,2,1,4,0,0,5,1,1,0.4,0.4091,0.43,0.0,12,180,49,490,61,670
10942,2012-04-06,2,1,4,1,0,5,1,1,0.36,0.3485,0.62,0.1343,10,150,28,280,38,430
10943,2012-04-06,2,1,4,2,0,5,1,1,0.36,0.3333,0.5,0.3881,6,90,5,50,11,140
10944,2012-04-06,2,1,4,3,0,5,1,1,0.34,0.303,0.53,0.3284,3,45,5,50,8,95
10945,2012-04-06,2,1,4,4,0,5,1,1,0.34,0.3182,0.49,0.2537,2,30,3,30,5,60
10946,2012-04-06,2,1,4,5,0,5,1,1,0.32,0.303,0.53,0.3284,0,0,23,230,23,230
10947,2012-04-06,2,1,4,6,0,5,1,1,0.3,0.2727,0.49,0.3881,0,0,80,800,80,800
10948,2012-04-06,2,1,4,7,0,5,1,1,0.3,0.2879,0.49,0.2836,15,225,231,2310,246,2535
10949,2012-04-06,2,1,4,8,0,5,1,1,0.3,0.2727,0.49,0.3284,19,285,489,4890,508,5175
10950,2012-04-06,2,1,4,9,0,5,1,1,0.34,0.303,0.42,0.3284,58,870,318,3180,376,4050
10951,2012-04-06,2,1,4,10,0,5,1,1,0.36,0.3333,0.4,0.3284,81,1215,157,1570,238,2785
10952,2012-04-06,2,1,4,11,0,5,1,1,0.4,0.4091,0.37,0.2985,112,1680,179,1790,291,3470
10953,2012-04-06,2,1,4,12,0,5,1,1,0.42,0.4242,0.35,0.2985,113,1695,224,2240,337,3935
10954,2012-04-06,2,1,4,13,0,5,1,1,0.44,0.4394,0.33,0.3284,173,2595,238,2380,411,4975
10955,2012-04-06,2,1,4,14,0,5,1,1,0.48,0.4697,0.29,0.3881,240,3600,250,2500,490,6100
10956,2012-04-06,2,1,4,15,0,5,1,1,0.5,0.4848,0.27,0.2836,218,3270,319,3190,537,6460
10957,2012-04-06,2,1,4,16,0,5,1,1,0.5,0.4848,0.22,0.4179,184,2760,352,3520,536,6280
10958,2012-04-06,2,1,4,17,0,5,1,1,0.52,0.5,0.23,0.4179,172,2580,483,4830,655,7410
10959,2012-04-06,2,1,4,18,0,5,1,1,0.5,0.4848,0.22,0.4627,104,1560,380,3800,484,5360
10960,2012-04-06,2,1,4,19,0,5,1,1,0.48,0.4697,0.23,0.2985,115,1725,297,2970,412,4695
10961,2012-04-06,2,1,4,20,0,5,1,1,0.46,0.4545,0.24,0.2836,61,915,191,1910,252,2825
10962,2012-04-06,2,1,4,21,0,5,1,1,0.44,0.4394,0.26,0.1343,54,810,136,1360,190,2170
10963,2012-04-06,2,1,4,22,0,5,1,1,0.4,0.4091,0.35,0.2239,34,510,124,1240,158,1750
10964,2012-04-06,2,1,4,23,0,5,1,1,0.42,0.4242,0.3,0.2836,21,315,92,920,113,1235
10965,2012-04-07,2,1,4,0,0,6,0,1,0.42,0.4242,0.26,0.2985,9,135,85,850,94,985
10966,2012-04-07,2,1,4,1,0,6,0,1,0.4,0.4091,0.28,0.2537,9,135,60,600,69,735
10967,2012-04-07,2,1,4,2,0,6,0,1,0.36,0.3333,0.29,0.3582,11,165,25,250,36,415
10968,2012-04-07,2,1,4,3,0,6,0,1,0.36,0.3333,0.32,0.2537,7,105,21,210,28,315
10969,2012-04-07,2,1,4,4,0,6,0,1,0.32,0.3182,0.36,0.1642,3,45,4,40,7,85
10970,2012-04-07,2,1,4,5,0,6,0,1,0.32,0.3182,0.33,0.1642,0,0,2,20,2,20
10971,2012-04-07,2,1,4,6,0,6,0,1,0.32,0.3182,0.36,0.194,1,15,18,180,19,195
10972,2012-04-07,2,1,4,7,0,6,0,1,0.32,0.303,0.33,0.2836,14,210,40,400,54,610
10973,2012-04-07,2,1,4,8,0,6,0,1,0.34,0.3182,0.34,0.2537,29,435,94,940,123,1375
10974,2012-04-07,2,1,4,9,0,6,0,1,0.4,0.4091,0.3,0.2537,103,1545,173,1730,276,3275
10975,2012-04-07,2,1,4,10,0,6,0,1,0.42,0.4242,0.28,0.2537,187,2805,176,1760,363,4565
10976,2012-04-07,2,1,4,11,0,6,0,1,0.44,0.4394,0.24,0.2985,251,3765,244,2440,495,6205
10977,2012-04-07,2,1,4,12,0,6,0,1,0.46,0.4545,0.23,0.3881,320,4800,270,2700,590,7500
10978,2012-04-07,2,1,4,13,0,6,0,1,0.5,0.4848,0.22,0.194,355,5325,288,2880,643,8205
10979,2012-04-07,2,1,4,14,0,6,0,1,0.5,0.4848,0.22,0.2985,326,4890,252,2520,578,7410
10980,2012-04-07,2,1,4,15,0,6,0,1,0.52,0.5,0.19,0.4179,321,4815,305,3050,626,7865
10981,2012-04-07,2,1,4,16,0,6,0,1,0.54,0.5152,0.19,0.3881,354,5310,261,2610,615,7920
10982,2012-04-07,2,1,4,17,0,6,0,1,0.54,0.5152,0.19,0.4179,299,4485,268,2680,567,7165
10983,2012-04-07,2,1,4,18,0,6,0,1,0.54,0.5152,0.18,0.2985,227,3405,290,2900,517,6305
10984,2012-04-07,2,1,4,19,0,6,0,1,0.54,0.5152,0.16,0.3284,170,2550,243,2430,413,4980
10985,2012-04-07,2,1,4,20,0,6,0,1,0.5,0.4848,0.2,0.2239,73,1095,135,1350,208,2445
10986,2012-04-07,2,1,4,21,0,6,0,1,0.5,0.4848,0.2,0.194,75,1125,159,1590,234,2715
10987,2012-04-07,2,1,4,22,0,6,0,1,0.48,0.4697,0.2,0.194,76,1140,106,1060,182,2200
10988,2012-04-07,2,1,4,23,0,6,0,1,0.46,0.4545,0.23,0.2239,32,480,86,860,118,1340
10989,2012-04-08,2,1,4,0,0,0,0,1,0.44,0.4394,0.24,0.2239,21,315,64,640,85,955
10990,2012-04-08,2,1,4,1,0,0,0,1,0.44,0.4394,0.24,0.2239,14,210,50,500,64,710
10991,2012-04-08,2,1,4,2,0,0,0,1,0.44,0.4394,0.24,0.2239,7,105,25,250,32,355
10992,2012-04-08,2,1,4,3,0,0,0,1,0.42,0.4242,0.26,0.1343,8,120,18,180,26,300
10993,2012-04-08,2,1,4,4,0,0,0,1,0.4,0.4091,0.4,0.0,0,0,7,70,7,70
10994,2012-04-08,2,1,4,5,0,0,0,1,0.38,0.3939,0.46,0.0,4,60,8,80,12,140
10995,2012-04-08,2,1,4,6,0,0,0,1,0.36,0.3788,0.37,0.0,7,105,21,210,28,315
10996,2012-04-08,2,1,4,7,0,0,0,1,0.38,0.3939,0.27,0.1642,12,180,25,250,37,430
10997,2012-04-08,2,1,4,8,0,0,0,1,0.4,0.4091,0.3,0.194,19,285,65,650,84,935
10998,2012-04-08,2,1,4,9,0,0,0,1,0.44,0.4394,0.26,0.2239,71,1065,108,1080,179,2145
10999,2012-04-08,2,1,4,10,0,0,0,1,0.5,0.4848,0.25,0.2239,113,1695,186,1860,299,3555
11000,2012-04-08,2,1,4,11,0,0,0,1,0.5,0.4848,0.25,0.2836,195,2925,209,2090,404,5015
11001,2012-04-08,2,1,4,12,0,0,0,1,0.54,0.5152,0.24,0.2537,198,2970,259,2590,457,5560
11002,2012-04-08,2,1,4,13,0,0,0,1,0.58,0.5455,0.23,0.1642,229,3435,254,2540,483,5975
11003,2012-04-08,2,1,4,14,0,0,0,1,0.6,0.5909,0.18,0.4478,254,3810,249,2490,503,6300
11004,2012-04-08,2,1,4,15,0,0,0,1,0.62,0.6061,0.17,0.3582,260,3900,226,2260,486,6160
11005,2012-04-08,2,1,4,16,0,0,0,1,0.64,0.6061,0.19,0.3284,232,3480,244,2440,476,5920
11006,2012-04-08,2,1,4,17,0,0,0,1,0.62,0.6061,0.22,0.2985,185,2775,226,2260,411,5035
11007,2012-04-08,2,1,4,18,0,0,0,1,0.62,0.6061,0.25,0.3284,151,2265,159,1590,310,3855
11008,2012-04-08,2,1,4,19,0,0,0,1,0.6,0.6061,0.23,0.3881,89,1335,187,1870,276,3205
11009,2012-04-08,2,1,4,20,0,0,0,1,0.56,0.5303,0.28,0.4179,65,975,146,1460,211,2435
11010,2012-04-08,2,1,4,21,0,0,0,1,0.52,0.5,0.34,0.2239,53,795,77,770,130,1565
11011,2012-04-08,2,1,4,22,0,0,0,1,0.5,0.4848,0.36,0.2239,33,495,85,850,118,1345
11012,2012-04-08,2,1,4,23,0,0,0,1,0.5,0.4848,0.39,0.2537,10,150,41,410,51,560
11013,2012-04-09,2,1,4,0,0,1,1,1,0.48,0.4697,0.39,0.2836,8,120,29,290,37,410
11014,2012-04-09,2,1,4,1,0,1,1,1,0.46,0.4545,0.41,0.1343,4,60,12,120,16,180
11015,2012-04-09,2,1,4,2,0,1,1,1,0.46,0.4545,0.31,0.194,2,30,4,40,6,70
11016,2012-04-09,2,1,4,3,0,1,1,1,0.44,0.4394,0.3,0.1642,0,0,3,30,3,30
11017,2012-04-09,2,1,4,4,0,1,1,1,0.44,0.4394,0.24,0.194,2,30,3,30,5,60
11018,2012-04-09,2,1,4,5,0,1,1,1,0.44,0.4394,0.24,0.194,2,30,30,300,32,330
11019,2012-04-09,2,1,4,6,0,1,1,1,0.42,0.4242,0.26,0.2239,3,45,108,1080,111,1125
11020,2012-04-09,2,1,4,7,0,1,1,1,0.42,0.4242,0.28,0.194,11,165,320,3200,331,3365
11021,2012-04-09,2,1,4,8,0,1,1,1,0.44,0.4394,0.3,0.194,22,330,595,5950,617,6280
11022,2012-04-09,2,1,4,9,0,1,1,1,0.46,0.4545,0.31,0.3582,50,750,236,2360,286,3110
11023,2012-04-09,2,1,4,10,0,1,1,1,0.5,0.4848,0.27,0.4925,65,975,113,1130,178,2105
11024,2012-04-09,2,1,4,11,0,1,1,1,0.52,0.5,0.27,0.4179,96,1440,127,1270,223,2710
11025,2012-04-09,2,1,4,12,0,1,1,1,0.54,0.5152,0.28,0.7164,94,1410,186,1860,280,3270
11026,2012-04-09,2,1,4,13,0,1,1,1,0.54,0.5152,0.28,0.5821,108,1620,173,1730,281,3350
11027,2012-04-09,2,1,4,14,0,1,1,1,0.56,0.5303,0.28,0.5522,66,990,152,1520,218,2510
11028,2012-04-09,2,1,4,15,0,1,1,1,0.58,0.5455,0.28,0.5522,82,1230,173,1730,255,2960
11029,2012-04-09,2,1,4,16,0,1,1,1,0.56,0.5303,0.3,0.4179,81,1215,310,3100,391,4315
11030,2012-04-09,2,1,4,17,0,1,1,1,0.54,0.5152,0.32,0.4179,67,1005,565,5650,632,6655
11031,2012-04-09,2,1,4,18,0,1,1,1,0.54,0.5152,0.34,0.2985,60,900,586,5860,646,6760
11032,2012-04-09,2,1,4,19,0,1,1,1,0.52,0.5,0.34,0.3582,35,525,386,3860,421,4385
11033,2012-04-09,2,1,4,20,0,1,1,1,0.5,0.4848,0.36,0.4478,21,315,255,2550,276,2865
11034,2012-04-09,2,1,4,21,0,1,1,3,0.48,0.4697,0.41,0.4179,14,210,151,1510,165,1720
11035,2012-04-09,2,1,4,22,0,1,1,2,0.46,0.4545,0.41,0.4925,6,90,102,1020,108,1110
11036,2012-04-09,2,1,4,23,0,1,1,1,0.44,0.4394,0.44,0.2985,6,90,61,610,67,700
11037,2012-04-10,2,1,4,0,0,2,1,2,0.44,0.4394,0.47,0.2836,3,45,23,230,26,275
11038,2012-04-10,2,1,4,1,0,2,1,1,0.42,0.4242,0.5,0.2239,0,0,9,90,9,90
11039,2012-04-10,2,1,4,2,0,2,1,1,0.36,0.3485,0.71,0.1343,0,0,2,20,2,20
11040,2012-04-10,2,1,4,3,0,2,1,1,0.36,0.3485,0.71,0.1343,0,0,2,20,2,20
11041,2012-04-10,2,1,4,4,0,2,1,1,0.34,0.3333,0.71,0.1343,0,0,2,20,2,20
11042,2012-04-10,2,1,4,5,0,2,1,1,0.34,0.3333,0.71,0.1343,0,0,24,240,24,240
11043,2012-04-10,2,1,4,6,0,2,1,1,0.34,0.3485,0.71,0.1045,3,45,100,1000,103,1045
11044,2012-04-10,2,1,4,7,0,2,1,1,0.34,0.3485,0.71,0.1045,16,240,368,3680,384,3920
11045,2012-04-10,2,1,4,8,0,2,1,1,0.38,0.3939,0.62,0.1343,22,330,670,6700,692,7030
11046,2012-04-10,2,1,4,9,0,2,1,1,0.42,0.4242,0.67,0.194,16,240,303,3030,319,3270
11047,2012-04-10,2,1,4,10,0,2,1,1,0.46,0.4545,0.47,0.1642,49,735,132,1320,181,2055
11048,2012-04-10,2,1,4,11,0,2,1,1,0.5,0.4848,0.36,0.0,78,1170,161,1610,239,2780
11049,2012-04-10,2,1,4,12,0,2,1,1,0.54,0.5152,0.22,0.2836,75,1125,184,1840,259,2965
11050,2012-04-10,2,1,4,13,0,2,1,1,0.52,0.5,0.23,0.1642,81,1215,202,2020,283,3235
11051,2012-04-10,2,1,4,14,0,2,1,1,0.54,0.5152,0.24,0.194,75,1125,149,1490,224,2615
11052,2012-04-10,2,1,4,15,0,2,1,1,0.56,0.5303,0.21,0.2985,46,690,157,1570,203,2260
11053,2012-04-10,2,1,4,16,0,2,1,1,0.58,0.5455,0.21,0.2537,66,990,296,2960,362,3950
11054,2012-04-10,2,1,4,17,0,2,1,1,0.56,0.5303,0.21,0.5224,88,1320,656,6560,744,7880
11055,2012-04-10,2,1,4,18,0,2,1,1,0.54,0.5152,0.22,0.4179,78,1170,626,6260,704,7430
11056,2012-04-10,2,1,4,19,0,2,1,1,0.52,0.5,0.2,0.3582,51,765,428,4280,479,5045
11057,2012-04-10,2,1,4,20,0,2,1,1,0.46,0.4545,0.28,0.3881,34,510,248,2480,282,2990
11058,2012-04-10,2,1,4,21,0,2,1,1,0.44,0.4394,0.3,0.4478,15,225,191,1910,206,2135
11059,2012-04-10,2,1,4,22,0,2,1,1,0.4,0.4091,0.37,0.4925,9,135,118,1180,127,1315
11060,2012-04-10,2,1,4,23,0,2,1,1,0.36,0.3333,0.4,0.4179,14,210,48,480,62,690
11061,2012-04-11,2,1,4,0,0,3,1,1,0.34,0.303,0.36,0.4179,8,120,22,220,30,340
11062,2012-04-11,2,1,4,1,0,3,1,1,0.34,0.3182,0.39,0.2836,3,45,9,90,12,135
11063,2012-04-11,2,1,4,2,0,3,1,1,0.32,0.303,0.45,0.2836,0,0,2,20,2,20
11064,2012-04-11,2,1,4,3,0,3,1,1,0.3,0.2879,0.49,0.2239,0,0,2,20,2,20
11065,2012-04-11,2,1,4,5,0,3,1,1,0.28,0.2727,0.56,0.194,1,15,26,260,27,275
11066,2012-04-11,2,1,4,6,0,3,1,1,0.28,0.2879,0.56,0.1045,3,45,103,1030,106,1075
11067,2012-04-11,2,1,4,7,0,3,1,1,0.28,0.2879,0.52,0.1343,18,270,303,3030,321,3300
11068,2012-04-11,2,1,4,8,0,3,1,1,0.3,0.2879,0.49,0.2239,14,210,581,5810,595,6020
11069,2012-04-11,2,1,4,9,0,3,1,2,0.32,0.303,0.49,0.2985,20,300,282,2820,302,3120
11070,2012-04-11,2,1,4,10,0,3,1,2,0.34,0.303,0.49,0.3284,26,390,127,1270,153,1660
11071,2012-04-11,2,1,4,11,0,3,1,2,0.38,0.3939,0.43,0.3284,38,570,142,1420,180,1990
11072,2012-04-11,2,1,4,12,0,3,1,2,0.36,0.3333,0.46,0.3881,35,525,147,1470,182,1995
11073,2012-04-11,2,1,4,13,0,3,1,2,0.4,0.4091,0.4,0.3582,16,240,147,1470,163,1710
11074,2012-04-11,2,1,4,14,0,3,1,1,0.36,0.3485,0.57,0.194,34,510,101,1010,135,1520
11075,2012-04-11,2,1,4,15,0,3,1,3,0.38,0.3939,0.46,0.2239,50,750,152,1520,202,2270
11076,2012-04-11,2,1,4,16,0,3,1,1,0.44,0.4394,0.33,0.2985,51,765,256,2560,307,3325
11077,2012-04-11,2,1,4,17,0,3,1,1,0.42,0.4242,0.35,0.3881,52,780,527,5270,579,6050
11078,2012-04-11,2,1,4,18,0,3,1,3,0.4,0.4091,0.43,0.4179,39,585,546,5460,585,6045
11079,2012-04-11,2,1,4,19,0,3,1,1,0.4,0.4091,0.4,0.3582,28,420,356,3560,384,3980
11080,2012-04-11,2,1,4,20,0,3,1,1,0.36,0.3333,0.46,0.3284,22,330,213,2130,235,2460
11081,2012-04-11,2,1,4,21,0,3,1,1,0.34,0.303,0.57,0.3881,11,165,154,1540,165,1705
11082,2012-04-11,2,1,4,22,0,3,1,1,0.34,0.303,0.57,0.3284,4,60,130,1300,134,1360
11083,2012-04-11,2,1,4,23,0,3,1,1,0.34,0.303,0.57,0.2985,9,135,52,520,61,655
11084,2012-04-12,2,1,4,0,0,4,1,1,0.32,0.303,0.66,0.2836,1,15,22,220,23,235
11085,2012-04-12,2,1,4,1,0,4,1,1,0.32,0.303,0.66,0.2239,2,30,7,70,9,100
11086,2012-04-12,2,1,4,2,0,4,1,1,0.32,0.303,0.61,0.2836,0,0,4,40,4,40
11087,2012-04-12,2,1,4,3,0,4,1,1,0.32,0.303,0.61,0.2537,2,30,3,30,5,60
11088,2012-04-12,2,1,4,4,0,4,1,1,0.3,0.2879,0.61,0.2239,0,0,1,10,1,10
11089,2012-04-12,2,1,4,5,0,4,1,1,0.3,0.2879,0.61,0.2239,0,0,21,210,21,210
11090,2012-04-12,2,1,4,6,0,4,1,1,0.3,0.2879,0.65,0.2537,2,30,94,940,96,970
11091,2012-04-12,2,1,4,7,0,4,1,1,0.3,0.2727,0.65,0.3284,12,180,294,2940,306,3120
11092,2012-04-12,2,1,4,8,0,4,1,1,0.32,0.303,0.66,0.3284,20,300,604,6040,624,6340
11093,2012-04-12,2,1,4,9,0,4,1,1,0.36,0.3333,0.57,0.3582,16,240,271,2710,287,2950
11094,2012-04-12,2,1,4,10,0,4,1,1,0.4,0.4091,0.5,0.2985,38,570,103,1030,141,1600
11095,2012-04-12,2,1,4,11,0,4,1,1,0.42,0.4242,0.47,0.2985,50,750,174,1740,224,2490
11096,2012-04-12,2,1,4,12,0,4,1,1,0.46,0.4545,0.41,0.4478,60,900,199,1990,259,2890
11097,2012-04-12,2,1,4,13,0,4,1,1,0.48,0.4697,0.36,0.4478,55,825,148,1480,203,2305
11098,2012-04-12,2,1,4,14,0,4,1,1,0.5,0.4848,0.31,0.3284,74,1110,150,1500,224,2610
11099,2012-04-12,2,1,4,15,0,4,1,1,0.48,0.4697,0.31,0.2537,42,630,169,1690,211,2320
11100,2012-04-12,2,1,4,16,0,4,1,1,0.48,0.4697,0.31,0.2836,54,810,299,2990,353,3800
11101,2012-04-12,2,1,4,17,0,4,1,1,0.5,0.4848,0.27,0.3881,60,900,596,5960,656,6860
11102,2012-04-12,2,1,4,18,0,4,1,1,0.5,0.4848,0.27,0.3881,63,945,547,5470,610,6415
11103,2012-04-12,2,1,4,19,0,4,1,1,0.46,0.4545,0.31,0.2985,50,750,383,3830,433,4580
11104,2012-04-12,2,1,4,20,0,4,1,1,0.44,0.4394,0.33,0.2537,26,390,254,2540,280,2930
11105,2012-04-12,2,1,4,21,0,4,1,1,0.42,0.4242,0.35,0.1343,13,195,174,1740,187,1935
11106,2012-04-12,2,1,4,22,0,4,1,1,0.42,0.4242,0.35,0.194,15,225,143,1430,158,1655
11107,2012-04-12,2,1,4,23,0,4,1,1,0.42,0.4242,0.35,0.194,8,120,86,860,94,980
11108,2012-04-13,2,1,4,0,0,5,1,1,0.4,0.4091,0.37,0.2537,14,210,41,410,55,620
11109,2012-04-13,2,1,4,1,0,5,1,1,0.36,0.3485,0.46,0.194,2,30,28,280,30,310
11110,2012-04-13,2,1,4,2,0,5,1,1,0.34,0.3333,0.49,0.194,6,90,5,50,11,140
11111,2012-04-13,2,1,4,3,0,5,1,1,0.34,0.3333,0.61,0.1642,3,45,8,80,11,125
11112,2012-04-13,2,1,4,4,0,5,1,2,0.34,0.3333,0.53,0.1343,1,15,4,40,5,55
11113,2012-04-13,2,1,4,5,0,5,1,2,0.34,0.3333,0.53,0.1642,2,30,19,190,21,220
11114,2012-04-13,2,1,4,6,0,5,1,1,0.32,0.3182,0.57,0.1642,0,0,84,840,84,840
11115,2012-04-13,2,1,4,7,0,5,1,1,0.34,0.3182,0.61,0.2239,13,195,283,2830,296,3025
11116,2012-04-13,2,1,4,8,0,5,1,1,0.38,0.3939,0.46,0.1642,24,360,539,5390,563,5750
11117,2012-04-13,2,1,4,9,0,5,1,1,0.42,0.4242,0.41,0.1642,36,540,294,2940,330,3480
11118,2012-04-13,2,1,4,10,0,5,1,1,0.44,0.4394,0.38,0.194,59,885,133,1330,192,2215
11119,2012-04-13,2,1,4,11,0,5,1,1,0.46,0.4545,0.36,0.1343,75,1125,158,1580,233,2705
11120,2012-04-13,2,1,4,12,0,5,1,1,0.5,0.4848,0.31,0.0,104,1560,218,2180,322,3740
11121,2012-04-13,2,1,4,13,0,5,1,1,0.52,0.5,0.27,0.2836,112,1680,246,2460,358,4140
11122,2012-04-13,2,1,4,14,0,5,1,1,0.52,0.5,0.27,0.0,125,1875,223,2230,348,4105
11123,2012-04-13,2,1,4,15,0,5,1,1,0.54,0.5152,0.28,0.2537,115,1725,237,2370,352,4095
11124,2012-04-13,2,1,4,16,0,5,1,1,0.56,0.5303,0.26,0.2537,113,1695,350,3500,463,5195
11125,2012-04-13,2,1,4,17,0,5,1,1,0.56,0.5303,0.24,0.1642,117,1755,621,6210,738,7965
11126,2012-04-13,2,1,4,18,0,5,1,1,0.54,0.5152,0.26,0.1343,107,1605,564,5640,671,7245
11127,2012-04-13,2,1,4,19,0,5,1,1,0.54,0.5152,0.24,0.1642,75,1125,352,3520,427,4645
11128,2012-04-13,2,1,4,20,0,5,1,1,0.5,0.4848,0.29,0.1343,44,660,242,2420,286,3080
11129,2012-04-13,2,1,4,21,0,5,1,1,0.5,0.4848,0.36,0.0,36,540,153,1530,189,2070
11130,2012-04-13,2,1,4,22,0,5,1,1,0.44,0.4394,0.62,0.1045,34,510,181,1810,215,2320
11131,2012-04-13,2,1,4,23,0,5,1,1,0.42,0.4242,0.62,0.0896,35,525,163,1630,198,2155
11132,2012-04-14,2,1,4,0,0,6,0,1,0.4,0.4091,0.58,0.1343,11,165,85,850,96,1015
11133,2012-04-14,2,1,4,1,0,6,0,1,0.4,0.4091,0.58,0.1343,10,150,60,600,70,750
11134,2012-04-14,2,1,4,2,0,6,0,1,0.38,0.3939,0.66,0.1343,3,45,53,530,56,575
11135,2012-04-14,2,1,4,3,0,6,0,1,0.36,0.3636,0.66,0.0896,6,90,26,260,32,350
11136,2012-04-14,2,1,4,4,0,6,0,1,0.36,0.3636,0.71,0.1045,5,75,9,90,14,165
11137,2012-04-14,2,1,4,5,0,6,0,1,0.36,0.3636,0.66,0.1045,2,30,5,50,7,80
11138,2012-04-14,2,1,4,6,0,6,0,1,0.34,0.3333,0.76,0.1642,2,30,19,190,21,220
11139,2012-04-14,2,1,4,7,0,6,0,1,0.36,0.3636,0.71,0.1045,8,120,56,560,64,680
11140,2012-04-14,2,1,4,8,0,6,0,1,0.36,0.3485,0.71,0.1343,24,360,136,1360,160,1720
11141,2012-04-14,2,1,4,9,0,6,0,1,0.42,0.4242,0.54,0.1343,59,885,206,2060,265,2945
11142,2012-04-14,2,1,4,10,0,6,0,1,0.46,0.4545,0.51,0.1642,139,2085,267,2670,406,4755
11143,2012-04-14,2,1,4,11,0,6,0,1,0.52,0.5,0.45,0.194,207,3105,357,3570,564,6675
11144,2012-04-14,2,1,4,12,0,6,0,1,0.58,0.5455,0.35,0.2537,274,4110,404,4040,678,8150
11145,2012-04-14,2,1,4,13,0,6,0,1,0.62,0.6212,0.33,0.2985,308,4620,370,3700,678,8320
11146,2012-04-14,2,1,4,14,0,6,0,2,0.64,0.6212,0.27,0.4478,288,4320,372,3720,660,8040
11147,2012-04-14,2,1,4,15,0,6,0,2,0.64,0.6212,0.27,0.3582,311,4665,347,3470,658,8135
11148,2012-04-14,2,1,4,16,0,6,0,2,0.64,0.6212,0.27,0.3582,253,3795,329,3290,582,7085
11149,2012-04-14,2,1,4,17,0,6,0,2,0.62,0.6212,0.33,0.2537,251,3765,309,3090,560,6855
11150,2012-04-14,2,1,4,18,0,6,0,2,0.62,0.6212,0.35,0.2239,197,2955,284,2840,481,5795
11151,2012-04-14,2,1,4,19,0,6,0,2,0.6,0.6212,0.4,0.1642,163,2445,296,2960,459,5405
11152,2012-04-14,2,1,4,20,0,6,0,2,0.56,0.5303,0.46,0.1343,112,1680,209,2090,321,3770
11153,2012-04-14,2,1,4,21,0,6,0,2,0.56,0.5303,0.43,0.1343,53,795,167,1670,220,2465
11154,2012-04-14,2,1,4,22,0,6,0,2,0.54,0.5152,0.52,0.1642,64,960,148,1480,212,2440
11155,2012-04-14,2,1,4,23,0,6,0,2,0.54,0.5152,0.56,0.194,45,675,151,1510,196,2185
11156,2012-04-15,2,1,4,0,0,0,0,2,0.54,0.5152,0.56,0.194,30,450,94,940,124,1390
11157,2012-04-15,2,1,4,1,0,0,0,2,0.54,0.5152,0.56,0.1642,17,255,89,890,106,1145
11158,2012-04-15,2,1,4,2,0,0,0,2,0.54,0.5152,0.56,0.1045,20,300,54,540,74,840
11159,2012-04-15,2,1,4,3,0,0,0,2,0.52,0.5,0.59,0.1343,18,270,27,270,45,540
11160,2012-04-15,2,1,4,4,0,0,0,2,0.54,0.5152,0.52,0.0,2,30,10,100,12,130
11161,2012-04-15,2,1,4,5,0,0,0,1,0.5,0.4848,0.68,0.1642,4,60,6,60,10,120
11162,2012-04-15,2,1,4,6,0,0,0,1,0.5,0.4848,0.63,0.1343,5,75,11,110,16,185
11163,2012-04-15,2,1,4,7,0,0,0,1,0.5,0.4848,0.63,0.1045,16,240,30,300,46,540
11164,2012-04-15,2,1,4,8,0,0,0,1,0.52,0.5,0.59,0.0,33,495,64,640,97,1135
11165,2012-04-15,2,1,4,9,0,0,0,1,0.54,0.5152,0.56,0.2239,97,1455,154,1540,251,2995
11166,2012-04-15,2,1,4,10,0,0,0,1,0.58,0.5455,0.53,0.2239,186,2790,235,2350,421,5140
11167,2012-04-15,2,1,4,11,0,0,0,1,0.62,0.6212,0.46,0.2985,227,3405,301,3010,528,6415
11168,2012-04-15,2,1,4,12,0,0,0,1,0.64,0.6212,0.44,0.2836,275,4125,360,3600,635,7725
11169,2012-04-15,2,1,4,13,0,0,0,1,0.66,0.6212,0.44,0.2836,298,4470,383,3830,681,8300
11170,2012-04-15,2,1,4,14,0,0,0,1,0.7,0.6364,0.39,0.2836,282,4230,346,3460,628,7690
11171,2012-04-15,2,1,4,15,0,0,0,1,0.7,0.6364,0.39,0.3881,266,3990,351,3510,617,7500
11172,2012-04-15,2,1,4,16,0,0,0,1,0.72,0.6515,0.39,0.3582,286,4290,330,3300,616,7590
11173,2012-04-15,2,1,4,17,0,0,0,1,0.7,0.6364,0.42,0.3284,262,3930,361,3610,623,7540
11174,2012-04-15,2,1,4,18,0,0,0,1,0.7,0.6364,0.42,0.2537,184,2760,295,2950,479,5710
11175,2012-04-15,2,1,4,19,0,0,0,1,0.7,0.6364,0.42,0.2537,114,1710,265,2650,379,4360
11176,2012-04-15,2,1,4,20,0,0,0,1,0.64,0.6212,0.5,0.2239,86,1290,205,2050,291,3340
11177,2012-04-15,2,1,4,21,0,0,0,1,0.62,0.6212,0.57,0.2537,76,1140,153,1530,229,2670
11178,2012-04-15,2,1,4,22,0,0,0,1,0.68,0.6364,0.44,0.3582,37,555,97,970,134,1525
11179,2012-04-15,2,1,4,23,0,0,0,1,0.66,0.6212,0.5,0.3881,25,375,65,650,90,1025
11180,2012-04-16,2,1,4,0,1,1,0,1,0.64,0.6212,0.53,0.3284,15,225,26,260,41,485
11181,2012-04-16,2,1,4,1,1,1,0,1,0.62,0.6061,0.61,0.3582,7,105,21,210,28,315
11182,2012-04-16,2,1,4,2,1,1,0,1,0.6,0.6061,0.64,0.2537,5,75,9,90,14,165
11183,2012-04-16,2,1,4,3,1,1,0,1,0.58,0.5455,0.68,0.194,3,45,5,50,8,95
11184,2012-04-16,2,1,4,4,1,1,0,1,0.54,0.5152,0.77,0.2239,0,0,6,60,6,60
11185,2012-04-16,2,1,4,5,1,1,0,1,0.54,0.5152,0.77,0.2239,4,60,34,340,38,400
11186,2012-04-16,2,1,4,6,1,1,0,1,0.52,0.5,0.83,0.1642,10,150,123,1230,133,1380
11187,2012-04-16,2,1,4,7,1,1,0,1,0.52,0.5,0.83,0.1343,20,300,367,3670,387,3970
11188,2012-04-16,2,1,4,8,1,1,0,2,0.56,0.5303,0.83,0.1642,48,720,549,5490,597,6210
11189,2012-04-16,2,1,4,9,1,1,0,1,0.62,0.6061,0.69,0.2239,59,885,238,2380,297,3265
11190,2012-04-16,2,1,4,10,1,1,0,1,0.62,0.6061,0.69,0.2537,75,1125,149,1490,224,2615
11191,2012-04-16,2,1,4,11,1,1,0,1,0.64,0.6061,0.65,0.2537,115,1725,136,1360,251,3085
11192,2012-04-16,2,1,4,12,1,1,0,1,0.68,0.6364,0.57,0.2537,75,1125,196,1960,271,3085
11193,2012-04-16,2,1,4,13,1,1,0,1,0.74,0.6667,0.45,0.2985,79,1185,184,1840,263,3025
11194,2012-04-16,2,1,4,14,1,1,0,1,0.76,0.6818,0.45,0.3284,105,1575,183,1830,288,3405
11195,2012-04-16,2,1,4,15,1,1,0,1,0.8,0.697,0.33,0.4478,81,1215,194,1940,275,3155
11196,2012-04-16,2,1,4,16,1,1,0,1,0.8,0.697,0.33,0.4627,92,1380,266,2660,358,4040
11197,2012-04-16,2,1,4,17,1,1,0,1,0.8,0.697,0.33,0.3881,111,1665,601,6010,712,7675
11198,2012-04-16,2,1,4,18,1,1,0,1,0.8,0.697,0.31,0.3881,87,1305,589,5890,676,7195
11199,2012-04-16,2,1,4,19,1,1,0,1,0.76,0.6667,0.35,0.3881,61,915,461,4610,522,5525
11200,2012-04-16,2,1,4,20,1,1,0,1,0.74,0.6515,0.37,0.2985,48,720,327,3270,375,3990
11201,2012-04-16,2,1,4,21,1,1,0,1,0.68,0.6364,0.51,0.2537,39,585,232,2320,271,2905
11202,2012-04-16,2,1,4,22,1,1,0,1,0.68,0.6364,0.51,0.2537,35,525,179,1790,214,2315
11203,2012-04-16,2,1,4,23,1,1,0,1,0.7,0.6364,0.45,0.2985,24,360,97,970,121,1330
11204,2012-04-17,2,1,4,0,0,2,1,1,0.66,0.6212,0.54,0.194,10,150,33,330,43,480
11205,2012-04-17,2,1,4,1,0,2,1,1,0.64,0.6212,0.57,0.1642,6,90,5,50,11,140
11206,2012-04-17,2,1,4,2,0,2,1,1,0.56,0.5303,0.83,0.1045,1,15,3,30,4,45
11207,2012-04-17,2,1,4,3,0,2,1,1,0.56,0.5303,0.83,0.0896,0,0,6,60,6,60
11208,2012-04-17,2,1,4,4,0,2,1,1,0.66,0.6212,0.44,0.2239,3,45,6,60,9,105
11209,2012-04-17,2,1,4,5,0,2,1,1,0.6,0.6212,0.53,0.2537,1,15,29,290,30,305
11210,2012-04-17,2,1,4,6,0,2,1,1,0.6,0.6212,0.46,0.2537,8,120,136,1360,144,1480
11211,2012-04-17,2,1,4,7,0,2,1,1,0.6,0.6212,0.43,0.2537,18,270,443,4430,461,4700
11212,2012-04-17,2,1,4,8,0,2,1,1,0.6,0.6212,0.43,0.2239,42,630,631,6310,673,6940
11213,2012-04-17,2,1,4,9,0,2,1,1,0.6,0.6212,0.38,0.4925,71,1065,329,3290,400,4355
11214,2012-04-17,2,1,4,10,0,2,1,1,0.6,0.6212,0.38,0.4179,52,780,165,1650,217,2430
11215,2012-04-17,2,1,4,11,0,2,1,1,0.6,0.6212,0.33,0.4179,65,975,174,1740,239,2715
11216,2012-04-17,2,1,4,12,0,2,1,1,0.6,0.6212,0.33,0.3582,65,975,179,1790,244,2765
11217,2012-04-17,2,1,4,13,0,2,1,1,0.62,0.6212,0.29,0.2537,52,780,187,1870,239,2650
11218,2012-04-17,2,1,4,14,0,2,1,1,0.64,0.6212,0.27,0.2836,59,885,198,1980,257,2865
11219,2012-04-17,2,1,4,15,0,2,1,1,0.66,0.6212,0.24,0.3284,91,1365,217,2170,308,3535
11220,2012-04-17,2,1,4,16,0,2,1,1,0.68,0.6212,0.22,0.3582,50,750,320,3200,370,3950
11221,2012-04-17,2,1,4,17,0,2,1,1,0.64,0.6061,0.25,0.2985,108,1620,673,6730,781,8350
11222,2012-04-17,2,1,4,18,0,2,1,1,0.64,0.6061,0.25,0.2836,105,1575,670,6700,775,8275
11223,2012-04-17,2,1,4,19,0,2,1,1,0.6,0.6061,0.26,0.2537,73,1095,464,4640,537,5735
11224,2012-04-17,2,1,4,20,0,2,1,1,0.6,0.6061,0.23,0.2836,44,660,358,3580,402,4240
11225,2012-04-17,2,1,4,21,0,2,1,1,0.56,0.5303,0.26,0.2985,37,555,260,2600,297,3155
11226,2012-04-17,2,1,4,22,0,2,1,1,0.54,0.5152,0.3,0.2537,18,270,144,1440,162,1710
11227,2012-04-17,2,1,4,23,0,2,1,1,0.54,0.5152,0.32,0.2239,10,150,72,720,82,870
11228,2012-04-18,2,1,4,0,0,3,1,1,0.54,0.5152,0.32,0.1642,3,45,35,350,38,395
11229,2012-04-18,2,1,4,1,0,3,1,1,0.52,0.5,0.34,0.194,1,15,13,130,14,145
11230,2012-04-18,2,1,4,2,0,3,1,2,0.5,0.4848,0.42,0.194,1,15,8,80,9,95
11231,2012-04-18,2,1,4,3,0,3,1,2,0.5,0.4848,0.42,0.2239,0,0,6,60,6,60
11232,2012-04-18,2,1,4,4,0,3,1,2,0.5,0.4848,0.42,0.2836,0,0,7,70,7,70
11233,2012-04-18,2,1,4,5,0,3,1,2,0.5,0.4848,0.39,0.2836,0,0,34,340,34,340
11234,2012-04-18,2,1,4,6,0,3,1,2,0.5,0.4848,0.39,0.2836,6,90,128,1280,134,1370
11235,2012-04-18,2,1,4,7,0,3,1,2,0.5,0.4848,0.39,0.194,10,150,408,4080,418,4230
11236,2012-04-18,2,1,4,8,0,3,1,3,0.5,0.4848,0.39,0.194,25,375,551,5510,576,5885
11237,2012-04-18,2,1,4,9,0,3,1,3,0.48,0.4697,0.44,0.2985,20,300,245,2450,265,2750
11238,2012-04-18,2,1,4,10,0,3,1,3,0.48,0.4697,0.47,0.2239,31,465,116,1160,147,1625
11239,2012-04-18,2,1,4,11,0,3,1,3,0.46,0.4545,0.47,0.2537,14,210,105,1050,119,1260
11240,2012-04-18,2,1,4,12,0,3,1,3,0.46,0.4545,0.51,0.1045,15,225,95,950,110,1175
11241,2012-04-18,2,1,4,13,0,3,1,3,0.46,0.4545,0.59,0.0,13,195,51,510,64,705
11242,2012-04-18,2,1,4,14,0,3,1,3,0.44,0.4394,0.72,0.1045,8,120,43,430,51,550
11243,2012-04-18,2,1,4,15,0,3,1,3,0.42,0.4242,0.77,0.194,10,150,88,880,98,1030
11244,2012-04-18,2,1,4,16,0,3,1,2,0.42,0.4242,0.77,0.2239,36,540,199,1990,235,2530
11245,2012-04-18,2,1,4,17,0,3,1,2,0.42,0.4242,0.77,0.194,46,690,442,4420,488,5110
11246,2012-04-18,2,1,4,18,0,3,1,2,0.42,0.4242,0.77,0.0,27,405,478,4780,505,5185
11247,2012-04-18,2,1,4,19,0,3,1,2,0.42,0.4242,0.77,0.1343,26,390,342,3420,368,3810
11248,2012-04-18,2,1,4,20,0,3,1,2,0.42,0.4242,0.77,0.1045,8,120,252,2520,260,2640
11249,2012-04-18,2,1,4,21,0,3,1,2,0.42,0.4242,0.82,0.0896,24,360,165,1650,189,2010
11250,2012-04-18,2,1,4,22,0,3,1,2,0.42,0.4242,0.77,0.0896,9,135,153,1530,162,1665
11251,2012-04-18,2,1,4,23,0,3,1,2,0.42,0.4242,0.77,0.0,14,210,56,560,70,770
11252,2012-04-19,2,1,4,0,0,4,1,3,0.42,0.4242,0.77,0.0,5,75,20,200,25,275
11253,2012-04-19,2,1,4,1,0,4,1,3,0.42,0.4242,0.77,0.1045,2,30,11,110,13,140
11254,2012-04-19,2,1,4,2,0,4,1,2,0.42,0.4242,0.77,0.0,2,30,4,40,6,70
11255,2012-04-19,2,1,4,3,0,4,1,2,0.42,0.4242,0.77,0.0,1,15,3,30,4,45
11256,2012-04-19,2,1,4,4,0,4,1,2,0.42,0.4242,0.71,0.0,0,0,4,40,4,40
11257,2012-04-19,2,1,4,5,0,4,1,1,0.4,0.4091,0.82,0.0,0,0,30,300,30,300
11258,2012-04-19,2,1,4,6,0,4,1,2,0.4,0.4091,0.82,0.1045,4,60,116,1160,120,1220
11259,2012-04-19,2,1,4,7,0,4,1,2,0.4,0.4091,0.82,0.1343,15,225,391,3910,406,4135
11260,2012-04-19,2,1,4,8,0,4,1,2,0.42,0.4242,0.82,0.1045,26,390,651,6510,677,6900
11261,2012-04-19,2,1,4,9,0,4,1,2,0.46,0.4545,0.72,0.0,31,465,270,2700,301,3165
11262,2012-04-19,2,1,4,10,0,4,1,1,0.48,0.4697,0.63,0.0896,46,690,143,1430,189,2120
11263,2012-04-19,2,1,4,11,0,4,1,1,0.52,0.5,0.48,0.0,46,690,183,1830,229,2520
11264,2012-04-19,2,1,4,12,0,4,1,1,0.54,0.5152,0.49,0.0,51,765,213,2130,264,2895
11265,2012-04-19,2,1,4,13,0,4,1,1,0.56,0.5303,0.46,0.0,52,780,186,1860,238,2640
11266,2012-04-19,2,1,4,14,0,4,1,1,0.58,0.5455,0.43,0.0,54,810,183,1830,237,2640
11267,2012-04-19,2,1,4,15,0,4,1,1,0.6,0.6212,0.43,0.0,66,990,196,1960,262,2950
11268,2012-04-19,2,1,4,16,0,4,1,1,0.62,0.6212,0.41,0.1045,63,945,324,3240,387,4185
11269,2012-04-19,2,1,4,17,0,4,1,1,0.6,0.6212,0.43,0.0896,85,1275,663,6630,748,7905
11270,2012-04-19,2,1,4,18,0,4,1,1,0.6,0.6212,0.43,0.0896,99,1485,677,6770,776,8255
11271,2012-04-19,2,1,4,19,0,4,1,1,0.58,0.5455,0.46,0.1343,70,1050,516,5160,586,6210
11272,2012-04-19,2,1,4,20,0,4,1,1,0.56,0.5303,0.49,0.2239,52,780,352,3520,404,4300
11273,2012-04-19,2,1,4,21,0,4,1,1,0.52,0.5,0.55,0.1045,27,405,240,2400,267,2805
11274,2012-04-19,2,1,4,22,0,4,1,1,0.52,0.5,0.59,0.194,29,435,219,2190,248,2625
11275,2012-04-19,2,1,4,23,0,4,1,1,0.5,0.4848,0.63,0.1045,20,300,124,1240,144,1540
11276,2012-04-20,2,1,4,0,0,5,1,1,0.48,0.4697,0.67,0.1045,5,75,59,590,64,665
11277,2012-04-20,2,1,4,1,0,5,1,1,0.46,0.4545,0.82,0.194,3,45,22,220,25,265
11278,2012-04-20,2,1,4,2,0,5,1,1,0.44,0.4394,0.88,0.194,3,45,18,180,21,225
11279,2012-04-20,2,1,4,3,0,5,1,1,0.44,0.4394,0.88,0.1045,1,15,9,90,10,105
11280,2012-04-20,2,1,4,4,0,5,1,1,0.42,0.4242,0.94,0.1045,0,0,3,30,3,30
11281,2012-04-20,2,1,4,5,0,5,1,1,0.42,0.4242,0.94,0.0,1,15,24,240,25,255
11282,2012-04-20,2,1,4,6,0,5,1,1,0.42,0.4242,0.88,0.0,8,120,105,1050,113,1170
11283,2012-04-20,2,1,4,7,0,5,1,1,0.42,0.4242,0.94,0.0,9,135,350,3500,359,3635
11284,2012-04-20,2,1,4,8,0,5,1,1,0.44,0.4394,0.94,0.0,32,480,668,6680,700,7160
11285,2012-04-20,2,1,4,9,0,5,1,1,0.46,0.4545,0.88,0.0896,30,450,329,3290,359,3740
11286,2012-04-20,2,1,4,10,0,5,1,1,0.5,0.4848,0.77,0.194,67,1005,170,1700,237,2705
11287,2012-04-20,2,1,4,11,0,5,1,1,0.54,0.5152,0.68,0.1642,64,960,190,1900,254,2860
11288,2012-04-20,2,1,4,12,0,5,1,1,0.58,0.5455,0.53,0.194,102,1530,260,2600,362,4130
11289,2012-04-20,2,1,4,13,0,5,1,1,0.62,0.6212,0.43,0.194,105,1575,276,2760,381,4335
11290,2012-04-20,2,1,4,14,0,5,1,1,0.64,0.6212,0.44,0.2239,156,2340,238,2380,394,4720
11291,2012-04-20,2,1,4,15,0,5,1,1,0.64,0.6212,0.47,0.194,145,2175,262,2620,407,4795
11292,2012-04-20,2,1,4,16,0,5,1,1,0.66,0.6212,0.44,0.194,151,2265,429,4290,580,6555
11293,2012-04-20,2,1,4,17,0,5,1,1,0.64,0.6212,0.47,0.2836,122,1830,697,6970,819,8800
11294,2012-04-20,2,1,4,18,0,5,1,1,0.62,0.6212,0.5,0.2836,110,1650,558,5580,668,7230
11295,2012-04-20,2,1,4,19,0,5,1,1,0.6,0.6212,0.53,0.194,82,1230,410,4100,492,5330
11296,2012-04-20,2,1,4,20,0,5,1,1,0.58,0.5455,0.56,0.1642,52,780,289,2890,341,3670
11297,2012-04-20,2,1,4,21,0,5,1,1,0.56,0.5303,0.68,0.1343,35,525,252,2520,287,3045
11298,2012-04-20,2,1,4,22,0,5,1,1,0.54,0.5152,0.68,0.2537,26,390,176,1760,202,2150
11299,2012-04-20,2,1,4,23,0,5,1,1,0.52,0.5,0.72,0.1343,31,465,156,1560,187,2025
11300,2012-04-21,2,1,4,0,0,6,0,1,0.52,0.5,0.77,0.2239,31,465,111,1110,142,1575
11301,2012-04-21,2,1,4,1,0,6,0,1,0.52,0.5,0.77,0.2239,24,360,64,640,88,1000
11302,2012-04-21,2,1,4,2,0,6,0,1,0.52,0.5,0.77,0.1343,12,180,69,690,81,870
11303,2012-04-21,2,1,4,3,0,6,0,1,0.5,0.4848,0.82,0.2239,4,60,25,250,29,310
11304,2012-04-21,2,1,4,4,0,6,0,1,0.5,0.4848,0.82,0.2537,0,0,9,90,9,90
11305,2012-04-21,2,1,4,5,0,6,0,1,0.5,0.4848,0.82,0.2537,0,0,1,10,1,10
11306,2012-04-21,2,1,4,6,0,6,0,1,0.5,0.4848,0.82,0.2239,10,150,21,210,31,360
11307,2012-04-21,2,1,4,7,0,6,0,1,0.5,0.4848,0.82,0.2836,21,315,55,550,76,865
11308,2012-04-21,2,1,4,8,0,6,0,1,0.52,0.5,0.81,0.2537,52,780,149,1490,201,2270
11309,2012-04-21,2,1,4,9,0,6,0,1,0.54,0.5152,0.77,0.1642,115,1725,216,2160,331,3885
11310,2012-04-21,2,1,4,10,0,6,0,1,0.6,0.6061,0.64,0.2836,183,2745,299,2990,482,5735
11311,2012-04-21,2,1,4,11,0,6,0,1,0.62,0.6061,0.61,0.3284,260,3900,348,3480,608,7380
11312,2012-04-21,2,1,4,12,0,6,0,1,0.64,0.6212,0.57,0.2239,262,3930,378,3780,640,7710
11313,2012-04-21,2,1,4,13,0,6,0,1,0.66,0.6212,0.54,0.2239,291,4365,358,3580,649,7945
11314,2012-04-21,2,1,4,14,0,6,0,1,0.7,0.6364,0.45,0.2836,278,4170,331,3310,609,7480
11315,2012-04-21,2,1,4,15,0,6,0,1,0.72,0.6515,0.39,0.2537,267,4005,361,3610,628,7615
11316,2012-04-21,2,1,4,16,0,6,0,1,0.7,0.6364,0.42,0.3284,267,4005,372,3720,639,7725
11317,2012-04-21,2,1,4,17,0,6,0,2,0.74,0.6515,0.3,0.3881,259,3885,309,3090,568,6975
11318,2012-04-21,2,1,4,18,0,6,0,2,0.68,0.6364,0.47,0.4925,133,1995,283,2830,416,4825
11319,2012-04-21,2,1,4,19,0,6,0,3,0.56,0.5303,0.73,0.4925,9,135,45,450,54,585
11320,2012-04-21,2,1,4,20,0,6,0,3,0.5,0.4848,0.82,0.2985,5,75,34,340,39,415
11321,2012-04-21,2,1,4,21,0,6,0,3,0.5,0.4848,0.82,0.3881,20,300,82,820,102,1120
11322,2012-04-21,2,1,4,22,0,6,0,1,0.48,0.4697,0.82,0.2985,20,300,90,900,110,1200
11323,2012-04-21,2,1,4,23,0,6,0,2,0.46,0.4545,0.82,0.2836,18,270,73,730,91,1000
11324,2012-04-22,2,1,4,0,0,0,0,2,0.46,0.4545,0.82,0.194,32,480,85,850,117,1330
11325,2012-04-22,2,1,4,1,0,0,0,2,0.46,0.4545,0.82,0.3284,10,150,63,630,73,780
11326,2012-04-22,2,1,4,2,0,0,0,1,0.46,0.4545,0.72,0.2836,7,105,49,490,56,595
11327,2012-04-22,2,1,4,3,0,0,0,2,0.44,0.4394,0.82,0.1642,7,105,33,330,40,435
11328,2012-04-22,2,1,4,4,0,0,0,2,0.44,0.4394,0.77,0.1642,0,0,7,70,7,70
11329,2012-04-22,2,1,4,5,0,0,0,2,0.44,0.4394,0.77,0.2239,0,0,6,60,6,60
11330,2012-04-22,2,1,4,6,0,0,0,2,0.44,0.4394,0.72,0.3284,6,90,6,60,12,150
11331,2012-04-22,2,1,4,7,0,0,0,3,0.42,0.4242,0.77,0.3881,2,30,22,220,24,250
11332,2012-04-22,2,1,4,8,0,0,0,3,0.4,0.4091,0.82,0.2537,8,120,43,430,51,550
11333,2012-04-22,2,1,4,9,0,0,0,3,0.4,0.4091,0.82,0.2537,8,120,71,710,79,830
11334,2012-04-22,2,1,4,10,0,0,0,3,0.38,0.3939,0.82,0.3284,11,165,57,570,68,735
11335,2012-04-22,2,1,4,11,0,0,0,3,0.38,0.3939,0.87,0.2985,7,105,70,700,77,805
11336,2012-04-22,2,1,4,12,0,0,0,3,0.38,0.3939,0.87,0.3284,5,75,56,560,61,635
11337,2012-04-22,2,1,4,13,0,0,0,3,0.38,0.3939,0.82,0.3582,5,75,47,470,52,545
11338,2012-04-22,2,1,4,14,0,0,0,3,0.38,0.3939,0.87,0.3284,3,45,50,500,53,545
11339,2012-04-22,2,1,4,15,0,0,0,3,0.38,0.3939,0.87,0.3881,0,0,38,380,38,380
11340,2012-04-22,2,1,4,16,0,0,0,3,0.38,0.3939,0.87,0.4478,4,60,32,320,36,380
11341,2012-04-22,2,1,4,17,0,0,0,3,0.36,0.3182,0.93,0.4478,2,30,25,250,27,280
11342,2012-04-22,2,1,4,18,0,0,0,3,0.36,0.3182,0.93,0.4478,1,15,38,380,39,395
11343,2012-04-22,2,1,4,19,0,0,0,3,0.36,0.3182,0.87,0.5224,1,15,34,340,35,355
11344,2012-04-22,2,1,4,20,0,0,0,3,0.36,0.3333,0.93,0.4179,1,15,34,340,35,355
11345,2012-04-22,2,1,4,21,0,0,0,3,0.36,0.3333,0.87,0.3881,0,0,11,110,11,110
11346,2012-04-22,2,1,4,22,0,0,0,3,0.34,0.2879,0.87,0.5224,0,0,13,130,13,130
11347,2012-04-22,2,1,4,23,0,0,0,3,0.36,0.3182,0.81,0.4627,0,0,17,170,17,170
11348,2012-04-23,2,1,4,0,0,1,1,3,0.36,0.3333,0.81,0.4179,0,0,6,60,6,60
11349,2012-04-23,2,1,4,1,0,1,1,3,0.34,0.303,0.87,0.3582,1,15,1,10,2,25
11350,2012-04-23,2,1,4,2,0,1,1,2,0.32,0.303,0.87,0.3284,1,15,3,30,4,45
11351,2012-04-23,2,1,4,3,0,1,1,2,0.32,0.303,0.81,0.2836,0,0,1,10,1,10
11352,2012-04-23,2,1,4,4,0,1,1,3,0.3,0.2879,0.81,0.2836,0,0,3,30,3,30
11353,2012-04-23,2,1,4,5,0,1,1,3,0.3,0.2879,0.81,0.2836,0,0,14,140,14,140
11354,2012-04-23,2,1,4,6,0,1,1,2,0.3,0.2727,0.81,0.2985,2,30,43,430,45,460
11355,2012-04-23,2,1,4,7,0,1,1,3,0.3,0.2879,0.81,0.2537,1,15,206,2060,207,2075
11356,2012-04-23,2,1,4,8,0,1,1,2,0.3,0.2727,0.75,0.3284,11,165,471,4710,482,4875
11357,2012-04-23,2,1,4,9,0,1,1,2,0.3,0.2727,0.75,0.3881,17,255,255,2550,272,2805
11358,2012-04-23,2,1,4,10,0,1,1,2,0.32,0.303,0.7,0.3284,12,180,88,880,100,1060
11359,2012-04-23,2,1,4,11,0,1,1,2,0.32,0.2879,0.7,0.3582,10,150,91,910,101,1060
11360,2012-04-23,2,1,4,12,0,1,1,3,0.34,0.303,0.71,0.3582,12,180,117,1170,129,1350
11361,2012-04-23,2,1,4,13,0,1,1,3,0.34,0.303,0.66,0.3881,9,135,98,980,107,1115
11362,2012-04-23,2,1,4,14,0,1,1,3,0.36,0.3182,0.62,0.4478,12,180,102,1020,114,1200
11363,2012-04-23,2,1,4,15,0,1,1,2,0.36,0.3333,0.62,0.3881,11,165,101,1010,112,1175
11364,2012-04-23,2,1,4,16,0,1,1,3,0.3,0.2727,0.81,0.3582,10,150,93,930,103,1080
11365,2012-04-23,2,1,4,17,0,1,1,3,0.3,0.2727,0.82,0.3284,13,195,219,2190,232,2385
11366,2012-04-23,2,1,4,18,0,1,1,3,0.32,0.3333,0.81,0.1343,10,150,369,3690,379,3840
11367,2012-04-23,2,1,4,19,0,1,1,2,0.34,0.3182,0.76,0.2239,11,165,287,2870,298,3035
11368,2012-04-23,2,1,4,20,0,1,1,2,0.32,0.3182,0.76,0.1642,17,255,186,1860,203,2115
11369,2012-04-23,2,1,4,21,0,1,1,2,0.32,0.303,0.81,0.2239,7,105,145,1450,152,1555
11370,2012-04-23,2,1,4,22,0,1,1,1,0.32,0.3182,0.76,0.194,18,270,71,710,89,980
11371,2012-04-23,2,1,4,23,0,1,1,1,0.32,0.3182,0.76,0.1642,10,150,49,490,59,640
11372,2012-04-24,2,1,4,0,0,2,1,2,0.32,0.3333,0.76,0.1343,0,0,13,130,13,130
11373,2012-04-24,2,1,4,1,0,2,1,2,0.32,0.3333,0.81,0.1343,1,15,6,60,7,75
11374,2012-04-24,2,1,4,2,0,2,1,1,0.32,0.3182,0.81,0.194,0,0,3,30,3,30
11375,2012-04-24,2,1,4,3,0,2,1,1,0.32,0.303,0.81,0.2239,0,0,2,20,2,20
11376,2012-04-24,2,1,4,4,0,2,1,1,0.3,0.2879,0.7,0.194,0,0,3,30,3,30
11377,2012-04-24,2,1,4,5,0,2,1,1,0.3,0.2879,0.7,0.194,0,0,22,220,22,220
11378,2012-04-24,2,1,4,6,0,2,1,1,0.3,0.2879,0.7,0.2239,3,45,117,1170,120,1215
11379,2012-04-24,2,1,4,7,0,2,1,1,0.32,0.303,0.66,0.2836,3,45,387,3870,390,3915
11380,2012-04-24,2,1,4,8,0,2,1,1,0.34,0.3182,0.61,0.2537,12,180,599,5990,611,6170
11381,2012-04-24,2,1,4,9,0,2,1,1,0.4,0.4091,0.47,0.3582,6,90,302,3020,308,3110
11382,2012-04-24,2,1,4,10,0,2,1,1,0.42,0.4242,0.47,0.2985,33,495,129,1290,162,1785
11383,2012-04-24,2,1,4,11,0,2,1,1,0.46,0.4545,0.31,0.3881,27,405,157,1570,184,1975
11384,2012-04-24,2,1,4,12,0,2,1,1,0.48,0.4697,0.29,0.3881,36,540,188,1880,224,2420
11385,2012-04-24,2,1,4,13,0,2,1,1,0.5,0.4848,0.29,0.3881,35,525,189,1890,224,2415
11386,2012-04-24,2,1,4,14,0,2,1,1,0.5,0.4848,0.25,0.3881,50,750,166,1660,216,2410
11387,2012-04-24,2,1,4,15,0,2,1,1,0.5,0.4848,0.23,0.4179,60,900,176,1760,236,2660
11388,2012-04-24,2,1,4,16,0,2,1,1,0.5,0.4848,0.23,0.194,54,810,308,3080,362,3890
11389,2012-04-24,2,1,4,17,0,2,1,1,0.52,0.5,0.22,0.3881,72,1080,619,6190,691,7270
11390,2012-04-24,2,1,4,18,0,2,1,1,0.5,0.4848,0.18,0.0,52,780,580,5800,632,6580
11391,2012-04-24,2,1,4,19,0,2,1,1,0.5,0.4848,0.18,0.2537,33,495,449,4490,482,4985
11392,2012-04-24,2,1,4,20,0,2,1,1,0.48,0.4697,0.21,0.3284,16,240,269,2690,285,2930
11393,2012-04-24,2,1,4,21,0,2,1,2,0.46,0.4545,0.28,0.1642,13,195,213,2130,226,2325
11394,2012-04-24,2,1,4,22,0,2,1,1,0.44,0.4394,0.35,0.1045,8,120,149,1490,157,1610
11395,2012-04-24,2,1,4,23,0,2,1,1,0.42,0.4242,0.38,0.0896,4,60,69,690,73,750
11396,2012-04-25,2,1,4,0,0,3,1,1,0.44,0.4394,0.38,0.0,13,195,23,230,36,425
11397,2012-04-25,2,1,4,1,0,3,1,1,0.42,0.4242,0.41,0.0,8,120,17,170,25,290
11398,2012-04-25,2,1,4,2,0,3,1,1,0.36,0.3788,0.62,0.0,1,15,6,60,7,75
11399,2012-04-25,2,1,4,3,0,3,1,1,0.32,0.3333,0.7,0.0896,0,0,3,30,3,30
11400,2012-04-25,2,1,4,4,0,3,1,1,0.34,0.3485,0.66,0.0896,0,0,6,60,6,60
11401,2012-04-25,2,1,4,5,0,3,1,1,0.34,0.3636,0.66,0.0,0,0,24,240,24,240
11402,2012-04-25,2,1,4,6,0,3,1,1,0.34,0.3636,0.66,0.0,3,45,103,1030,106,1075
11403,2012-04-25,2,1,4,7,0,3,1,1,0.34,0.3636,0.71,0.0,13,195,376,3760,389,3955
11404,2012-04-25,2,1,4,8,0,3,1,1,0.36,0.3636,0.76,0.0896,20,300,634,6340,654,6640
11405,2012-04-25,2,1,4,9,0,3,1,1,0.42,0.4242,0.54,0.0,33,495,288,2880,321,3375
11406,2012-04-25,2,1,4,10,0,3,1,1,0.52,0.5,0.34,0.0,44,660,138,1380,182,2040
11407,2012-04-25,2,1,4,11,0,3,1,1,0.52,0.5,0.32,0.1343,42,630,177,1770,219,2400
11408,2012-04-25,2,1,4,12,0,3,1,1,0.54,0.5152,0.28,0.2836,49,735,220,2200,269,2935
11409,2012-04-25,2,1,4,13,0,3,1,1,0.56,0.5303,0.26,0.2239,35,525,193,1930,228,2455
11410,2012-04-25,2,1,4,14,0,3,1,1,0.56,0.5303,0.22,0.3582,47,705,176,1760,223,2465
11411,2012-04-25,2,1,4,15,0,3,1,1,0.58,0.5455,0.19,0.1642,47,705,182,1820,229,2525
11412,2012-04-25,2,1,4,16,0,3,1,1,0.6,0.5909,0.2,0.3284,49,735,327,3270,376,4005
11413,2012-04-25,2,1,4,17,0,3,1,1,0.6,0.5909,0.2,0.2985,68,1020,664,6640,732,7660
11414,2012-04-25,2,1,4,18,0,3,1,1,0.6,0.5909,0.2,0.2836,60,900,649,6490,709,7390
11415,2012-04-25,2,1,4,19,0,3,1,1,0.6,0.5909,0.2,0.194,42,630,501,5010,543,5640
11416,2012-04-25,2,1,4,20,0,3,1,1,0.56,0.5303,0.22,0.0896,22,330,358,3580,380,3910
11417,2012-04-25,2,1,4,21,0,3,1,1,0.52,0.5,0.52,0.1343,27,405,212,2120,239,2525
11418,2012-04-25,2,1,4,22,0,3,1,1,0.5,0.4848,0.51,0.0,22,330,170,1700,192,2030
11419,2012-04-25,2,1,4,23,0,3,1,2,0.5,0.4848,0.51,0.0896,10,150,94,940,104,1090
11420,2012-04-26,2,1,4,0,0,4,1,2,0.48,0.4697,0.63,0.0,1,15,42,420,43,435
11421,2012-04-26,2,1,4,1,0,4,1,2,0.48,0.4697,0.48,0.0896,1,15,22,220,23,235
11422,2012-04-26,2,1,4,2,0,4,1,2,0.48,0.4697,0.55,0.1045,3,45,10,100,13,145
11423,2012-04-26,2,1,4,3,0,4,1,2,0.48,0.4697,0.55,0.0896,1,15,5,50,6,65
11424,2012-04-26,2,1,4,4,0,4,1,2,0.48,0.4697,0.59,0.0896,1,15,2,20,3,35
11425,2012-04-26,2,1,4,5,0,4,1,2,0.48,0.4697,0.63,0.1343,0,0,17,170,17,170
11426,2012-04-26,2,1,4,6,0,4,1,2,0.48,0.4697,0.63,0.2537,5,75,122,1220,127,1295
11427,2012-04-26,2,1,4,7,0,4,1,3,0.46,0.4545,0.82,0.3582,3,45,222,2220,225,2265
11428,2012-04-26,2,1,4,8,0,4,1,3,0.46,0.4545,0.82,0.194,4,60,358,3580,362,3640
11429,2012-04-26,2,1,4,9,0,4,1,3,0.46,0.4545,0.88,0.1642,12,180,189,1890,201,2070
11430,2012-04-26,2,1,4,10,0,4,1,2,0.46,0.4545,0.94,0.1642,14,210,125,1250,139,1460
11431,2012-04-26,2,1,4,11,0,4,1,2,0.46,0.4545,0.94,0.2239,16,240,135,1350,151,1590
11432,2012-04-26,2,1,4,12,0,4,1,2,0.52,0.5,0.83,0.1343,24,360,180,1800,204,2160
11433,2012-04-26,2,1,4,13,0,4,1,2,0.5,0.4848,0.82,0.1642,19,285,178,1780,197,2065
11434,2012-04-26,2,1,4,14,0,4,1,2,0.54,0.5152,0.77,0.194,37,555,132,1320,169,1875
11435,2012-04-26,2,1,4,15,0,4,1,2,0.52,0.5,0.83,0.3284,39,585,165,1650,204,2235
11436,2012-04-26,2,1,4,16,0,4,1,2,0.52,0.5,0.83,0.2239,37,555,281,2810,318,3365
11437,2012-04-26,2,1,4,17,0,4,1,1,0.54,0.5152,0.77,0.1642,49,735,565,5650,614,6385
11438,2012-04-26,2,1,4,18,0,4,1,2,0.54,0.5152,0.77,0.194,75,1125,589,5890,664,7015
11439,2012-04-26,2,1,4,19,0,4,1,2,0.54,0.5152,0.77,0.2239,57,855,407,4070,464,4925
11440,2012-04-26,2,1,4,20,0,4,1,1,0.54,0.5152,0.77,0.194,23,345,314,3140,337,3485
11441,2012-04-26,2,1,4,21,0,4,1,1,0.52,0.5,0.83,0.2239,28,420,222,2220,250,2640
11442,2012-04-26,2,1,4,22,0,4,1,1,0.52,0.5,0.83,0.1642,20,300,163,1630,183,1930
11443,2012-04-26,2,1,4,23,0,4,1,1,0.5,0.4848,0.88,0.1642,6,90,106,1060,112,1150
11444,2012-04-27,2,1,4,0,0,5,1,1,0.54,0.5152,0.68,0.5522,12,180,61,610,73,790
11445,2012-04-27,2,1,4,1,0,5,1,1,0.5,0.4848,0.59,0.4478,3,45,32,320,35,365
11446,2012-04-27,2,1,4,2,0,5,1,1,0.48,0.4697,0.59,0.4179,4,60,18,180,22,240
11447,2012-04-27,2,1,4,3,0,5,1,1,0.44,0.4394,0.47,0.4925,1,15,2,20,3,35
11448,2012-04-27,2,1,4,4,0,5,1,1,0.42,0.4242,0.44,0.2537,0,0,6,60,6,60
11449,2012-04-27,2,1,4,5,0,5,1,1,0.42,0.4242,0.44,0.3582,0,0,19,190,19,190
11450,2012-04-27,2,1,4,6,0,5,1,1,0.4,0.4091,0.43,0.2537,5,75,115,1150,120,1225
11451,2012-04-27,2,1,4,7,0,5,1,1,0.38,0.3939,0.5,0.2836,10,150,305,3050,315,3200
11452,2012-04-27,2,1,4,8,0,5,1,1,0.4,0.4091,0.5,0.0,17,255,575,5750,592,6005
11453,2012-04-27,2,1,4,9,0,5,1,1,0.42,0.4242,0.44,0.4925,42,630,292,2920,334,3550
11454,2012-04-27,2,1,4,10,0,5,1,1,0.44,0.4394,0.38,0.4179,64,960,172,1720,236,2680
11455,2012-04-27,2,1,4,11,0,5,1,1,0.44,0.4394,0.38,0.3284,47,705,186,1860,233,2565
11456,2012-04-27,2,1,4,12,0,5,1,1,0.46,0.4545,0.36,0.3582,63,945,244,2440,307,3385
11457,2012-04-27,2,1,4,13,0,5,1,1,0.46,0.4545,0.33,0.3881,94,1410,212,2120,306,3530
11458,2012-04-27,2,1,4,14,0,5,1,1,0.46,0.4545,0.33,0.3284,94,1410,206,2060,300,3470
11459,2012-04-27,2,1,4,15,0,5,1,1,0.52,0.5,0.29,0.4925,101,1515,223,2230,324,3745
11460,2012-04-27,2,1,4,16,0,5,1,1,0.52,0.5,0.29,0.2537,105,1575,335,3350,440,4925
11461,2012-04-27,2,1,4,17,0,5,1,1,0.54,0.5152,0.24,0.3881,89,1335,613,6130,702,7465
11462,2012-04-27,2,1,4,18,0,5,1,1,0.52,0.5,0.25,0.3582,94,1410,560,5600,654,7010
11463,2012-04-27,2,1,4,19,0,5,1,1,0.5,0.4848,0.27,0.3881,62,930,379,3790,441,4720
11464,2012-04-27,2,1,4,20,0,5,1,1,0.46,0.4545,0.31,0.2836,49,735,240,2400,289,3135
11465,2012-04-27,2,1,4,21,0,5,1,1,0.44,0.4394,0.33,0.2985,23,345,185,1850,208,2195
11466,2012-04-27,2,1,4,22,0,5,1,1,0.42,0.4242,0.38,0.2537,24,360,134,1340,158,1700
11467,2012-04-27,2,1,4,23,0,5,1,1,0.4,0.4091,0.4,0.2537,11,165,105,1050,116,1215
11468,2012-04-28,2,1,4,0,0,6,0,1,0.38,0.3939,0.43,0.1642,4,60,99,990,103,1050
11469,2012-04-28,2,1,4,1,0,6,0,1,0.36,0.3333,0.5,0.2985,7,105,60,600,67,705
11470,2012-04-28,2,1,4,2,0,6,0,1,0.36,0.3485,0.43,0.1642,8,120,49,490,57,610
11471,2012-04-28,2,1,4,3,0,6,0,1,0.34,0.3182,0.49,0.2239,3,45,23,230,26,275
11472,2012-04-28,2,1,4,4,0,6,0,1,0.34,0.3333,0.49,0.1642,0,0,2,20,2,20
11473,2012-04-28,2,1,4,5,0,6,0,1,0.34,0.3333,0.46,0.1343,2,30,3,30,5,60
11474,2012-04-28,2,1,4,6,0,6,0,1,0.34,0.3333,0.49,0.194,10,150,18,180,28,330
11475,2012-04-28,2,1,4,7,0,6,0,1,0.34,0.3333,0.49,0.1642,10,150,45,450,55,600
11476,2012-04-28,2,1,4,8,0,6,0,1,0.38,0.3939,0.4,0.1343,24,360,134,1340,158,1700
11477,2012-04-28,2,1,4,9,0,6,0,2,0.38,0.3939,0.37,0.0,45,675,169,1690,214,2365
11478,2012-04-28,2,1,4,10,0,6,0,2,0.38,0.3939,0.4,0.1642,60,900,231,2310,291,3210
11479,2012-04-28,2,1,4,11,0,6,0,2,0.38,0.3939,0.4,0.1045,96,1440,262,2620,358,4060
11480,2012-04-28,2,1,4,12,0,6,0,2,0.38,0.3939,0.43,0.0,105,1575,276,2760,381,4335
11481,2012-04-28,2,1,4,13,0,6,0,2,0.4,0.4091,0.37,0.0,120,1800,269,2690,389,4490
11482,2012-04-28,2,1,4,14,0,6,0,1,0.42,0.4242,0.38,0.1045,147,2205,293,2930,440,5135
11483,2012-04-28,2,1,4,15,0,6,0,1,0.42,0.4242,0.41,0.2239,148,2220,260,2600,408,4820
11484,2012-04-28,2,1,4,16,0,6,0,2,0.44,0.4394,0.38,0.194,132,1980,244,2440,376,4420
11485,2012-04-28,2,1,4,17,0,6,0,2,0.42,0.4242,0.41,0.1343,98,1470,224,2240,322,3710
11486,2012-04-28,2,1,4,18,0,6,0,3,0.4,0.4091,0.47,0.0,17,255,73,730,90,985
11487,2012-04-28,2,1,4,19,0,6,0,3,0.36,0.3485,0.71,0.1343,29,435,110,1100,139,1535
11488,2012-04-28,2,1,4,20,0,6,0,2,0.38,0.3939,0.66,0.0,21,315,81,810,102,1125
11489,2012-04-28,2,1,4,21,0,6,0,3,0.36,0.3485,0.71,0.194,12,180,72,720,84,900
11490,2012-04-28,2,1,4,22,0,6,0,2,0.36,0.3485,0.71,0.1343,17,255,66,660,83,915
11491,2012-04-28,2,1,4,23,0,6,0,2,0.38,0.3939,0.76,0.0896,5,75,37,370,42,445
11492,2012-04-29,2,1,4,0,0,0,0,3,0.36,0.3485,0.81,0.1343,0,0,36,360,36,360
11493,2012-04-29,2,1,4,1,0,0,0,2,0.36,0.3485,0.81,0.1343,5,75,37,370,42,445
11494,2012-04-29,2,1,4,2,0,0,0,2,0.36,0.3636,0.87,0.1045,4,60,36,360,40,420
11495,2012-04-29,2,1,4,3,0,0,0,2,0.36,0.3485,0.87,0.194,2,30,14,140,16,170
11496,2012-04-29,2,1,4,4,0,0,0,2,0.36,0.3485,0.87,0.1343,0,0,4,40,4,40
11497,2012-04-29,2,1,4,5,0,0,0,1,0.34,0.3636,0.87,0.0,0,0,6,60,6,60
11498,2012-04-29,2,1,4,6,0,0,0,1,0.34,0.3333,0.87,0.1343,1,15,6,60,7,75
11499,2012-04-29,2,1,4,7,0,0,0,2,0.34,0.3333,0.87,0.1343,7,105,20,200,27,305
11500,2012-04-29,2,1,4,8,0,0,0,1,0.38,0.3939,0.76,0.1343,26,390,81,810,107,1200
11501,2012-04-29,2,1,4,9,0,0,0,1,0.4,0.4091,0.71,0.1343,52,780,133,1330,185,2110
11502,2012-04-29,2,1,4,10,0,0,0,1,0.42,0.4242,0.67,0.0896,127,1905,253,2530,380,4435
11503,2012-04-29,2,1,4,11,0,0,0,1,0.46,0.4545,0.51,0.0,128,1920,283,2830,411,4750
11504,2012-04-29,2,1,4,12,0,0,0,1,0.48,0.4697,0.44,0.1045,223,3345,361,3610,584,6955
11505,2012-04-29,2,1,4,13,0,0,0,1,0.5,0.4848,0.45,0.1045,226,3390,369,3690,595,7080
11506,2012-04-29,2,1,4,14,0,0,0,1,0.54,0.5152,0.34,0.0,281,4215,372,3720,653,7935
11507,2012-04-29,2,1,4,15,0,0,0,1,0.56,0.5303,0.37,0.1343,279,4185,324,3240,603,7425
11508,2012-04-29,2,1,4,16,0,0,0,1,0.6,0.6061,0.28,0.194,240,3600,347,3470,587,7070
11509,2012-04-29,2,1,4,17,0,0,0,1,0.62,0.6061,0.27,0.2985,188,2820,334,3340,522,6160
11510,2012-04-29,2,1,4,18,0,0,0,1,0.6,0.6061,0.26,0.2836,164,2460,323,3230,487,5690
11511,2012-04-29,2,1,4,19,0,0,0,1,0.56,0.5303,0.35,0.1343,128,1920,247,2470,375,4390
11512,2012-04-29,2,1,4,20,0,0,0,1,0.56,0.5303,0.32,0.0896,45,675,198,1980,243,2655
11513,2012-04-29,2,1,4,21,0,0,0,1,0.52,0.5,0.48,0.1343,65,975,139,1390,204,2365
11514,2012-04-29,2,1,4,22,0,0,0,1,0.5,0.4848,0.45,0.0,23,345,85,850,108,1195
11515,2012-04-29,2,1,4,23,0,0,0,1,0.48,0.4697,0.59,0.0,15,225,67,670,82,895
11516,2012-04-30,2,1,4,0,0,1,1,1,0.44,0.4394,0.72,0.1045,12,180,36,360,48,540
11517,2012-04-30,2,1,4,1,0,1,1,1,0.42,0.4242,0.77,0.0896,9,135,15,150,24,285
11518,2012-04-30,2,1,4,2,0,1,1,1,0.42,0.4242,0.71,0.1343,3,45,5,50,8,95
11519,2012-04-30,2,1,4,3,0,1,1,1,0.4,0.4091,0.76,0.1642,0,0,4,40,4,40
11520,2012-04-30,2,1,4,4,0,1,1,1,0.38,0.3939,0.62,0.2537,0,0,2,20,2,20
11521,2012-04-30,2,1,4,5,0,1,1,1,0.38,0.3939,0.62,0.2537,1,15,19,190,20,205
11522,2012-04-30,2,1,4,6,0,1,1,1,0.4,0.4091,0.47,0.194,2,30,121,1210,123,1240
11523,2012-04-30,2,1,4,7,0,1,1,1,0.4,0.4091,0.5,0.194,6,90,343,3430,349,3520
11524,2012-04-30,2,1,4,8,0,1,1,1,0.4,0.4091,0.43,0.194,17,255,579,5790,596,6045
11525,2012-04-30,2,1,4,9,0,1,1,2,0.4,0.4091,0.43,0.194,29,435,239,2390,268,2825
11526,2012-04-30,2,1,4,10,0,1,1,2,0.42,0.4242,0.41,0.1642,41,615,116,1160,157,1775
11527,2012-04-30,2,1,4,11,0,1,1,2,0.44,0.4394,0.44,0.1045,52,780,111,1110,163,1890
11528,2012-04-30,2,1,4,12,0,1,1,2,0.44,0.4394,0.47,0.1343,45,675,180,1800,225,2475
11529,2012-04-30,2,1,4,13,0,1,1,2,0.48,0.4697,0.51,0.0896,48,720,199,1990,247,2710
11530,2012-04-30,2,1,4,14,0,1,1,2,0.5,0.4848,0.55,0.1343,56,840,162,1620,218,2460
11531,2012-04-30,2,1,4,15,0,1,1,2,0.52,0.5,0.55,0.1045,55,825,176,1760,231,2585
11532,2012-04-30,2,1,4,16,0,1,1,1,0.56,0.5303,0.6,0.194,44,660,303,3030,347,3690
11533,2012-04-30,2,1,4,17,0,1,1,1,0.56,0.5303,0.6,0.1642,66,990,617,6170,683,7160
11534,2012-04-30,2,1,4,18,0,1,1,2,0.56,0.5303,0.6,0.2239,53,795,611,6110,664,6905
11535,2012-04-30,2,1,4,19,0,1,1,2,0.54,0.5152,0.64,0.2537,51,765,420,4200,471,4965
11536,2012-04-30,2,1,4,20,0,1,1,2,0.52,0.5,0.59,0.194,28,420,281,2810,309,3230
11537,2012-04-30,2,1,4,21,0,1,1,2,0.52,0.5,0.59,0.194,26,390,195,1950,221,2340
11538,2012-04-30,2,1,4,22,0,1,1,2,0.52,0.5,0.55,0.1642,11,165,123,1230,134,1395
11539,2012-04-30,2,1,4,23,0,1,1,2,0.52,0.5,0.55,0.2239,10,150,50,500,60,650
11540,2012-05-01,2,1,5,0,0,2,1,2,0.5,0.4848,0.59,0.194,7,105,28,280,35,385
11541,2012-05-01,2,1,5,1,0,2,1,2,0.5,0.4848,0.63,0.1343,0,0,21,210,21,210
11542,2012-05-01,2,1,5,2,0,2,1,2,0.5,0.4848,0.72,0.0896,1,15,7,70,8,85
11543,2012-05-01,2,1,5,3,0,2,1,2,0.5,0.4848,0.77,0.0,1,15,2,20,3,35
11544,2012-05-01,2,1,5,4,0,2,1,2,0.52,0.5,0.72,0.0896,1,15,7,70,8,85
11545,2012-05-01,2,1,5,5,0,2,1,2,0.52,0.5,0.72,0.0896,0,0,17,170,17,170
11546,2012-05-01,2,1,5,6,0,2,1,3,0.52,0.5,0.77,0.1045,2,30,24,240,26,270
11547,2012-05-01,2,1,5,7,0,2,1,2,0.5,0.4848,0.94,0.2537,8,120,161,1610,169,1730
11548,2012-05-01,2,1,5,8,0,2,1,2,0.52,0.5,0.94,0.2836,19,285,538,5380,557,5665
11549,2012-05-01,2,1,5,9,0,2,1,2,0.54,0.5152,0.88,0.194,18,270,331,3310,349,3580
11550,2012-05-01,2,1,5,10,0,2,1,1,0.62,0.5909,0.78,0.2537,30,450,144,1440,174,1890
11551,2012-05-01,2,1,5,11,0,2,1,2,0.66,0.6212,0.65,0.2836,50,750,179,1790,229,2540
11552,2012-05-01,2,1,5,12,0,2,1,2,0.7,0.6515,0.58,0.2239,41,615,228,2280,269,2895
11553,2012-05-01,2,1,5,13,0,2,1,2,0.72,0.6667,0.51,0.2239,41,615,208,2080,249,2695
11554,2012-05-01,2,1,5,14,0,2,1,2,0.74,0.6667,0.48,0.2537,37,555,167,1670,204,2225
11555,2012-05-01,2,1,5,15,0,2,1,2,0.74,0.6667,0.45,0.2239,48,720,186,1860,234,2580
11556,2012-05-01,2,1,5,16,0,2,1,1,0.74,0.6667,0.45,0.194,41,615,313,3130,354,3745
11557,2012-05-01,2,1,5,17,0,2,1,1,0.74,0.6667,0.48,0.0896,65,975,616,6160,681,7135
11558,2012-05-01,2,1,5,18,0,2,1,1,0.7,0.6515,0.54,0.1343,81,1215,662,6620,743,7835
11559,2012-05-01,2,1,5,19,0,2,1,1,0.7,0.6515,0.54,0.1343,58,870,429,4290,487,5160
11560,2012-05-01,2,1,5,20,0,2,1,1,0.66,0.6212,0.61,0.1642,36,540,299,2990,335,3530
11561,2012-05-01,2,1,5,21,0,2,1,1,0.64,0.6061,0.65,0.1343,31,465,251,2510,282,2975
11562,2012-05-01,2,1,5,22,0,2,1,1,0.64,0.6061,0.65,0.0,21,315,190,1900,211,2215
11563,2012-05-01,2,1,5,23,0,2,1,1,0.6,0.5758,0.78,0.0,16,240,79,790,95,1030
11564,2012-05-02,2,1,5,0,0,3,1,1,0.6,0.5758,0.78,0.1045,4,60,43,430,47,490
11565,2012-05-02,2,1,5,1,0,3,1,1,0.56,0.5303,0.83,0.0,8,120,7,70,15,190
11566,2012-05-02,2,1,5,2,0,3,1,1,0.56,0.5303,0.83,0.0,7,105,9,90,16,195
11567,2012-05-02,2,1,5,3,0,3,1,1,0.56,0.5303,0.83,0.0896,0,0,6,60,6,60
11568,2012-05-02,2,1,5,4,0,3,1,1,0.54,0.5152,0.88,0.0,2,30,2,20,4,50
11569,2012-05-02,2,1,5,5,0,3,1,1,0.54,0.5152,0.9,0.1343,2,30,31,310,33,340
11570,2012-05-02,2,1,5,6,0,3,1,3,0.56,0.5303,0.84,0.0,3,45,117,1170,120,1215
11571,2012-05-02,2,1,5,7,0,3,1,2,0.54,0.5152,0.88,0.194,14,210,344,3440,358,3650
11572,2012-05-02,2,1,5,8,0,3,1,2,0.56,0.5303,0.88,0.0,26,390,640,6400,666,6790
11573,2012-05-02,2,1,5,9,0,3,1,2,0.56,0.5303,0.88,0.0,26,390,289,2890,315,3280
11574,2012-05-02,2,1,5,10,0,3,1,2,0.58,0.5455,0.83,0.1045,28,420,147,1470,175,1890
11575,2012-05-02,2,1,5,11,0,3,1,2,0.58,0.5455,0.81,0.1343,39,585,145,1450,184,2035
11576,2012-05-02,2,1,5,12,0,3,1,2,0.58,0.5455,0.83,0.2239,35,525,210,2100,245,2625
11577,2012-05-02,2,1,5,13,0,3,1,2,0.58,0.5455,0.78,0.194,49,735,179,1790,228,2525
11578,2012-05-02,2,1,5,14,0,3,1,1,0.62,0.6061,0.69,0.0896,51,765,189,1890,240,2655
11579,2012-05-02,2,1,5,15,0,3,1,1,0.64,0.6061,0.65,0.194,52,780,204,2040,256,2820
11580,2012-05-02,2,1,5,16,0,3,1,1,0.64,0.6061,0.65,0.1642,54,810,313,3130,367,3940
11581,2012-05-02,2,1,5,17,0,3,1,1,0.6,0.5909,0.73,0.2537,70,1050,659,6590,729,7640
11582,2012-05-02,2,1,5,18,0,3,1,1,0.56,0.5303,0.73,0.2239,43,645,770,7700,813,8345
11583,2012-05-02,2,1,5,19,0,3,1,1,0.54,0.5152,0.77,0.2537,43,645,461,4610,504,5255
11584,2012-05-02,2,1,5,20,0,3,1,1,0.52,0.5,0.77,0.2537,42,630,296,2960,338,3590
11585,2012-05-02,2,1,5,21,0,3,1,1,0.52,0.5,0.77,0.2239,21,315,218,2180,239,2495
11586,2012-05-02,2,1,5,22,0,3,1,1,0.5,0.4848,0.82,0.2239,27,405,146,1460,173,1865
11587,2012-05-02,2,1,5,23,0,3,1,2,0.5,0.4848,0.77,0.2537,21,315,77,770,98,1085
11588,2012-05-03,2,1,5,0,0,4,1,2,0.48,0.4697,0.82,0.2239,15,225,75,750,90,975
11589,2012-05-03,2,1,5,1,0,4,1,2,0.46,0.4545,0.88,0.1045,9,135,15,150,24,285
11590,2012-05-03,2,1,5,2,0,4,1,2,0.46,0.4545,0.88,0.1343,4,60,13,130,17,190
11591,2012-05-03,2,1,5,3,0,4,1,2,0.46,0.4545,0.88,0.0,2,30,4,40,6,70
11592,2012-05-03,2,1,5,4,0,4,1,2,0.46,0.4545,0.88,0.2537,0,0,2,20,2,20
11593,2012-05-03,2,1,5,5,0,4,1,2,0.46,0.4545,0.88,0.2537,1,15,20,200,21,215
11594,2012-05-03,2,1,5,6,0,4,1,2,0.46,0.4545,0.88,0.1642,8,120,128,1280,136,1400
11595,2012-05-03,2,1,5,7,0,4,1,3,0.44,0.4394,0.94,0.1045,8,120,376,3760,384,3880
11596,2012-05-03,2,1,5,8,0,4,1,3,0.46,0.4545,0.88,0.194,19,285,608,6080,627,6365
11597,2012-05-03,2,1,5,9,0,4,1,2,0.48,0.4697,0.88,0.1045,25,375,279,2790,304,3165
11598,2012-05-03,2,1,5,10,0,4,1,2,0.52,0.5,0.77,0.0,36,540,132,1320,168,1860
11599,2012-05-03,2,1,5,11,0,4,1,1,0.54,0.5152,0.77,0.0,34,510,167,1670,201,2180
11600,2012-05-03,2,1,5,12,0,4,1,1,0.56,0.5303,0.73,0.1343,64,960,237,2370,301,3330
11601,2012-05-03,2,1,5,13,0,4,1,1,0.6,0.5909,0.69,0.194,48,720,217,2170,265,2890
11602,2012-05-03,2,1,5,14,0,4,1,1,0.64,0.6061,0.65,0.194,33,495,171,1710,204,2205
11603,2012-05-03,2,1,5,15,0,4,1,1,0.66,0.6212,0.61,0.194,63,945,220,2200,283,3145
11604,2012-05-03,2,1,5,16,0,4,1,1,0.68,0.6364,0.57,0.1642,45,675,325,3250,370,3925
11605,2012-05-03,2,1,5,17,0,4,1,1,0.72,0.6667,0.54,0.1343,87,1305,617,6170,704,7475
11606,2012-05-03,2,1,5,18,0,4,1,1,0.72,0.6667,0.58,0.1343,64,960,642,6420,706,7380
11607,2012-05-03,2,1,5,19,0,4,1,1,0.7,0.6515,0.61,0.194,55,825,467,4670,522,5495
11608,2012-05-03,2,1,5,20,0,4,1,1,0.64,0.6061,0.73,0.194,52,780,368,3680,420,4460
11609,2012-05-03,2,1,5,21,0,4,1,1,0.62,0.5909,0.78,0.1343,42,630,257,2570,299,3200
11610,2012-05-03,2,1,5,22,0,4,1,1,0.62,0.5909,0.78,0.0,29,435,217,2170,246,2605
11611,2012-05-03,2,1,5,23,0,4,1,1,0.6,0.5606,0.83,0.0,21,315,100,1000,121,1315
11612,2012-05-04,2,1,5,0,0,5,1,1,0.6,0.5758,0.78,0.3284,19,285,70,700,89,985
11613,2012-05-04,2,1,5,1,0,5,1,1,0.6,0.5758,0.78,0.1045,15,225,33,330,48,555
11614,2012-05-04,2,1,5,2,0,5,1,1,0.58,0.5455,0.83,0.1343,0,0,11,110,11,110
11615,2012-05-04,2,1,5,3,0,5,1,1,0.56,0.5303,0.88,0.2239,0,0,14,140,14,140
11616,2012-05-04,2,1,5,4,0,5,1,1,0.56,0.5303,0.88,0.194,0,0,4,40,4,40
11617,2012-05-04,2,1,5,5,0,5,1,1,0.56,0.5303,0.88,0.194,0,0,24,240,24,240
11618,2012-05-04,2,1,5,6,0,5,1,1,0.54,0.5152,0.94,0.1045,8,120,127,1270,135,1390
11619,2012-05-04,2,1,5,7,0,5,1,1,0.56,0.5303,0.88,0.0,9,135,347,3470,356,3605
11620,2012-05-04,2,1,5,8,0,5,1,1,0.56,0.5303,0.88,0.0,34,510,584,5840,618,6350
11621,2012-05-04,2,1,5,9,0,5,1,1,0.6,0.5758,0.78,0.0,32,480,262,2620,294,3100
11622,2012-05-04,2,1,5,10,0,5,1,2,0.62,0.5909,0.73,0.1343,45,675,154,1540,199,2215
11623,2012-05-04,2,1,5,11,0,5,1,2,0.7,0.6515,0.61,0.0,77,1155,181,1810,258,2965
11624,2012-05-04,2,1,5,12,0,5,1,3,0.62,0.5909,0.78,0.3582,46,690,125,1250,171,1940
11625,2012-05-04,2,1,5,13,0,5,1,2,0.64,0.6061,0.73,0.0,71,1065,207,2070,278,3135
11626,2012-05-04,2,1,5,14,0,5,1,2,0.66,0.6212,0.74,0.2836,83,1245,159,1590,242,2835
11627,2012-05-04,2,1,5,15,0,5,1,2,0.72,0.6818,0.62,0.1045,103,1545,240,2400,343,3945
11628,2012-05-04,2,1,5,16,0,5,1,1,0.76,0.6818,0.48,0.1642,82,1230,358,3580,440,4810
11629,2012-05-04,2,1,5,17,0,5,1,1,0.7,0.6515,0.54,0.4627,96,1440,547,5470,643,6910
11630,2012-05-04,2,1,5,18,0,5,1,1,0.7,0.6515,0.54,0.4627,77,1155,564,5640,641,6795
11631,2012-05-04,2,1,5,19,0,5,1,1,0.7,0.6515,0.51,0.1343,64,960,388,3880,452,4840
11632,2012-05-04,2,1,5,20,0,5,1,1,0.68,0.6364,0.51,0.1045,58,870,255,2550,313,3420
11633,2012-05-04,2,1,5,21,0,5,1,1,0.64,0.6061,0.69,0.194,49,735,186,1860,235,2595
11634,2012-05-04,2,1,5,22,0,5,1,1,0.6,0.5606,0.83,0.1343,50,750,182,1820,232,2570
11635,2012-05-04,2,1,5,23,0,5,1,1,0.6,0.5606,0.83,0.0896,51,765,205,2050,256,2815
11636,2012-05-05,2,1,5,0,0,6,0,1,0.6,0.5606,0.83,0.0,42,630,111,1110,153,1740
11637,2012-05-05,2,1,5,1,0,6,0,1,0.6,0.5606,0.83,0.0,28,420,79,790,107,1210
11638,2012-05-05,2,1,5,2,0,6,0,1,0.58,0.5455,0.88,0.0,24,360,51,510,75,870
11639,2012-05-05,2,1,5,3,0,6,0,1,0.58,0.5455,0.83,0.0,11,165,21,210,32,375
11640,2012-05-05,2,1,5,4,0,6,0,1,0.56,0.5303,0.88,0.1045,0,0,9,90,9,90
11641,2012-05-05,2,1,5,5,0,6,0,1,0.56,0.5303,0.88,0.0896,8,120,14,140,22,260
11642,2012-05-05,2,1,5,6,0,6,0,2,0.54,0.5152,0.94,0.0,9,135,33,330,42,465
11643,2012-05-05,2,1,5,7,0,6,0,1,0.56,0.5303,0.88,0.0,8,120,79,790,87,910
11644,2012-05-05,2,1,5,8,0,6,0,1,0.58,0.5455,0.83,0.0896,42,630,155,1550,197,2180
11645,2012-05-05,2,1,5,9,0,6,0,1,0.62,0.5909,0.78,0.1045,61,915,223,2230,284,3145
11646,2012-05-05,2,1,5,10,0,6,0,1,0.66,0.6212,0.65,0.1343,148,2220,284,2840,432,5060
11647,2012-05-05,2,1,5,11,0,6,0,1,0.7,0.6515,0.58,0.0896,221,3315,354,3540,575,6855
11648,2012-05-05,2,1,5,12,0,6,0,1,0.72,0.6667,0.58,0.1045,220,3300,330,3300,550,6600
11649,2012-05-05,2,1,5,13,0,6,0,1,0.74,0.6818,0.55,0.1343,217,3255,307,3070,524,6325
11650,2012-05-05,2,1,5,14,0,6,0,3,0.7,0.6515,0.61,0.2985,187,2805,241,2410,428,5215
11651,2012-05-05,2,1,5,15,0,6,0,3,0.66,0.6212,0.74,0.194,241,3615,300,3000,541,6615
11652,2012-05-05,2,1,5,16,0,6,0,2,0.68,0.6364,0.65,0.3881,230,3450,310,3100,540,6550
11653,2012-05-05,2,1,5,17,0,6,0,2,0.68,0.6364,0.65,0.2985,204,3060,298,2980,502,6040
11654,2012-05-05,2,1,5,18,0,6,0,2,0.66,0.6212,0.69,0.3582,156,2340,278,2780,434,5120
11655,2012-05-05,2,1,5,19,0,6,0,2,0.62,0.5909,0.73,0.3284,151,2265,254,2540,405,4805
11656,2012-05-05,2,1,5,20,0,6,0,1,0.6,0.5758,0.78,0.2537,100,1500,209,2090,309,3590
11657,2012-05-05,2,1,5,21,0,6,0,2,0.58,0.5455,0.78,0.2239,86,1290,183,1830,269,3120
11658,2012-05-05,2,1,5,22,0,6,0,2,0.58,0.5455,0.78,0.194,67,1005,150,1500,217,2505
11659,2012-05-05,2,1,5,23,0,6,0,2,0.56,0.5303,0.83,0.2836,35,525,114,1140,149,1665
11660,2012-05-06,2,1,5,0,0,0,0,2,0.56,0.5303,0.83,0.1343,23,345,111,1110,134,1455
11661,2012-05-06,2,1,5,1,0,0,0,2,0.54,0.5152,0.83,0.2239,37,555,84,840,121,1395
11662,2012-05-06,2,1,5,2,0,0,0,2,0.54,0.5152,0.83,0.2836,29,435,64,640,93,1075
11663,2012-05-06,2,1,5,3,0,0,0,2,0.54,0.5152,0.83,0.194,9,135,19,190,28,325
11664,2012-05-06,2,1,5,4,0,0,0,3,0.52,0.5,0.83,0.1642,9,135,7,70,16,205
11665,2012-05-06,2,1,5,5,0,0,0,3,0.52,0.5,0.83,0.1642,1,15,10,100,11,115
11666,2012-05-06,2,1,5,6,0,0,0,3,0.52,0.5,0.83,0.2239,3,45,14,140,17,185
11667,2012-05-06,2,1,5,7,0,0,0,3,0.52,0.5,0.83,0.1642,5,75,31,310,36,385
11668,2012-05-06,2,1,5,8,0,0,0,2,0.5,0.4848,0.88,0.1343,23,345,91,910,114,1255
11669,2012-05-06,2,1,5,9,0,0,0,2,0.52,0.5,0.83,0.1642,63,945,128,1280,191,2225
11670,2012-05-06,2,1,5,10,0,0,0,2,0.54,0.5152,0.77,0.1045,112,1680,221,2210,333,3890
11671,2012-05-06,2,1,5,11,0,0,0,1,0.56,0.5303,0.73,0.1045,144,2160,270,2700,414,4860
11672,2012-05-06,2,1,5,12,0,0,0,2,0.6,0.6061,0.64,0.0896,207,3105,351,3510,558,6615
11673,2012-05-06,2,1,5,13,0,0,0,2,0.6,0.6061,0.64,0.0,197,2955,368,3680,565,6635
11674,2012-05-06,2,1,5,14,0,0,0,2,0.6,0.6061,0.64,0.1045,226,3390,292,2920,518,6310
11675,2012-05-06,2,1,5,15,0,0,0,2,0.62,0.6061,0.61,0.1045,229,3435,342,3420,571,6855
11676,2012-05-06,2,1,5,16,0,0,0,2,0.62,0.6061,0.61,0.0,181,2715,363,3630,544,6345
11677,2012-05-06,2,1,5,17,0,0,0,2,0.62,0.6061,0.65,0.1343,195,2925,316,3160,511,6085
11678,2012-05-06,2,1,5,18,0,0,0,2,0.62,0.6061,0.61,0.194,131,1965,332,3320,463,5285
11679,2012-05-06,2,1,5,19,0,0,0,2,0.6,0.6061,0.64,0.1642,117,1755,266,2660,383,4415
11680,2012-05-06,2,1,5,20,0,0,0,1,0.6,0.6061,0.64,0.194,73,1095,203,2030,276,3125
11681,2012-05-06,2,1,5,21,0,0,0,1,0.56,0.5303,0.73,0.194,55,825,148,1480,203,2305
11682,2012-05-06,2,1,5,22,0,0,0,1,0.56,0.5303,0.73,0.1642,44,660,113,1130,157,1790
11683,2012-05-06,2,1,5,23,0,0,0,1,0.52,0.5,0.77,0.194,22,330,80,800,102,1130
11684,2012-05-07,2,1,5,0,0,1,1,2,0.52,0.5,0.77,0.1343,13,195,21,210,34,405
11685,2012-05-07,2,1,5,1,0,1,1,2,0.52,0.5,0.77,0.194,1,15,8,80,9,95
11686,2012-05-07,2,1,5,2,0,1,1,1,0.5,0.4848,0.77,0.194,1,15,5,50,6,65
11687,2012-05-07,2,1,5,3,0,1,1,1,0.5,0.4848,0.77,0.194,2,30,3,30,5,60
11688,2012-05-07,2,1,5,4,0,1,1,2,0.46,0.4545,0.88,0.1343,0,0,2,20,2,20
11689,2012-05-07,2,1,5,5,0,1,1,1,0.46,0.4545,0.88,0.1045,2,30,21,210,23,240
11690,2012-05-07,2,1,5,6,0,1,1,1,0.46,0.4545,0.88,0.1045,8,120,134,1340,142,1460
11691,2012-05-07,2,1,5,7,0,1,1,2,0.48,0.4697,0.82,0.1045,18,270,367,3670,385,3940
11692,2012-05-07,2,1,5,8,0,1,1,2,0.5,0.4848,0.82,0.194,31,465,608,6080,639,6545
11693,2012-05-07,2,1,5,9,0,1,1,2,0.5,0.4848,0.82,0.2239,61,915,289,2890,350,3805
11694,2012-05-07,2,1,5,10,0,1,1,2,0.52,0.5,0.77,0.194,62,930,128,1280,190,2210
11695,2012-05-07,2,1,5,11,0,1,1,2,0.54,0.5152,0.73,0.194,64,960,149,1490,213,2450
11696,2012-05-07,2,1,5,12,0,1,1,2,0.56,0.5303,0.68,0.2239,74,1110,189,1890,263,3000
11697,2012-05-07,2,1,5,13,0,1,1,2,0.6,0.6212,0.53,0.3284,75,1125,197,1970,272,3095
11698,2012-05-07,2,1,5,14,0,1,1,2,0.62,0.6212,0.5,0.3582,59,885,180,1800,239,2685
11699,2012-05-07,2,1,5,15,0,1,1,2,0.62,0.6212,0.53,0.2985,76,1140,186,1860,262,3000
11700,2012-05-07,2,1,5,16,0,1,1,2,0.6,0.6212,0.53,0.3881,68,1020,320,3200,388,4220
11701,2012-05-07,2,1,5,17,0,1,1,2,0.6,0.6212,0.53,0.3284,102,1530,667,6670,769,8200
11702,2012-05-07,2,1,5,18,0,1,1,2,0.6,0.6212,0.53,0.3582,78,1170,602,6020,680,7190
11703,2012-05-07,2,1,5,19,0,1,1,1,0.58,0.5455,0.56,0.3284,83,1245,463,4630,546,5875
11704,2012-05-07,2,1,5,20,0,1,1,1,0.54,0.5152,0.52,0.2836,46,690,277,2770,323,3460
11705,2012-05-07,2,1,5,21,0,1,1,2,0.54,0.5152,0.45,0.2239,37,555,210,2100,247,2655
11706,2012-05-07,2,1,5,22,0,1,1,2,0.54,0.5152,0.45,0.2537,26,390,147,1470,173,1860
11707,2012-05-07,2,1,5,23,0,1,1,2,0.54,0.5152,0.45,0.194,21,315,92,920,113,1235
11708,2012-05-08,2,1,5,0,0,2,1,2,0.52,0.5,0.52,0.2537,10,150,28,280,38,430
11709,2012-05-08,2,1,5,1,0,2,1,2,0.52,0.5,0.59,0.2239,6,90,3,30,9,120
11710,2012-05-08,2,1,5,2,0,2,1,2,0.52,0.5,0.63,0.2985,9,135,7,70,16,205
11711,2012-05-08,2,1,5,3,0,2,1,2,0.52,0.5,0.68,0.2836,2,30,4,40,6,70
11712,2012-05-08,2,1,5,4,0,2,1,2,0.52,0.5,0.68,0.3284,0,0,5,50,5,50
11713,2012-05-08,2,1,5,5,0,2,1,2,0.52,0.5,0.72,0.2836,0,0,20,200,20,200
11714,2012-05-08,2,1,5,6,0,2,1,1,0.5,0.4848,0.77,0.2985,7,105,158,1580,165,1685
11715,2012-05-08,2,1,5,7,0,2,1,1,0.52,0.5,0.72,0.2836,21,315,442,4420,463,4735
11716,2012-05-08,2,1,5,8,0,2,1,2,0.54,0.5152,0.73,0.2985,36,540,605,6050,641,6590
11717,2012-05-08,2,1,5,9,0,2,1,2,0.56,0.5303,0.68,0.3582,37,555,258,2580,295,3135
11718,2012-05-08,2,1,5,10,0,2,1,2,0.58,0.5455,0.68,0.4179,46,690,111,1110,157,1800
11719,2012-05-08,2,1,5,11,0,2,1,2,0.6,0.6061,0.64,0.3881,60,900,157,1570,217,2470
11720,2012-05-08,2,1,5,12,0,2,1,2,0.62,0.6061,0.65,0.3284,60,900,203,2030,263,2930
11721,2012-05-08,2,1,5,13,0,2,1,3,0.64,0.6061,0.65,0.2537,53,795,166,1660,219,2455
11722,2012-05-08,2,1,5,14,0,2,1,3,0.62,0.6061,0.69,0.3284,8,120,63,630,71,750
11723,2012-05-08,2,1,5,15,0,2,1,3,0.62,0.5909,0.73,0.2537,40,600,94,940,134,1540
11724,2012-05-08,2,1,5,16,0,2,1,3,0.64,0.6061,0.73,0.2239,54,810,335,3350,389,4160
11725,2012-05-08,2,1,5,17,0,2,1,2,0.64,0.6061,0.69,0.2836,77,1155,640,6400,717,7555
11726,2012-05-08,2,1,5,18,0,2,1,2,0.64,0.6061,0.69,0.2836,69,1035,641,6410,710,7445
11727,2012-05-08,2,1,5,19,0,2,1,2,0.64,0.6061,0.69,0.2836,59,885,399,3990,458,4875
11728,2012-05-08,2,1,5,20,0,2,1,2,0.64,0.6061,0.69,0.2836,40,600,262,2620,302,3220
11729,2012-05-08,2,1,5,21,0,2,1,2,0.64,0.6061,0.65,0.2836,21,315,202,2020,223,2335
11730,2012-05-08,2,1,5,22,0,2,1,3,0.6,0.5758,0.78,0.2537,13,195,134,1340,147,1535
11731,2012-05-08,2,1,5,23,0,2,1,3,0.6,0.5758,0.78,0.3284,10,150,53,530,63,680
11732,2012-05-09,2,1,5,0,0,3,1,2,0.58,0.5455,0.83,0.194,8,120,27,270,35,390
11733,2012-05-09,2,1,5,1,0,3,1,2,0.6,0.5758,0.78,0.2537,3,45,11,110,14,155
11734,2012-05-09,2,1,5,2,0,3,1,3,0.56,0.5303,0.88,0.4478,0,0,1,10,1,10
11735,2012-05-09,2,1,5,3,0,3,1,3,0.56,0.5303,0.88,0.1642,0,0,2,20,2,20
11736,2012-05-09,2,1,5,4,0,3,1,3,0.56,0.5303,0.88,0.2239,0,0,5,50,5,50
11737,2012-05-09,2,1,5,5,0,3,1,2,0.56,0.5303,0.88,0.1343,1,15,27,270,28,285
11738,2012-05-09,2,1,5,6,0,3,1,2,0.56,0.5303,0.88,0.1045,5,75,121,1210,126,1285
11739,2012-05-09,2,1,5,7,0,3,1,2,0.56,0.5303,0.94,0.194,17,255,401,4010,418,4265
11740,2012-05-09,2,1,5,8,0,3,1,2,0.6,0.5606,0.83,0.1343,28,420,594,5940,622,6360
11741,2012-05-09,2,1,5,9,0,3,1,2,0.6,0.5606,0.83,0.0,40,600,285,2850,325,3450
11742,2012-05-09,2,1,5,10,0,3,1,2,0.62,0.6061,0.65,0.2537,40,600,113,1130,153,1730
11743,2012-05-09,2,1,5,11,0,3,1,2,0.62,0.6212,0.59,0.2985,45,675,156,1560,201,2235
11744,2012-05-09,2,1,5,12,0,3,1,2,0.62,0.6212,0.57,0.2239,58,870,222,2220,280,3090
11745,2012-05-09,2,1,5,13,0,3,1,2,0.64,0.6212,0.53,0.2537,50,750,216,2160,266,2910
11746,2012-05-09,2,1,5,14,0,3,1,2,0.64,0.6212,0.53,0.2537,68,1020,175,1750,243,2770
11747,2012-05-09,2,1,5,15,0,3,1,2,0.64,0.6212,0.53,0.1045,68,1020,191,1910,259,2930
11748,2012-05-09,2,1,5,16,0,3,1,2,0.66,0.6212,0.5,0.194,68,1020,289,2890,357,3910
11749,2012-05-09,2,1,5,17,0,3,1,2,0.64,0.6212,0.53,0.1343,76,1140,629,6290,705,7430
11750,2012-05-09,2,1,5,18,0,3,1,3,0.52,0.5,0.77,0.5821,23,345,349,3490,372,3835
11751,2012-05-09,2,1,5,19,0,3,1,3,0.5,0.4848,0.77,0.3582,2,30,96,960,98,990
11752,2012-05-09,2,1,5,20,0,3,1,3,0.5,0.4848,0.82,0.2239,3,45,48,480,51,525
11753,2012-05-09,2,1,5,21,0,3,1,3,0.5,0.4848,0.82,0.1642,4,60,30,300,34,360
11754,2012-05-09,2,1,5,22,0,3,1,3,0.48,0.4697,0.82,0.1045,5,75,62,620,67,695
11755,2012-05-09,2,1,5,23,0,3,1,3,0.48,0.4697,0.82,0.194,8,120,47,470,55,590
11756,2012-05-10,2,1,5,0,0,4,1,3,0.5,0.4848,0.77,0.1642,2,30,31,310,33,340
11757,2012-05-10,2,1,5,1,0,4,1,2,0.48,0.4697,0.88,0.1343,2,30,9,90,11,120
11758,2012-05-10,2,1,5,2,0,4,1,2,0.48,0.4697,0.88,0.1045,0,0,3,30,3,30
11759,2012-05-10,2,1,5,3,0,4,1,1,0.46,0.4545,0.88,0.2239,0,0,3,30,3,30
11760,2012-05-10,2,1,5,4,0,4,1,1,0.46,0.4545,0.77,0.194,0,0,2,20,2,20
11761,2012-05-10,2,1,5,5,0,4,1,1,0.46,0.4545,0.72,0.2985,1,15,23,230,24,245
11762,2012-05-10,2,1,5,6,0,4,1,1,0.44,0.4394,0.72,0.2239,9,135,130,1300,139,1435
11763,2012-05-10,2,1,5,7,0,4,1,1,0.44,0.4394,0.72,0.2985,8,120,393,3930,401,4050
11764,2012-05-10,2,1,5,8,0,4,1,1,0.46,0.4545,0.67,0.3582,27,405,603,6030,630,6435
11765,2012-05-10,2,1,5,9,0,4,1,1,0.5,0.4848,0.59,0.4627,62,930,299,2990,361,3920
11766,2012-05-10,2,1,5,10,0,4,1,1,0.5,0.4848,0.51,0.4179,42,630,112,1120,154,1750
11767,2012-05-10,2,1,5,11,0,4,1,1,0.52,0.5,0.48,0.5224,77,1155,179,1790,256,2945
11768,2012-05-10,2,1,5,12,0,4,1,1,0.52,0.5,0.48,0.4179,65,975,207,2070,272,3045
11769,2012-05-10,2,1,5,13,0,4,1,1,0.54,0.5152,0.39,0.4478,90,1350,228,2280,318,3630
11770,2012-05-10,2,1,5,14,0,4,1,1,0.56,0.5303,0.37,0.4179,61,915,186,1860,247,2775
11771,2012-05-10,2,1,5,15,0,4,1,1,0.54,0.5152,0.37,0.3881,79,1185,192,1920,271,3105
11772,2012-05-10,2,1,5,16,0,4,1,1,0.58,0.5455,0.3,0.4627,87,1305,334,3340,421,4645
11773,2012-05-10,2,1,5,17,0,4,1,1,0.6,0.6212,0.31,0.3881,84,1260,648,6480,732,7740
11774,2012-05-10,2,1,5,18,0,4,1,1,0.56,0.5303,0.35,0.5224,109,1635,661,6610,770,8245
11775,2012-05-10,2,1,5,19,0,4,1,1,0.54,0.5152,0.37,0.3582,84,1260,469,4690,553,5950
11776,2012-05-10,2,1,5,20,0,4,1,1,0.52,0.5,0.4,0.3284,59,885,315,3150,374,4035
11777,2012-05-10,2,1,5,21,0,4,1,1,0.5,0.4848,0.42,0.194,19,285,211,2110,230,2395
11778,2012-05-10,2,1,5,22,0,4,1,1,0.5,0.4848,0.42,0.1045,36,540,196,1960,232,2500
11779,2012-05-10,2,1,5,23,0,4,1,1,0.48,0.4697,0.48,0.1045,23,345,112,1120,135,1465
11780,2012-05-11,2,1,5,0,0,5,1,1,0.46,0.4545,0.55,0.1045,17,255,47,470,64,725
11781,2012-05-11,2,1,5,1,0,5,1,1,0.46,0.4545,0.51,0.1343,14,210,32,320,46,530
11782,2012-05-11,2,1,5,2,0,5,1,1,0.46,0.4545,0.44,0.1642,15,225,16,160,31,385
11783,2012-05-11,2,1,5,3,0,5,1,1,0.46,0.4545,0.41,0.2836,5,75,8,80,13,155
11784,2012-05-11,2,1,5,4,0,5,1,1,0.42,0.4242,0.5,0.194,3,45,6,60,9,105
11785,2012-05-11,2,1,5,5,0,5,1,1,0.42,0.4242,0.47,0.1642,3,45,23,230,26,275
11786,2012-05-11,2,1,5,6,0,5,1,1,0.42,0.4242,0.5,0.2537,7,105,128,1280,135,1385
11787,2012-05-11,2,1,5,7,0,5,1,1,0.42,0.4242,0.5,0.2537,6,90,345,3450,351,3540
11788,2012-05-11,2,1,5,8,0,5,1,1,0.46,0.4545,0.44,0.2537,41,615,579,5790,620,6405
11789,2012-05-11,2,1,5,9,0,5,1,1,0.48,0.4697,0.41,0.2985,34,510,288,2880,322,3390
11790,2012-05-11,2,1,5,10,0,5,1,1,0.52,0.5,0.36,0.3284,69,1035,141,1410,210,2445
11791,2012-05-11,2,1,5,11,0,5,1,1,0.56,0.5303,0.35,0.2537,88,1320,203,2030,291,3350
11792,2012-05-11,2,1,5,12,0,5,1,1,0.56,0.5303,0.28,0.4179,89,1335,259,2590,348,3925
11793,2012-05-11,2,1,5,13,0,5,1,1,0.6,0.6061,0.26,0.3881,100,1500,263,2630,363,4130
11794,2012-05-11,2,1,5,14,0,5,1,1,0.62,0.6061,0.23,0.2239,116,1740,218,2180,334,3920
11795,2012-05-11,2,1,5,15,0,5,1,1,0.62,0.6061,0.25,0.194,140,2100,299,2990,439,5090
11796,2012-05-11,2,1,5,16,0,5,1,1,0.62,0.6061,0.25,0.3284,128,1920,397,3970,525,5890
11797,2012-05-11,2,1,5,17,0,5,1,1,0.64,0.6061,0.23,0.2537,102,1530,677,6770,779,8300
11798,2012-05-11,2,1,5,18,0,5,1,1,0.64,0.6061,0.23,0.2836,78,1170,518,5180,596,6350
11799,2012-05-11,2,1,5,19,0,5,1,1,0.64,0.6061,0.23,0.2537,73,1095,430,4300,503,5395
11800,2012-05-11,2,1,5,20,0,5,1,1,0.62,0.6061,0.25,0.1343,64,960,277,2770,341,3730
11801,2012-05-11,2,1,5,21,0,5,1,1,0.6,0.6061,0.28,0.1045,45,675,225,2250,270,2925
11802,2012-05-11,2,1,5,22,0,5,1,1,0.56,0.5303,0.35,0.2239,44,660,190,1900,234,2560
11803,2012-05-11,2,1,5,23,0,5,1,1,0.54,0.5152,0.37,0.194,38,570,142,1420,180,1990
11804,2012-05-12,2,1,5,0,0,6,0,1,0.52,0.5,0.42,0.1642,25,375,111,1110,136,1485
11805,2012-05-12,2,1,5,1,0,6,0,1,0.5,0.4848,0.48,0.0,14,210,79,790,93,1000
11806,2012-05-12,2,1,5,2,0,6,0,1,0.46,0.4545,0.59,0.1343,10,150,46,460,56,610
11807,2012-05-12,2,1,5,3,0,6,0,1,0.48,0.4697,0.59,0.0,14,210,20,200,34,410
11808,2012-05-12,2,1,5,4,0,6,0,1,0.44,0.4394,0.67,0.1045,3,45,6,60,9,105
11809,2012-05-12,2,1,5,5,0,6,0,1,0.42,0.4242,0.67,0.1343,5,75,8,80,13,155
11810,2012-05-12,2,1,5,6,0,6,0,1,0.42,0.4242,0.67,0.0896,10,150,23,230,33,380
11811,2012-05-12,2,1,5,7,0,6,0,1,0.42,0.4242,0.71,0.1343,10,150,57,570,67,720
11812,2012-05-12,2,1,5,8,0,6,0,1,0.52,0.5,0.48,0.0,22,330,156,1560,178,1890
11813,2012-05-12,2,1,5,9,0,6,0,1,0.54,0.5152,0.49,0.0,87,1305,248,2480,335,3785
11814,2012-05-12,2,1,5,10,0,6,0,1,0.56,0.5303,0.49,0.0896,132,1980,279,2790,411,4770
11815,2012-05-12,2,1,5,11,0,6,0,1,0.62,0.6212,0.41,0.0896,157,2355,365,3650,522,6005
11816,2012-05-12,2,1,5,12,0,6,0,1,0.64,0.6212,0.36,0.1642,206,3090,353,3530,559,6620
11817,2012-05-12,2,1,5,13,0,6,0,1,0.64,0.6212,0.36,0.194,293,4395,366,3660,659,8055
11818,2012-05-12,2,1,5,14,0,6,0,1,0.66,0.6212,0.36,0.194,257,3855,358,3580,615,7435
11819,2012-05-12,2,1,5,15,0,6,0,1,0.68,0.6212,0.24,0.194,269,4035,321,3210,590,7245
11820,2012-05-12,2,1,5,16,0,6,0,2,0.7,0.6364,0.21,0.194,254,3810,337,3370,591,7180
11821,2012-05-12,2,1,5,17,0,6,0,2,0.66,0.6212,0.36,0.194,233,3495,343,3430,576,6925
11822,2012-05-12,2,1,5,18,0,6,0,2,0.66,0.6212,0.31,0.194,164,2460,382,3820,546,6280
11823,2012-05-12,2,1,5,19,0,6,0,2,0.64,0.6212,0.36,0.1642,166,2490,273,2730,439,5220
11824,2012-05-12,2,1,5,20,0,6,0,1,0.62,0.6212,0.46,0.1642,113,1695,174,1740,287,3435
11825,2012-05-12,2,1,5,21,0,6,0,2,0.6,0.6061,0.6,0.1343,74,1110,156,1560,230,2670
11826,2012-05-12,2,1,5,22,0,6,0,1,0.56,0.5303,0.68,0.1343,62,930,212,2120,274,3050
11827,2012-05-12,2,1,5,23,0,6,0,1,0.58,0.5455,0.56,0.0896,42,630,134,1340,176,1970
11828,2012-05-13,2,1,5,0,0,0,0,1,0.56,0.5303,0.64,0.1642,19,285,79,790,98,1075
11829,2012-05-13,2,1,5,1,0,0,0,2,0.54,0.5152,0.68,0.1343,22,330,72,720,94,1050
11830,2012-05-13,2,1,5,2,0,0,0,2,0.54,0.5152,0.68,0.1642,22,330,60,600,82,930
11831,2012-05-13,2,1,5,3,0,0,0,2,0.54,0.5152,0.64,0.1343,2,30,26,260,28,290
11832,2012-05-13,2,1,5,4,0,0,0,2,0.54,0.5152,0.68,0.194,2,30,7,70,9,100
11833,2012-05-13,2,1,5,5,0,0,0,1,0.52,0.5,0.72,0.194,4,60,8,80,12,140
11834,2012-05-13,2,1,5,6,0,0,0,1,0.52,0.5,0.68,0.1642,6,90,15,150,21,240
11835,2012-05-13,2,1,5,7,0,0,0,1,0.52,0.5,0.68,0.1642,18,270,42,420,60,690
11836,2012-05-13,2,1,5,8,0,0,0,1,0.56,0.5303,0.64,0.1642,32,480,124,1240,156,1720
11837,2012-05-13,2,1,5,9,0,0,0,1,0.6,0.6212,0.56,0.1343,79,1185,143,1430,222,2615
11838,2012-05-13,2,1,5,10,0,0,0,1,0.6,0.6061,0.6,0.2537,128,1920,222,2220,350,4140
11839,2012-05-13,2,1,5,11,0,0,0,1,0.62,0.6212,0.57,0.2537,150,2250,278,2780,428,5030
11840,2012-05-13,2,1,5,12,0,0,0,1,0.64,0.6212,0.57,0.2239,189,2835,342,3420,531,6255
11841,2012-05-13,2,1,5,13,0,0,0,1,0.68,0.6364,0.54,0.2537,255,3825,347,3470,602,7295
11842,2012-05-13,2,1,5,14,0,0,0,1,0.7,0.6515,0.48,0.1343,228,3420,324,3240,552,6660
11843,2012-05-13,2,1,5,15,0,0,0,1,0.72,0.6515,0.45,0.3582,190,2850,309,3090,499,5940
11844,2012-05-13,2,1,5,16,0,0,0,1,0.72,0.6515,0.42,0.2537,225,3375,339,3390,564,6765
11845,2012-05-13,2,1,5,17,0,0,0,1,0.7,0.6364,0.45,0.4179,191,2865,287,2870,478,5735
11846,2012-05-13,2,1,5,18,0,0,0,2,0.68,0.6364,0.44,0.3582,129,1935,260,2600,389,4535
11847,2012-05-13,2,1,5,19,0,0,0,2,0.66,0.6212,0.5,0.4179,107,1605,232,2320,339,3925
11848,2012-05-13,2,1,5,20,0,0,0,2,0.66,0.6212,0.5,0.2836,67,1005,163,1630,230,2635
11849,2012-05-13,2,1,5,21,0,0,0,2,0.64,0.6212,0.53,0.194,48,720,121,1210,169,1930
11850,2012-05-13,2,1,5,22,0,0,0,2,0.62,0.6061,0.61,0.1642,42,630,89,890,131,1520
11851,2012-05-13,2,1,5,23,0,0,0,2,0.62,0.6212,0.57,0.2239,17,255,57,570,74,825
11852,2012-05-14,2,1,5,0,0,1,1,2,0.6,0.6212,0.56,0.2537,21,315,14,140,35,455
11853,2012-05-14,2,1,5,1,0,1,1,2,0.6,0.6061,0.6,0.2836,5,75,6,60,11,135
11854,2012-05-14,2,1,5,2,0,1,1,1,0.6,0.6061,0.6,0.2985,1,15,1,10,2,25
11855,2012-05-14,2,1,5,3,0,1,1,2,0.58,0.5455,0.68,0.3284,0,0,2,20,2,20
11856,2012-05-14,2,1,5,4,0,1,1,2,0.54,0.5152,0.77,0.2239,3,45,3,30,6,75
11857,2012-05-14,2,1,5,5,0,1,1,2,0.54,0.5152,0.77,0.1642,1,15,25,250,26,265
11858,2012-05-14,2,1,5,6,0,1,1,3,0.52,0.5,0.94,0.2985,3,45,62,620,65,665
11859,2012-05-14,2,1,5,7,0,1,1,3,0.52,0.5,0.94,0.194,3,45,72,720,75,765
11860,2012-05-14,2,1,5,8,0,1,1,3,0.54,0.5152,0.88,0.2239,1,15,155,1550,156,1565
11861,2012-05-14,2,1,5,9,0,1,1,3,0.54,0.5152,0.88,0.2836,5,75,105,1050,110,1125
11862,2012-05-14,2,1,5,10,0,1,1,3,0.54,0.5152,0.88,0.2537,6,90,53,530,59,620
11863,2012-05-14,2,1,5,11,0,1,1,2,0.56,0.5303,0.83,0.2239,12,180,67,670,79,850
11864,2012-05-14,2,1,5,12,0,1,1,2,0.56,0.5303,0.88,0.2836,53,795,132,1320,185,2115
11865,2012-05-14,2,1,5,13,0,1,1,2,0.62,0.5909,0.73,0.2239,33,495,143,1430,176,1925
11866,2012-05-14,2,1,5,14,0,1,1,2,0.62,0.5909,0.73,0.2537,43,645,128,1280,171,1925
11867,2012-05-14,2,1,5,15,0,1,1,2,0.62,0.5909,0.73,0.1642,40,600,156,1560,196,2160
11868,2012-05-14,2,1,5,16,0,1,1,3,0.62,0.6061,0.69,0.2836,20,300,91,910,111,1210
11869,2012-05-14,2,1,5,17,0,1,1,3,0.56,0.5303,0.88,0.2537,25,375,204,2040,229,2415
11870,2012-05-14,2,1,5,18,0,1,1,2,0.58,0.5455,0.83,0.0,17,255,283,2830,300,3085
11871,2012-05-14,2,1,5,19,0,1,1,3,0.58,0.5455,0.88,0.1343,10,150,294,2940,304,3090
11872,2012-05-14,2,1,5,20,0,1,1,2,0.58,0.5455,0.88,0.194,11,165,178,1780,189,1945
11873,2012-05-14,2,1,5,21,0,1,1,2,0.58,0.5455,0.83,0.0896,7,105,145,1450,152,1555
11874,2012-05-14,2,1,5,22,0,1,1,2,0.58,0.5455,0.78,0.0896,11,165,118,1180,129,1345
11875,2012-05-14,2,1,5,23,0,1,1,2,0.58,0.5455,0.78,0.1045,11,165,64,640,75,805
11876,2012-05-15,2,1,5,0,0,2,1,2,0.56,0.5303,0.88,0.1343,7,105,25,250,32,355
11877,2012-05-15,2,1,5,1,0,2,1,3,0.56,0.5303,0.88,0.1343,5,75,14,140,19,215
11878,2012-05-15,2,1,5,2,0,2,1,2,0.56,0.5303,0.88,0.1343,1,15,3,30,4,45
11879,2012-05-15,2,1,5,3,0,2,1,3,0.58,0.5455,0.83,0.1343,1,15,5,50,6,65
11880,2012-05-15,2,1,5,4,0,2,1,3,0.56,0.5303,0.94,0.0,1,15,4,40,5,55
11881,2012-05-15,2,1,5,5,0,2,1,3,0.56,0.5303,0.94,0.2239,0,0,8,80,8,80
11882,2012-05-15,2,1,5,6,0,2,1,3,0.56,0.5303,0.94,0.2239,2,30,22,220,24,250
11883,2012-05-15,2,1,5,7,0,2,1,3,0.56,0.5303,0.94,0.1343,1,15,91,910,92,925
11884,2012-05-15,2,1,5,8,0,2,1,2,0.58,0.5455,0.88,0.0896,8,120,401,4010,409,4130
11885,2012-05-15,2,1,5,9,0,2,1,2,0.58,0.5455,0.88,0.0896,28,420,327,3270,355,3690
11886,2012-05-15,2,1,5,10,0,2,1,1,0.62,0.5909,0.78,0.1045,27,405,144,1440,171,1845
11887,2012-05-15,2,1,5,11,0,2,1,1,0.64,0.5909,0.78,0.194,38,570,186,1860,224,2430
11888,2012-05-15,2,1,5,12,0,2,1,1,0.64,0.6061,0.73,0.194,44,660,220,2200,264,2860
11889,2012-05-15,2,1,5,13,0,2,1,3,0.64,0.6061,0.73,0.194,35,525,204,2040,239,2565
11890,2012-05-15,2,1,5,14,0,2,1,2,0.64,0.6061,0.73,0.194,39,585,145,1450,184,2035
11891,2012-05-15,2,1,5,15,0,2,1,2,0.7,0.6515,0.61,0.0896,51,765,205,2050,256,2815
11892,2012-05-15,2,1,5,16,0,2,1,1,0.68,0.6364,0.65,0.1642,74,1110,300,3000,374,4110
11893,2012-05-15,2,1,5,17,0,2,1,1,0.68,0.6364,0.65,0.1045,75,1125,603,6030,678,7155
11894,2012-05-15,2,1,5,18,0,2,1,1,0.7,0.6515,0.61,0.0896,68,1020,665,6650,733,7670
11895,2012-05-15,2,1,5,19,0,2,1,1,0.66,0.6212,0.69,0.1642,57,855,455,4550,512,5405
11896,2012-05-15,2,1,5,20,0,2,1,3,0.64,0.6061,0.73,0.1343,30,450,233,2330,263,2780
11897,2012-05-15,2,1,5,21,0,2,1,3,0.64,0.6061,0.73,0.2836,11,165,98,980,109,1145
11898,2012-05-15,2,1,5,22,0,2,1,1,0.58,0.5455,0.78,0.2239,9,135,74,740,83,875
11899,2012-05-15,2,1,5,23,0,2,1,3,0.56,0.5303,0.88,0.1045,13,195,58,580,71,775
11900,2012-05-16,2,1,5,0,0,3,1,2,0.58,0.5455,0.88,0.0,12,180,27,270,39,450
11901,2012-05-16,2,1,5,1,0,3,1,2,0.58,0.5455,0.88,0.1343,7,105,14,140,21,245
11902,2012-05-16,2,1,5,2,0,3,1,1,0.56,0.5303,0.94,0.194,5,75,14,140,19,215
11903,2012-05-16,2,1,5,3,0,3,1,1,0.56,0.5303,0.88,0.1045,1,15,5,50,6,65
11904,2012-05-16,2,1,5,4,0,3,1,1,0.54,0.5152,0.94,0.1343,1,15,3,30,4,45
11905,2012-05-16,2,1,5,5,0,3,1,1,0.54,0.5152,0.94,0.1045,4,60,34,340,38,400
11906,2012-05-16,2,1,5,6,0,3,1,1,0.54,0.5152,0.94,0.0896,8,120,150,1500,158,1620
11907,2012-05-16,2,1,5,7,0,3,1,1,0.56,0.5303,0.83,0.0,14,210,426,4260,440,4470
11908,2012-05-16,2,1,5,8,0,3,1,1,0.58,0.5455,0.83,0.0,33,495,617,6170,650,6665
11909,2012-05-16,2,1,5,9,0,3,1,2,0.6,0.5758,0.78,0.1343,33,495,314,3140,347,3635
11910,2012-05-16,2,1,5,10,0,3,1,1,0.66,0.6212,0.61,0.0,43,645,149,1490,192,2135
11911,2012-05-16,2,1,5,11,0,3,1,1,0.7,0.6515,0.54,0.1343,55,825,212,2120,267,2945
11912,2012-05-16,2,1,5,12,0,3,1,1,0.7,0.6515,0.54,0.194,59,885,271,2710,330,3595
11913,2012-05-16,2,1,5,13,0,3,1,1,0.72,0.6515,0.42,0.0,77,1155,273,2730,350,3885
11914,2012-05-16,2,1,5,14,0,3,1,1,0.72,0.6515,0.42,0.0896,42,630,221,2210,263,2840
11915,2012-05-16,2,1,5,15,0,3,1,2,0.72,0.6667,0.48,0.1045,52,780,222,2220,274,3000
11916,2012-05-16,2,1,5,16,0,3,1,1,0.72,0.6515,0.45,0.1045,70,1050,376,3760,446,4810
11917,2012-05-16,2,1,5,17,0,3,1,1,0.72,0.6667,0.51,0.194,104,1560,769,7690,873,9250
11918,2012-05-16,2,1,5,18,0,3,1,1,0.72,0.6667,0.51,0.2239,97,1455,749,7490,846,8945
11919,2012-05-16,2,1,5,19,0,3,1,1,0.7,0.6515,0.54,0.2836,91,1365,499,4990,590,6355
11920,2012-05-16,2,1,5,20,0,3,1,1,0.66,0.6212,0.65,0.2537,61,915,398,3980,459,4895
11921,2012-05-16,2,1,5,21,0,3,1,1,0.64,0.6061,0.73,0.194,63,945,330,3300,393,4245
11922,2012-05-16,2,1,5,22,0,3,1,1,0.64,0.6061,0.73,0.1642,33,495,253,2530,286,3025
11923,2012-05-16,2,1,5,23,0,3,1,1,0.62,0.5909,0.78,0.1045,26,390,107,1070,133,1460
11924,2012-05-17,2,1,5,0,0,4,1,1,0.6,0.5758,0.78,0.1343,30,450,49,490,79,940
11925,2012-05-17,2,1,5,1,0,4,1,1,0.6,0.5606,0.83,0.1642,12,180,16,160,28,340
11926,2012-05-17,2,1,5,2,0,4,1,1,0.6,0.5758,0.78,0.1642,8,120,8,80,16,200
11927,2012-05-17,2,1,5,3,0,4,1,1,0.6,0.5909,0.73,0.2537,0,0,3,30,3,30
11928,2012-05-17,2,1,5,4,0,4,1,1,0.6,0.6061,0.64,0.3284,3,45,13,130,16,175
11929,2012-05-17,2,1,5,5,0,4,1,1,0.56,0.5303,0.68,0.3284,1,15,34,340,35,355
11930,2012-05-17,2,1,5,6,0,4,1,1,0.54,0.5152,0.73,0.3582,10,150,149,1490,159,1640
11931,2012-05-17,2,1,5,7,0,4,1,1,0.54,0.5152,0.73,0.3881,25,375,449,4490,474,4865
11932,2012-05-17,2,1,5,8,0,4,1,1,0.52,0.5,0.55,0.4478,29,435,605,6050,634,6485
11933,2012-05-17,2,1,5,9,0,4,1,1,0.54,0.5152,0.52,0.4179,57,855,289,2890,346,3745
11934,2012-05-17,2,1,5,10,0,4,1,1,0.56,0.5303,0.52,0.2537,43,645,162,1620,205,2265
11935,2012-05-17,2,1,5,11,0,4,1,1,0.58,0.5455,0.49,0.2239,77,1155,202,2020,279,3175
11936,2012-05-17,2,1,5,12,0,4,1,1,0.6,0.6212,0.43,0.194,72,1080,276,2760,348,3840
11937,2012-05-17,2,1,5,13,0,4,1,1,0.62,0.6212,0.41,0.194,86,1290,241,2410,327,3700
11938,2012-05-17,2,1,5,14,0,4,1,1,0.64,0.6212,0.38,0.194,68,1020,202,2020,270,3040
11939,2012-05-17,2,1,5,15,0,4,1,1,0.64,0.6212,0.36,0.2537,83,1245,233,2330,316,3575
11940,2012-05-17,2,1,5,16,0,4,1,1,0.66,0.6212,0.31,0.194,86,1290,344,3440,430,4730
11941,2012-05-17,2,1,5,17,0,4,1,1,0.66,0.6212,0.31,0.1343,133,1995,719,7190,852,9185
11942,2012-05-17,2,1,5,18,0,4,1,1,0.66,0.6212,0.27,0.1642,134,2010,734,7340,868,9350
11943,2012-05-17,2,1,5,19,0,4,1,1,0.64,0.6212,0.31,0.194,86,1290,451,4510,537,5800
11944,2012-05-17,2,1,5,20,0,4,1,1,0.6,0.6212,0.4,0.194,83,1245,363,3630,446,4875
11945,2012-05-17,2,1,5,21,0,4,1,1,0.58,0.5455,0.4,0.1045,45,675,254,2540,299,3215
11946,2012-05-17,2,1,5,22,0,4,1,1,0.56,0.5303,0.43,0.0896,42,630,209,2090,251,2720
11947,2012-05-17,2,1,5,23,0,4,1,1,0.54,0.5152,0.49,0.1343,29,435,137,1370,166,1805
11948,2012-05-18,2,1,5,0,0,5,1,1,0.52,0.5,0.59,0.1045,13,195,57,570,70,765
11949,2012-05-18,2,1,5,1,0,5,1,1,0.5,0.4848,0.59,0.0896,16,240,33,330,49,570
11950,2012-05-18,2,1,5,2,0,5,1,1,0.48,0.4697,0.67,0.1343,12,180,9,90,21,270
11951,2012-05-18,2,1,5,3,0,5,1,1,0.46,0.4545,0.72,0.0896,6,90,8,80,14,170
11952,2012-05-18,2,1,5,4,0,5,1,1,0.46,0.4545,0.77,0.1642,0,0,11,110,11,110
11953,2012-05-18,2,1,5,5,0,5,1,1,0.46,0.4545,0.77,0.1045,1,15,33,330,34,345
11954,2012-05-18,2,1,5,6,0,5,1,1,0.44,0.4394,0.77,0.1343,14,210,168,1680,182,1890
11955,2012-05-18,2,1,5,7,0,5,1,1,0.46,0.4545,0.82,0.1045,40,600,475,4750,515,5350
11956,2012-05-18,2,1,5,8,0,5,1,1,0.52,0.5,0.59,0.1343,49,735,696,6960,745,7695
11957,2012-05-18,2,1,5,9,0,5,1,1,0.56,0.5303,0.56,0.1045,57,855,304,3040,361,3895
11958,2012-05-18,2,1,5,10,0,5,1,1,0.6,0.6212,0.46,0.1343,74,1110,181,1810,255,2920
11959,2012-05-18,2,1,5,11,0,5,1,1,0.62,0.6212,0.43,0.0,109,1635,225,2250,334,3885
11960,2012-05-18,2,1,5,12,0,5,1,1,0.62,0.6212,0.41,0.194,108,1620,252,2520,360,4140
11961,2012-05-18,2,1,5,13,0,5,1,1,0.64,0.6212,0.36,0.1642,98,1470,297,2970,395,4440
11962,2012-05-18,2,1,5,14,0,5,1,1,0.66,0.6212,0.34,0.1343,108,1620,242,2420,350,4040
11963,2012-05-18,2,1,5,15,0,5,1,1,0.66,0.6212,0.36,0.194,131,1965,260,2600,391,4565
11964,2012-05-18,2,1,5,16,0,5,1,1,0.66,0.6212,0.34,0.2537,151,2265,417,4170,568,6435
11965,2012-05-18,2,1,5,17,0,5,1,1,0.66,0.6212,0.34,0.1343,124,1860,688,6880,812,8740
11966,2012-05-18,2,1,5,18,0,5,1,1,0.64,0.6212,0.38,0.2239,99,1485,570,5700,669,7185
11967,2012-05-18,2,1,5,19,0,5,1,1,0.62,0.6212,0.41,0.194,91,1365,392,3920,483,5285
11968,2012-05-18,2,1,5,20,0,5,1,1,0.62,0.6212,0.41,0.1642,73,1095,264,2640,337,3735
11969,2012-05-18,2,1,5,21,0,5,1,1,0.6,0.6212,0.4,0.0,49,735,209,2090,258,2825
11970,2012-05-18,2,1,5,22,0,5,1,1,0.56,0.5303,0.52,0.3284,57,855,194,1940,251,2795
11971,2012-05-18,2,1,5,23,0,5,1,1,0.52,0.5,0.55,0.0,41,615,133,1330,174,1945
11972,2012-05-19,2,1,5,0,0,6,0,1,0.52,0.5,0.48,0.1045,30,450,118,1180,148,1630
11973,2012-05-19,2,1,5,1,0,6,0,1,0.5,0.4848,0.48,0.0,20,300,84,840,104,1140
11974,2012-05-19,2,1,5,2,0,6,0,1,0.5,0.4848,0.51,0.1045,13,195,56,560,69,755
11975,2012-05-19,2,1,5,3,0,6,0,1,0.5,0.4848,0.48,0.1045,10,150,23,230,33,380
11976,2012-05-19,2,1,5,4,0,6,0,1,0.48,0.4697,0.59,0.0896,6,90,8,80,14,170
11977,2012-05-19,2,1,5,5,0,6,0,1,0.46,0.4545,0.67,0.0,1,15,11,110,12,125
11978,2012-05-19,2,1,5,6,0,6,0,1,0.44,0.4394,0.72,0.0896,12,180,38,380,50,560
11979,2012-05-19,2,1,5,7,0,6,0,1,0.46,0.4545,0.67,0.1045,28,420,67,670,95,1090
11980,2012-05-19,2,1,5,8,0,6,0,1,0.52,0.5,0.52,0.1642,33,495,162,1620,195,2115
11981,2012-05-19,2,1,5,9,0,6,0,1,0.56,0.5303,0.43,0.1642,79,1185,213,2130,292,3315
11982,2012-05-19,2,1,5,10,0,6,0,1,0.56,0.5303,0.43,0.0,177,2655,275,2750,452,5405
11983,2012-05-19,2,1,5,11,0,6,0,1,0.62,0.6212,0.38,0.0896,235,3525,351,3510,586,7035
11984,2012-05-19,2,1,5,12,0,6,0,1,0.66,0.6212,0.36,0.0,276,4140,366,3660,642,7800
11985,2012-05-19,2,1,5,13,0,6,0,1,0.7,0.6364,0.37,0.1343,332,4980,372,3720,704,8700
11986,2012-05-19,2,1,5,14,0,6,0,1,0.72,0.6515,0.3,0.0896,361,5415,369,3690,730,9105
11987,2012-05-19,2,1,5,15,0,6,0,1,0.72,0.6515,0.3,0.1045,356,5340,316,3160,672,8500
11988,2012-05-19,2,1,5,16,0,6,0,1,0.74,0.6515,0.3,0.1045,331,4965,311,3110,642,8075
11989,2012-05-19,2,1,5,17,0,6,0,1,0.74,0.6515,0.3,0.0896,279,4185,347,3470,626,7655
11990,2012-05-19,2,1,5,18,0,6,0,1,0.74,0.6515,0.33,0.0896,254,3810,391,3910,645,7720
11991,2012-05-19,2,1,5,19,0,6,0,1,0.7,0.6364,0.39,0.1343,203,3045,229,2290,432,5335
11992,2012-05-19,2,1,5,20,0,6,0,1,0.68,0.6364,0.41,0.0896,118,1770,197,1970,315,3740
11993,2012-05-19,2,1,5,21,0,6,0,1,0.64,0.6212,0.5,0.0,81,1215,178,1780,259,2995
11994,2012-05-19,2,1,5,22,0,6,0,1,0.64,0.6212,0.47,0.0,104,1560,234,2340,338,3900
11995,2012-05-19,2,1,5,23,0,6,0,1,0.6,0.6212,0.56,0.1642,71,1065,168,1680,239,2745
11996,2012-05-20,2,1,5,0,0,0,0,1,0.58,0.5455,0.53,0.1045,42,630,128,1280,170,1910
11997,2012-05-20,2,1,5,1,0,0,0,1,0.56,0.5303,0.52,0.0,28,420,102,1020,130,1440
11998,2012-05-20,2,1,5,2,0,0,0,1,0.56,0.5303,0.52,0.0,36,540,62,620,98,1160
11999,2012-05-20,2,1,5,3,0,0,0,1,0.54,0.5152,0.56,0.0896,26,390,40,400,66,790
12000,2012-05-20,2,1,5,4,0,0,0,1,0.52,0.5,0.68,0.0896,2,30,14,140,16,170
12001,2012-05-20,2,1,5,5,0,0,0,1,0.5,0.4848,0.72,0.1045,1,15,7,70,8,85
12002,2012-05-20,2,1,5,6,0,0,0,1,0.5,0.4848,0.63,0.1343,4,60,21,210,25,270
12003,2012-05-20,2,1,5,7,0,0,0,1,0.52,0.5,0.68,0.194,35,525,55,550,90,1075
12004,2012-05-20,2,1,5,8,0,0,0,1,0.56,0.5303,0.56,0.1642,51,765,120,1200,171,1965
12005,2012-05-20,2,1,5,9,0,0,0,1,0.62,0.6212,0.32,0.2537,129,1935,184,1840,313,3775
12006,2012-05-20,2,1,5,10,0,0,0,1,0.66,0.6212,0.34,0.2985,174,2610,258,2580,432,5190
12007,2012-05-20,2,1,5,11,0,0,0,1,0.66,0.6212,0.36,0.3284,258,3870,323,3230,581,7100
12008,2012-05-20,2,1,5,12,0,0,0,1,0.68,0.6364,0.36,0.3284,247,3705,390,3900,637,7605
12009,2012-05-20,2,1,5,13,0,0,0,1,0.7,0.6364,0.37,0.2836,244,3660,363,3630,607,7290
12010,2012-05-20,2,1,5,14,0,0,0,1,0.72,0.6515,0.39,0.3881,236,3540,307,3070,543,6610
12011,2012-05-20,2,1,5,15,0,0,0,2,0.7,0.6364,0.39,0.4179,246,3690,256,2560,502,6250
12012,2012-05-20,2,1,5,16,0,0,0,1,0.72,0.6515,0.42,0.3582,238,3570,339,3390,577,6960
12013,2012-05-20,2,1,5,17,0,0,0,1,0.72,0.6515,0.45,0.3284,209,3135,340,3400,549,6535
12014,2012-05-20,2,1,5,18,0,0,0,1,0.7,0.6515,0.51,0.3284,146,2190,328,3280,474,5470
12015,2012-05-20,2,1,5,19,0,0,0,1,0.66,0.6212,0.61,0.4179,142,2130,260,2600,402,4730
12016,2012-05-20,2,1,5,20,0,0,0,1,0.66,0.6212,0.61,0.4179,83,1245,191,1910,274,3155
12017,2012-05-20,2,1,5,21,0,0,0,1,0.64,0.6061,0.69,0.3881,51,765,182,1820,233,2585
12018,2012-05-20,2,1,5,22,0,0,0,1,0.62,0.5909,0.73,0.3284,44,660,101,1010,145,1670
12019,2012-05-20,2,1,5,23,0,0,0,3,0.6,0.5758,0.78,0.3582,32,480,54,540,86,1020
12020,2012-05-21,2,1,5,0,0,1,1,3,0.58,0.5455,0.88,0.2985,12,180,28,280,40,460
12021,2012-05-21,2,1,5,1,0,1,1,3,0.58,0.5455,0.88,0.3582,4,60,11,110,15,170
12022,2012-05-21,2,1,5,2,0,1,1,3,0.56,0.5303,0.94,0.2537,2,30,9,90,11,120
12023,2012-05-21,2,1,5,3,0,1,1,2,0.56,0.5303,0.88,0.2985,0,0,2,20,2,20
12024,2012-05-21,2,1,5,4,0,1,1,3,0.56,0.5303,0.88,0.2985,2,30,5,50,7,80
12025,2012-05-21,2,1,5,5,0,1,1,3,0.56,0.5303,0.88,0.2985,1,15,14,140,15,155
12026,2012-05-21,2,1,5,6,0,1,1,3,0.56,0.5303,0.88,0.2985,3,45,76,760,79,805
12027,2012-05-21,2,1,5,7,0,1,1,3,0.56,0.5303,0.88,0.2985,7,105,146,1460,153,1565
12028,2012-05-21,2,1,5,8,0,1,1,3,0.56,0.5303,0.88,0.2537,12,180,258,2580,270,2760
12029,2012-05-21,2,1,5,9,0,1,1,3,0.56,0.5303,0.88,0.2239,14,210,172,1720,186,1930
12030,2012-05-21,2,1,5,10,0,1,1,3,0.58,0.5455,0.88,0.2836,28,420,71,710,99,1130
12031,2012-05-21,2,1,5,11,0,1,1,2,0.6,0.5606,0.83,0.1642,24,360,82,820,106,1180
12032,2012-05-21,2,1,5,12,0,1,1,2,0.6,0.5606,0.83,0.2537,46,690,124,1240,170,1930
12033,2012-05-21,2,1,5,13,0,1,1,3,0.6,0.5606,0.83,0.2537,49,735,135,1350,184,2085
12034,2012-05-21,2,1,5,14,0,1,1,3,0.6,0.5606,0.83,0.194,45,675,135,1350,180,2025
12035,2012-05-21,2,1,5,15,0,1,1,2,0.64,0.6061,0.73,0.194,67,1005,158,1580,225,2585
12036,2012-05-21,2,1,5,16,0,1,1,2,0.64,0.6061,0.73,0.2537,46,690,269,2690,315,3380
12037,2012-05-21,2,1,5,17,0,1,1,2,0.66,0.6212,0.69,0.2537,40,600,468,4680,508,5280
12038,2012-05-21,2,1,5,18,0,1,1,1,0.64,0.6061,0.73,0.1045,52,780,478,4780,530,5560
12039,2012-05-21,2,1,5,19,0,1,1,1,0.66,0.6212,0.69,0.0896,57,855,391,3910,448,4765
12040,2012-05-21,2,1,5,20,0,1,1,1,0.64,0.6061,0.69,0.1343,44,660,292,2920,336,3580
12041,2012-05-21,2,1,5,21,0,1,1,1,0.62,0.6061,0.69,0.0896,31,465,210,2100,241,2565
12042,2012-05-21,2,1,5,22,0,1,1,2,0.62,0.5909,0.73,0.1642,26,390,116,1160,142,1550
12043,2012-05-21,2,1,5,23,0,1,1,1,0.62,0.5909,0.73,0.2836,18,270,79,790,97,1060
12044,2012-05-22,2,1,5,0,0,2,1,1,0.58,0.5455,0.83,0.2537,10,150,26,260,36,410
12045,2012-05-22,2,1,5,1,0,2,1,2,0.58,0.5455,0.83,0.1343,11,165,16,160,27,325
12046,2012-05-22,2,1,5,2,0,2,1,2,0.58,0.5455,0.83,0.1045,1,15,10,100,11,115
12047,2012-05-22,2,1,5,3,0,2,1,2,0.58,0.5455,0.83,0.1045,0,0,5,50,5,50
12048,2012-05-22,2,1,5,4,0,2,1,2,0.56,0.5303,0.88,0.1642,0,0,7,70,7,70
12049,2012-05-22,2,1,5,5,0,2,1,3,0.56,0.5303,0.88,0.194,0,0,17,170,17,170
12050,2012-05-22,2,1,5,6,0,2,1,3,0.56,0.5303,0.88,0.1045,8,120,129,1290,137,1410
12051,2012-05-22,2,1,5,7,0,2,1,3,0.56,0.5303,0.88,0.1045,9,135,315,3150,324,3285
12052,2012-05-22,2,1,5,8,0,2,1,2,0.56,0.5303,0.88,0.1343,20,300,570,5700,590,6000
12053,2012-05-22,2,1,5,9,0,2,1,2,0.6,0.5606,0.83,0.1045,46,690,287,2870,333,3560
12054,2012-05-22,2,1,5,10,0,2,1,2,0.6,0.5758,0.78,0.0896,52,780,148,1480,200,2260
12055,2012-05-22,2,1,5,11,0,2,1,2,0.6,0.5758,0.78,0.0,39,585,150,1500,189,2085
12056,2012-05-22,2,1,5,12,0,2,1,2,0.62,0.5909,0.78,0.1045,76,1140,178,1780,254,2920
12057,2012-05-22,2,1,5,13,0,2,1,2,0.64,0.6061,0.73,0.0,48,720,195,1950,243,2670
12058,2012-05-22,2,1,5,14,0,2,1,2,0.64,0.6061,0.73,0.1045,73,1095,149,1490,222,2585
12059,2012-05-22,2,1,5,15,0,2,1,1,0.7,0.6515,0.61,0.0896,54,810,191,1910,245,2720
12060,2012-05-22,2,1,5,16,0,2,1,1,0.68,0.6364,0.61,0.1045,70,1050,316,3160,386,4210
12061,2012-05-22,2,1,5,17,0,2,1,1,0.72,0.6667,0.54,0.0,69,1035,716,7160,785,8195
12062,2012-05-22,2,1,5,18,0,2,1,1,0.68,0.6364,0.61,0.1343,76,1140,709,7090,785,8230
12063,2012-05-22,2,1,5,19,0,2,1,1,0.66,0.6212,0.69,0.2239,44,660,320,3200,364,3860
12064,2012-05-22,2,1,5,20,0,2,1,1,0.64,0.6061,0.73,0.2537,54,810,319,3190,373,4000
12065,2012-05-22,2,1,5,21,0,2,1,1,0.62,0.5909,0.78,0.1343,28,420,233,2330,261,2750
12066,2012-05-22,2,1,5,22,0,2,1,1,0.62,0.5909,0.73,0.0896,17,255,157,1570,174,1825
12067,2012-05-22,2,1,5,23,0,2,1,1,0.62,0.5909,0.73,0.1045,14,210,91,910,105,1120
12068,2012-05-23,2,1,5,0,0,3,1,1,0.62,0.5909,0.78,0.1343,19,285,28,280,47,565
12069,2012-05-23,2,1,5,1,0,3,1,1,0.6,0.5606,0.83,0.1642,23,345,9,90,32,435
12070,2012-05-23,2,1,5,2,0,3,1,2,0.6,0.5606,0.83,0.1642,2,30,10,100,12,130
12071,2012-05-23,2,1,5,3,0,3,1,1,0.6,0.5758,0.78,0.1045,0,0,5,50,5,50
12072,2012-05-23,2,1,5,4,0,3,1,3,0.58,0.5455,0.83,0.194,0,0,3,30,3,30
12073,2012-05-23,2,1,5,5,0,3,1,3,0.56,0.5303,0.88,0.2537,6,90,29,290,35,380
12074,2012-05-23,2,1,5,6,0,3,1,1,0.56,0.5303,0.88,0.1045,6,90,154,1540,160,1630
12075,2012-05-23,2,1,5,7,0,3,1,1,0.58,0.5455,0.83,0.0,16,240,452,4520,468,4760
12076,2012-05-23,2,1,5,8,0,3,1,1,0.58,0.5455,0.83,0.0,38,570,681,6810,719,7380
12077,2012-05-23,2,1,5,9,0,3,1,2,0.62,0.5909,0.78,0.0,39,585,258,2580,297,3165
12078,2012-05-23,2,1,5,10,0,3,1,1,0.62,0.5909,0.78,0.0896,52,780,139,1390,191,2170
12079,2012-05-23,2,1,5,11,0,3,1,1,0.64,0.6061,0.73,0.0,46,690,151,1510,197,2200
12080,2012-05-23,2,1,5,12,0,3,1,2,0.66,0.6212,0.69,0.0896,42,630,206,2060,248,2690
12081,2012-05-23,2,1,5,13,0,3,1,2,0.66,0.6212,0.74,0.1642,69,1035,201,2010,270,3045
12082,2012-05-23,2,1,5,14,0,3,1,1,0.68,0.6364,0.65,0.1343,67,1005,181,1810,248,2815
12083,2012-05-23,2,1,5,15,0,3,1,2,0.7,0.6515,0.61,0.0,65,975,192,1920,257,2895
12084,2012-05-23,2,1,5,16,0,3,1,3,0.7,0.6515,0.61,0.0896,62,930,216,2160,278,3090
12085,2012-05-23,2,1,5,17,0,3,1,3,0.64,0.6061,0.69,0.1045,45,675,240,2400,285,3075
12086,2012-05-23,2,1,5,18,0,3,1,3,0.64,0.6061,0.69,0.1045,31,465,296,2960,327,3425
12087,2012-05-23,2,1,5,19,0,3,1,2,0.62,0.5758,0.83,0.1642,40,600,336,3360,376,3960
12088,2012-05-23,2,1,5,20,0,3,1,2,0.62,0.5758,0.83,0.0896,28,420,267,2670,295,3090
12089,2012-05-23,2,1,5,21,0,3,1,2,0.62,0.5758,0.83,0.0,24,360,221,2210,245,2570
12090,2012-05-23,2,1,5,22,0,3,1,2,0.62,0.5758,0.83,0.1642,23,345,136,1360,159,1705
12091,2012-05-23,2,1,5,23,0,3,1,1,0.6,0.5606,0.83,0.1343,23,345,83,830,106,1175
12092,2012-05-24,2,1,5,0,0,4,1,1,0.6,0.5606,0.83,0.0896,7,105,49,490,56,595
12093,2012-05-24,2,1,5,1,0,4,1,1,0.6,0.5455,0.88,0.0896,9,135,21,210,30,345
12094,2012-05-24,2,1,5,2,0,4,1,1,0.6,0.5455,0.88,0.0,1,15,15,150,16,165
12095,2012-05-24,2,1,5,3,0,4,1,2,0.6,0.5455,0.88,0.1045,1,15,3,30,4,45
12096,2012-05-24,2,1,5,4,0,4,1,2,0.6,0.5455,0.88,0.1642,0,0,5,50,5,50
12097,2012-05-24,2,1,5,5,0,4,1,2,0.6,0.5455,0.88,0.1642,1,15,29,290,30,305
12098,2012-05-24,2,1,5,6,0,4,1,2,0.6,0.5455,0.88,0.1642,10,150,146,1460,156,1610
12099,2012-05-24,2,1,5,7,0,4,1,1,0.6,0.5606,0.83,0.1045,22,330,393,3930,415,4260
12100,2012-05-24,2,1,5,8,0,4,1,1,0.62,0.5909,0.73,0.1343,33,495,659,6590,692,7085
12101,2012-05-24,2,1,5,9,0,4,1,1,0.62,0.5909,0.73,0.1642,34,510,267,2670,301,3180
12102,2012-05-24,2,1,5,10,0,4,1,1,0.64,0.6061,0.65,0.1343,47,705,138,1380,185,2085
12103,2012-05-24,2,1,5,11,0,4,1,1,0.66,0.6212,0.65,0.1343,61,915,160,1600,221,2515
12104,2012-05-24,2,1,5,12,0,4,1,1,0.7,0.6515,0.58,0.1045,76,1140,213,2130,289,3270
12105,2012-05-24,2,1,5,13,0,4,1,1,0.72,0.6667,0.54,0.1642,69,1035,233,2330,302,3365
12106,2012-05-24,2,1,5,14,0,4,1,1,0.74,0.6818,0.55,0.2239,72,1080,180,1800,252,2880
12107,2012-05-24,2,1,5,15,0,4,1,1,0.74,0.6818,0.55,0.2537,69,1035,222,2220,291,3255
12108,2012-05-24,2,1,5,16,0,4,1,1,0.74,0.6818,0.55,0.3582,61,915,329,3290,390,4205
12109,2012-05-24,2,1,5,17,0,4,1,1,0.74,0.6818,0.55,0.2836,120,1800,678,6780,798,8580
12110,2012-05-24,2,1,5,18,0,4,1,1,0.72,0.6667,0.54,0.3284,118,1770,634,6340,752,8110
12111,2012-05-24,2,1,5,19,0,4,1,1,0.7,0.6515,0.61,0.2985,76,1140,416,4160,492,5300
12112,2012-05-24,2,1,5,20,0,4,1,2,0.66,0.6212,0.69,0.2836,55,825,343,3430,398,4255
12113,2012-05-24,2,1,5,21,0,4,1,3,0.64,0.5909,0.78,0.1642,48,720,237,2370,285,3090
12114,2012-05-24,2,1,5,22,0,4,1,2,0.64,0.5909,0.78,0.1045,33,495,210,2100,243,2595
12115,2012-05-24,2,1,5,23,0,4,1,2,0.64,0.5909,0.78,0.1343,36,540,131,1310,167,1850
12116,2012-05-25,2,1,5,0,0,5,1,1,0.62,0.5758,0.83,0.1343,10,150,63,630,73,780
12117,2012-05-25,2,1,5,1,0,5,1,1,0.62,0.5758,0.83,0.0896,8,120,34,340,42,460
12118,2012-05-25,2,1,5,2,0,5,1,2,0.62,0.5758,0.83,0.0,7,105,16,160,23,265
12119,2012-05-25,2,1,5,3,0,5,1,2,0.62,0.5606,0.88,0.1045,8,120,6,60,14,180
12120,2012-05-25,2,1,5,4,0,5,1,2,0.62,0.5606,0.88,0.0,3,45,6,60,9,105
12121,2012-05-25,2,1,5,5,0,5,1,2,0.62,0.5606,0.88,0.0896,2,30,28,280,30,310
12122,2012-05-25,2,1,5,6,0,5,1,2,0.62,0.5606,0.88,0.1045,5,75,108,1080,113,1155
12123,2012-05-25,2,1,5,7,0,5,1,2,0.62,0.5606,0.88,0.1642,7,105,352,3520,359,3625
12124,2012-05-25,2,1,5,8,0,5,1,2,0.64,0.5758,0.89,0.1045,32,480,551,5510,583,5990
12125,2012-05-25,2,1,5,9,0,5,1,2,0.64,0.5758,0.89,0.1343,52,780,288,2880,340,3660
12126,2012-05-25,2,1,5,10,0,5,1,1,0.68,0.6364,0.79,0.1642,69,1035,163,1630,232,2665
12127,2012-05-25,2,1,5,11,0,5,1,1,0.68,0.6364,0.79,0.1343,90,1350,193,1930,283,3280
12128,2012-05-25,2,1,5,12,0,5,1,1,0.72,0.6818,0.66,0.1045,84,1260,237,2370,321,3630
12129,2012-05-25,2,1,5,13,0,5,1,1,0.74,0.6818,0.62,0.1343,86,1290,247,2470,333,3760
12130,2012-05-25,2,1,5,14,0,5,1,1,0.74,0.6818,0.58,0.1343,104,1560,263,2630,367,4190
12131,2012-05-25,2,1,5,15,0,5,1,1,0.76,0.7121,0.62,0.194,106,1590,360,3600,466,5190
12132,2012-05-25,2,1,5,16,0,5,1,1,0.78,0.7121,0.52,0.2239,137,2055,447,4470,584,6525
12133,2012-05-25,2,1,5,17,0,5,1,1,0.76,0.7121,0.62,0.2836,124,1860,529,5290,653,7150
12134,2012-05-25,2,1,5,18,0,5,1,1,0.76,0.7121,0.62,0.194,131,1965,391,3910,522,5875
12135,2012-05-25,2,1,5,19,0,5,1,1,0.74,0.6818,0.62,0.2537,111,1665,293,2930,404,4595
12136,2012-05-25,2,1,5,20,0,5,1,1,0.7,0.6515,0.65,0.1642,80,1200,270,2700,350,3900
12137,2012-05-25,2,1,5,21,0,5,1,1,0.7,0.6515,0.65,0.1343,62,930,193,1930,255,2860
12138,2012-05-25,2,1,5,22,0,5,1,1,0.66,0.6212,0.74,0.1045,65,975,147,1470,212,2445
12139,2012-05-25,2,1,5,23,0,5,1,1,0.66,0.6061,0.78,0.2239,34,510,132,1320,166,1830
12140,2012-05-26,2,1,5,0,0,6,0,1,0.64,0.5758,0.83,0.1642,18,270,98,980,116,1250
12141,2012-05-26,2,1,5,1,0,6,0,1,0.64,0.5758,0.83,0.1343,18,270,64,640,82,910
12142,2012-05-26,2,1,5,2,0,6,0,1,0.64,0.5758,0.89,0.1343,9,135,55,550,64,685
12143,2012-05-26,2,1,5,3,0,6,0,1,0.62,0.5606,0.88,0.1045,9,135,22,220,31,355
12144,2012-05-26,2,1,5,4,0,6,0,1,0.62,0.5606,0.88,0.1343,0,0,2,20,2,20
12145,2012-05-26,2,1,5,5,0,6,0,1,0.62,0.5758,0.83,0.2537,0,0,10,100,10,100
12146,2012-05-26,2,1,5,6,0,6,0,1,0.62,0.5606,0.88,0.194,6,90,25,250,31,340
12147,2012-05-26,2,1,5,7,0,6,0,2,0.62,0.5606,0.88,0.1642,10,150,44,440,54,590
12148,2012-05-26,2,1,5,8,0,6,0,1,0.64,0.5909,0.78,0.1343,38,570,103,1030,141,1600
12149,2012-05-26,2,1,5,9,0,6,0,1,0.64,0.5758,0.83,0.194,97,1455,192,1920,289,3375
12150,2012-05-26,2,1,5,10,0,6,0,1,0.68,0.6364,0.79,0.2239,181,2715,256,2560,437,5275
12151,2012-05-26,2,1,5,11,0,6,0,1,0.7,0.6667,0.74,0.194,208,3120,312,3120,520,6240
12152,2012-05-26,2,1,5,12,0,6,0,1,0.74,0.697,0.66,0.2239,236,3540,293,2930,529,6470
12153,2012-05-26,2,1,5,13,0,6,0,1,0.76,0.7273,0.66,0.194,265,3975,274,2740,539,6715
12154,2012-05-26,2,1,5,14,0,6,0,1,0.76,0.7273,0.66,0.2239,307,4605,257,2570,564,7175
12155,2012-05-26,2,1,5,15,0,6,0,1,0.76,0.7273,0.66,0.2836,274,4110,239,2390,513,6500
12156,2012-05-26,2,1,5,16,0,6,0,1,0.78,0.7273,0.55,0.2537,261,3915,243,2430,504,6345
12157,2012-05-26,2,1,5,17,0,6,0,2,0.78,0.7121,0.52,0.2537,235,3525,227,2270,462,5795
12158,2012-05-26,2,1,5,18,0,6,0,2,0.76,0.697,0.52,0.194,199,2985,216,2160,415,5145
12159,2012-05-26,2,1,5,19,0,6,0,2,0.74,0.697,0.66,0.2239,159,2385,214,2140,373,4525
12160,2012-05-26,2,1,5,20,0,6,0,2,0.74,0.6818,0.55,0.194,103,1545,152,1520,255,3065
12161,2012-05-26,2,1,5,21,0,6,0,2,0.72,0.6818,0.62,0.194,100,1500,151,1510,251,3010
12162,2012-05-26,2,1,5,22,0,6,0,1,0.7,0.6667,0.74,0.2537,86,1290,118,1180,204,2470
12163,2012-05-26,2,1,5,23,0,6,0,1,0.7,0.6667,0.74,0.2537,36,540,114,1140,150,1680
12164,2012-05-27,2,1,5,0,0,0,0,2,0.68,0.6364,0.69,0.1642,48,720,89,890,137,1610
12165,2012-05-27,2,1,5,1,0,0,0,1,0.66,0.6212,0.74,0.2239,17,255,61,610,78,865
12166,2012-05-27,2,1,5,2,0,0,0,1,0.64,0.6061,0.73,0.2239,16,240,45,450,61,690
12167,2012-05-27,2,1,5,3,0,0,0,1,0.64,0.6061,0.73,0.1642,11,165,25,250,36,415
12168,2012-05-27,2,1,5,4,0,0,0,1,0.62,0.5758,0.83,0.194,4,60,7,70,11,130
12169,2012-05-27,2,1,5,5,0,0,0,1,0.62,0.5758,0.83,0.194,2,30,5,50,7,80
12170,2012-05-27,2,1,5,6,0,0,0,1,0.62,0.5758,0.83,0.1642,8,120,14,140,22,260
12171,2012-05-27,2,1,5,7,0,0,0,1,0.62,0.5606,0.88,0.1642,22,330,30,300,52,630
12172,2012-05-27,2,1,5,8,0,0,0,1,0.64,0.5758,0.83,0.194,69,1035,82,820,151,1855
12173,2012-05-27,2,1,5,9,0,0,0,1,0.66,0.6061,0.83,0.2239,130,1950,140,1400,270,3350
12174,2012-05-27,2,1,5,10,0,0,0,1,0.68,0.6364,0.74,0.2537,209,3135,215,2150,424,5285
12175,2012-05-27,2,1,5,11,0,0,0,1,0.72,0.6818,0.66,0.2239,268,4020,251,2510,519,6530
12176,2012-05-27,2,1,5,12,0,0,0,1,0.74,0.697,0.66,0.2537,301,4515,269,2690,570,7205
12177,2012-05-27,2,1,5,13,0,0,0,1,0.76,0.7121,0.58,0.194,270,4050,228,2280,498,6330
12178,2012-05-27,2,1,5,14,0,0,0,1,0.76,0.7121,0.58,0.2537,317,4755,230,2300,547,7055
12179,2012-05-27,2,1,5,15,0,0,0,1,0.78,0.7121,0.52,0.2836,290,4350,245,2450,535,6800
12180,2012-05-27,2,1,5,16,0,0,0,1,0.78,0.7121,0.52,0.2836,258,3870,243,2430,501,6300
12181,2012-05-27,2,1,5,17,0,0,0,1,0.78,0.7121,0.49,0.2985,275,4125,247,2470,522,6595
12182,2012-05-27,2,1,5,18,0,0,0,1,0.76,0.7121,0.58,0.2985,266,3990,252,2520,518,6510
12183,2012-05-27,2,1,5,19,0,0,0,1,0.76,0.7121,0.58,0.194,230,3450,212,2120,442,5570
12184,2012-05-27,2,1,5,20,0,0,0,1,0.74,0.6818,0.55,0.1642,168,2520,224,2240,392,4760
12185,2012-05-27,2,1,5,21,0,0,0,3,0.66,0.6212,0.69,0.4179,64,960,79,790,143,1750
12186,2012-05-27,2,1,5,22,0,0,0,3,0.62,0.5758,0.83,0.0,9,135,50,500,59,635
12187,2012-05-27,2,1,5,23,0,0,0,3,0.62,0.5758,0.83,0.1343,31,465,65,650,96,1115
12188,2012-05-28,2,1,5,0,1,1,0,1,0.62,0.5758,0.83,0.2239,21,315,44,440,65,755
12189,2012-05-28,2,1,5,1,1,1,0,2,0.62,0.5909,0.78,0.2985,14,210,45,450,59,660
12190,2012-05-28,2,1,5,2,1,1,0,1,0.6,0.5606,0.83,0.2239,20,300,28,280,48,580
12191,2012-05-28,2,1,5,3,1,1,0,1,0.62,0.5909,0.73,0.1642,6,90,12,120,18,210
12192,2012-05-28,2,1,5,4,1,1,0,1,0.6,0.5758,0.78,0.1343,2,30,4,40,6,70
12193,2012-05-28,2,1,5,5,1,1,0,1,0.6,0.5758,0.78,0.1343,4,60,5,50,9,110
12194,2012-05-28,2,1,5,6,1,1,0,1,0.62,0.5909,0.73,0.1642,6,90,14,140,20,230
12195,2012-05-28,2,1,5,7,1,1,0,1,0.62,0.5909,0.78,0.1045,24,360,43,430,67,790
12196,2012-05-28,2,1,5,8,1,1,0,1,0.66,0.6212,0.69,0.0,62,930,93,930,155,1860
12197,2012-05-28,2,1,5,9,1,1,0,1,0.7,0.6515,0.61,0.0,121,1815,142,1420,263,3235
12198,2012-05-28,2,1,5,10,1,1,0,1,0.7,0.6515,0.61,0.0,189,2835,175,1750,364,4585
12199,2012-05-28,2,1,5,11,1,1,0,1,0.72,0.6818,0.66,0.1343,254,3810,222,2220,476,6030
12200,2012-05-28,2,1,5,12,1,1,0,1,0.76,0.7121,0.62,0.1343,233,3495,292,2920,525,6415
12201,2012-05-28,2,1,5,13,1,1,0,1,0.8,0.7879,0.63,0.2836,272,4080,284,2840,556,6920
12202,2012-05-28,2,1,5,14,1,1,0,1,0.8,0.7879,0.63,0.2836,238,3570,227,2270,465,5840
12203,2012-05-28,2,1,5,15,1,1,0,1,0.82,0.7879,0.56,0.2985,181,2715,279,2790,460,5505
12204,2012-05-28,2,1,5,16,1,1,0,1,0.82,0.7879,0.56,0.3284,223,3345,278,2780,501,6125
12205,2012-05-28,2,1,5,17,1,1,0,1,0.82,0.7879,0.56,0.2985,158,2370,247,2470,405,4840
12206,2012-05-28,2,1,5,18,1,1,0,1,0.8,0.7727,0.59,0.2985,132,1980,251,2510,383,4490
12207,2012-05-28,2,1,5,19,1,1,0,1,0.8,0.7576,0.55,0.2985,148,2220,247,2470,395,4690
12208,2012-05-28,2,1,5,20,1,1,0,1,0.78,0.7424,0.62,0.2985,114,1710,203,2030,317,3740
12209,2012-05-28,2,1,5,21,1,1,0,1,0.76,0.7273,0.66,0.2836,66,990,181,1810,247,2800
12210,2012-05-28,2,1,5,22,1,1,0,1,0.74,0.697,0.7,0.1642,47,705,110,1100,157,1805
12211,2012-05-28,2,1,5,23,1,1,0,1,0.72,0.697,0.74,0.1642,22,330,60,600,82,930
12212,2012-05-29,2,1,5,0,0,2,1,1,0.7,0.6667,0.79,0.194,12,180,33,330,45,510
12213,2012-05-29,2,1,5,1,0,2,1,1,0.7,0.6667,0.79,0.194,1,15,13,130,14,145
12214,2012-05-29,2,1,5,2,0,2,1,1,0.68,0.6364,0.83,0.1343,0,0,8,80,8,80
12215,2012-05-29,2,1,5,3,0,2,1,1,0.68,0.6364,0.79,0.2836,1,15,2,20,3,35
12216,2012-05-29,2,1,5,4,0,2,1,1,0.66,0.6061,0.78,0.2239,0,0,5,50,5,50
12217,2012-05-29,2,1,5,5,0,2,1,1,0.66,0.6061,0.78,0.2239,1,15,32,320,33,335
12218,2012-05-29,2,1,5,6,0,2,1,1,0.66,0.6061,0.78,0.2239,9,135,145,1450,154,1585
12219,2012-05-29,2,1,5,7,0,2,1,1,0.66,0.6061,0.78,0.2239,19,285,431,4310,450,4595
12220,2012-05-29,2,1,5,8,0,2,1,1,0.7,0.6667,0.74,0.194,46,690,588,5880,634,6570
12221,2012-05-29,2,1,5,9,0,2,1,1,0.72,0.6818,0.7,0.2537,26,390,231,2310,257,2700
12222,2012-05-29,2,1,5,10,0,2,1,1,0.74,0.697,0.7,0.2985,67,1005,116,1160,183,2165
12223,2012-05-29,2,1,5,11,0,2,1,1,0.76,0.7121,0.62,0.2985,50,750,147,1470,197,2220
12224,2012-05-29,2,1,5,12,0,2,1,1,0.8,0.7576,0.55,0.3284,56,840,181,1810,237,2650
12225,2012-05-29,2,1,5,13,0,2,1,1,0.82,0.7727,0.52,0.3881,63,945,176,1760,239,2705
12226,2012-05-29,2,1,5,14,0,2,1,1,0.82,0.7727,0.52,0.4179,80,1200,158,1580,238,2780
12227,2012-05-29,2,1,5,15,0,2,1,1,0.82,0.7727,0.49,0.3881,71,1065,185,1850,256,2915
12228,2012-05-29,2,1,5,16,0,2,1,1,0.82,0.7727,0.49,0.4925,73,1095,320,3200,393,4295
12229,2012-05-29,2,1,5,17,0,2,1,1,0.82,0.7576,0.46,0.4179,107,1605,674,6740,781,8345
12230,2012-05-29,2,1,5,18,0,2,1,1,0.8,0.7424,0.49,0.4925,78,1170,632,6320,710,7490
12231,2012-05-29,2,1,5,19,0,2,1,1,0.78,0.7121,0.52,0.3582,69,1035,457,4570,526,5605
12232,2012-05-29,2,1,5,20,0,2,1,3,0.7,0.6515,0.61,0.5224,36,540,168,1680,204,2220
12233,2012-05-29,2,1,5,21,0,2,1,3,0.6,0.5455,0.88,0.4478,3,45,68,680,71,725
12234,2012-05-29,2,1,5,22,0,2,1,2,0.62,0.5606,0.88,0.0896,2,30,53,530,55,560
12235,2012-05-29,2,1,5,23,0,2,1,3,0.62,0.5455,0.94,0.0,10,150,40,400,50,550
12236,2012-05-30,2,1,5,0,0,3,1,3,0.64,0.5758,0.89,0.1045,4,60,32,320,36,380
12237,2012-05-30,2,1,5,1,0,3,1,3,0.64,0.5758,0.89,0.194,0,0,4,40,4,40
12238,2012-05-30,2,1,5,2,0,3,1,3,0.62,0.5455,0.94,0.0896,1,15,4,40,5,55
12239,2012-05-30,2,1,5,3,0,3,1,3,0.62,0.5606,0.88,0.1343,0,0,5,50,5,50
12240,2012-05-30,2,1,5,4,0,3,1,2,0.62,0.5606,0.88,0.1343,0,0,6,60,6,60
12241,2012-05-30,2,1,5,5,0,3,1,2,0.62,0.5909,0.78,0.1343,1,15,40,400,41,415
12242,2012-05-30,2,1,5,6,0,3,1,2,0.6,0.5758,0.78,0.1045,5,75,139,1390,144,1465
12243,2012-05-30,2,1,5,7,0,3,1,3,0.6,0.5758,0.78,0.194,14,210,469,4690,483,4900
12244,2012-05-30,2,1,5,8,0,3,1,2,0.6,0.5909,0.73,0.1642,29,435,642,6420,671,6855
12245,2012-05-30,2,1,5,9,0,3,1,2,0.62,0.6061,0.69,0.194,23,345,282,2820,305,3165
12246,2012-05-30,2,1,5,10,0,3,1,2,0.62,0.6061,0.69,0.2836,39,585,138,1380,177,1965
12247,2012-05-30,2,1,5,11,0,3,1,2,0.66,0.6212,0.65,0.194,53,795,155,1550,208,2345
12248,2012-05-30,2,1,5,12,0,3,1,1,0.7,0.6515,0.54,0.0,33,495,220,2200,253,2695
12249,2012-05-30,2,1,5,13,0,3,1,1,0.7,0.6515,0.51,0.0,53,795,236,2360,289,3155
12250,2012-05-30,2,1,5,14,0,3,1,1,0.72,0.6515,0.42,0.1343,44,660,208,2080,252,2740
12251,2012-05-30,2,1,5,15,0,3,1,1,0.72,0.6667,0.51,0.1343,54,810,221,2210,275,3020
12252,2012-05-30,2,1,5,16,0,3,1,1,0.72,0.6667,0.51,0.1642,46,690,352,3520,398,4210
12253,2012-05-30,2,1,5,17,0,3,1,1,0.74,0.6667,0.48,0.0896,83,1245,756,7560,839,8805
12254,2012-05-30,2,1,5,18,0,3,1,1,0.74,0.6667,0.48,0.1642,50,750,746,7460,796,8210
12255,2012-05-30,2,1,5,19,0,3,1,1,0.72,0.6667,0.54,0.1642,50,750,506,5060,556,5810
12256,2012-05-30,2,1,5,20,0,3,1,2,0.54,0.5152,0.6,0.1343,57,855,374,3740,431,4595
12257,2012-05-30,2,1,5,21,0,3,1,1,0.68,0.6364,0.57,0.1045,41,615,263,2630,304,3245
12258,2012-05-30,2,1,5,22,0,3,1,1,0.66,0.6212,0.69,0.1045,26,390,191,1910,217,2300
12259,2012-05-30,2,1,5,23,0,3,1,1,0.66,0.6212,0.65,0.1045,39,585,121,1210,160,1795
12260,2012-05-31,2,1,5,0,0,4,1,1,0.64,0.6061,0.69,0.1343,13,195,48,480,61,675
12261,2012-05-31,2,1,5,1,0,4,1,1,0.64,0.6061,0.69,0.0896,4,60,22,220,26,280
12262,2012-05-31,2,1,5,2,0,4,1,1,0.64,0.6061,0.65,0.0896,6,90,8,80,14,170
12263,2012-05-31,2,1,5,3,0,4,1,1,0.62,0.6061,0.69,0.0896,0,0,8,80,8,80
12264,2012-05-31,2,1,5,4,0,4,1,1,0.62,0.6061,0.69,0.0,0,0,8,80,8,80
12265,2012-05-31,2,1,5,5,0,4,1,1,0.62,0.6061,0.69,0.2537,1,15,32,320,33,335
12266,2012-05-31,2,1,5,6,0,4,1,1,0.6,0.5909,0.73,0.2239,7,105,171,1710,178,1815
12267,2012-05-31,2,1,5,7,0,4,1,1,0.6,0.6061,0.64,0.2836,18,270,489,4890,507,5160
12268,2012-05-31,2,1,5,8,0,4,1,1,0.62,0.6212,0.57,0.2537,18,270,675,6750,693,7020
12269,2012-05-31,2,1,5,9,0,4,1,1,0.66,0.6212,0.47,0.2537,47,705,264,2640,311,3345
12270,2012-05-31,2,1,5,10,0,4,1,1,0.7,0.6364,0.39,0.3881,65,975,155,1550,220,2525
12271,2012-05-31,2,1,5,11,0,4,1,1,0.72,0.6515,0.37,0.2836,65,975,153,1530,218,2505
12272,2012-05-31,2,1,5,12,0,4,1,1,0.72,0.6515,0.37,0.194,62,930,230,2300,292,3230
12273,2012-05-31,2,1,5,13,0,4,1,1,0.74,0.6515,0.35,0.1343,77,1155,216,2160,293,3315
12274,2012-05-31,2,1,5,14,0,4,1,1,0.76,0.6667,0.31,0.194,61,915,193,1930,254,2845
12275,2012-05-31,2,1,5,15,0,4,1,1,0.76,0.6667,0.33,0.2985,81,1215,209,2090,290,3305
12276,2012-05-31,2,1,5,16,0,4,1,1,0.76,0.6667,0.33,0.2836,103,1545,384,3840,487,5385
12277,2012-05-31,2,1,5,17,0,4,1,1,0.76,0.6667,0.31,0.1642,85,1275,742,7420,827,8695
12278,2012-05-31,2,1,5,18,0,4,1,1,0.74,0.6515,0.3,0.194,85,1275,700,7000,785,8275
12279,2012-05-31,2,1,5,19,0,4,1,1,0.72,0.6515,0.34,0.1642,104,1560,487,4870,591,6430
12280,2012-05-31,2,1,5,20,0,4,1,1,0.68,0.6364,0.44,0.1642,88,1320,391,3910,479,5230
12281,2012-05-31,2,1,5,21,0,4,1,1,0.68,0.6364,0.44,0.1642,41,615,318,3180,359,3795
12282,2012-05-31,2,1,5,22,0,4,1,1,0.66,0.6212,0.5,0.1642,43,645,221,2210,264,2855
12283,2012-05-31,2,1,5,23,0,4,1,1,0.66,0.6212,0.54,0.2239,26,390,114,1140,140,1530
12284,2012-06-01,2,1,6,0,0,5,1,1,0.66,0.6212,0.5,0.2537,10,150,76,760,86,910
12285,2012-06-01,2,1,6,1,0,5,1,1,0.64,0.6212,0.53,0.2239,0,0,34,340,34,340
12286,2012-06-01,2,1,6,2,0,5,1,1,0.64,0.6212,0.57,0.2239,3,45,13,130,16,175
12287,2012-06-01,2,1,6,3,0,5,1,2,0.62,0.5909,0.73,0.0896,0,0,4,40,4,40
12288,2012-06-01,2,1,6,4,0,5,1,2,0.62,0.5909,0.73,0.0896,1,15,5,50,6,65
12289,2012-06-01,2,1,6,5,0,5,1,2,0.62,0.5909,0.78,0.0896,4,60,41,410,45,470
12290,2012-06-01,2,1,6,6,0,5,1,3,0.62,0.5606,0.88,0.1343,5,75,136,1360,141,1435
12291,2012-06-01,2,1,6,7,0,5,1,2,0.64,0.5758,0.89,0.194,33,495,369,3690,402,4185
12292,2012-06-01,2,1,6,8,0,5,1,2,0.64,0.5758,0.89,0.194,19,285,675,6750,694,7035
12293,2012-06-01,2,1,6,9,0,5,1,2,0.64,0.5758,0.83,0.2239,24,360,274,2740,298,3100
12294,2012-06-01,2,1,6,10,0,5,1,2,0.66,0.6061,0.78,0.2836,49,735,155,1550,204,2285
12295,2012-06-01,2,1,6,11,0,5,1,2,0.7,0.6667,0.74,0.2836,42,630,193,1930,235,2560
12296,2012-06-01,2,1,6,12,0,5,1,2,0.7,0.6667,0.74,0.3582,72,1080,238,2380,310,3460
12297,2012-06-01,2,1,6,13,0,5,1,1,0.72,0.6818,0.7,0.2985,76,1140,240,2400,316,3540
12298,2012-06-01,2,1,6,14,0,5,1,3,0.72,0.6818,0.66,0.2836,55,825,199,1990,254,2815
12299,2012-06-01,2,1,6,15,0,5,1,3,0.72,0.6818,0.66,0.2836,45,675,213,2130,258,2805
12300,2012-06-01,2,1,6,16,0,5,1,3,0.74,0.6818,0.58,0.4478,36,540,186,1860,222,2400
12301,2012-06-01,2,1,6,17,0,5,1,3,0.7,0.6515,0.7,0.2537,25,375,202,2020,227,2395
12302,2012-06-01,2,1,6,18,0,5,1,3,0.62,0.5606,0.88,0.3582,10,150,100,1000,110,1150
12303,2012-06-01,2,1,6,19,0,5,1,3,0.62,0.5606,0.88,0.3582,4,60,41,410,45,470
12304,2012-06-01,2,1,6,20,0,5,1,3,0.62,0.5455,0.94,0.2537,1,15,38,380,39,395
12305,2012-06-01,2,1,6,21,0,5,1,3,0.64,0.5909,0.78,0.2537,12,180,73,730,85,910
12306,2012-06-01,2,1,6,22,0,5,1,3,0.6,0.5455,0.88,0.1343,1,15,22,220,23,235
12307,2012-06-01,2,1,6,23,0,5,1,3,0.6,0.5455,0.88,0.1343,6,90,67,670,73,760
12308,2012-06-02,2,1,6,0,0,6,0,2,0.56,0.5303,0.83,0.1343,5,75,81,810,86,885
12309,2012-06-02,2,1,6,1,0,6,0,2,0.56,0.5303,0.83,0.1045,15,225,61,610,76,835
12310,2012-06-02,2,1,6,2,0,6,0,2,0.54,0.5152,0.88,0.0,3,45,38,380,41,425
12311,2012-06-02,2,1,6,3,0,6,0,1,0.56,0.5303,0.73,0.2537,8,120,18,180,26,300
12312,2012-06-02,2,1,6,4,0,6,0,1,0.54,0.5152,0.68,0.2836,2,30,11,110,13,140
12313,2012-06-02,2,1,6,5,0,6,0,1,0.5,0.4848,0.72,0.194,1,15,11,110,12,125
12314,2012-06-02,2,1,6,6,0,6,0,2,0.5,0.4848,0.77,0.194,5,75,31,310,36,385
12315,2012-06-02,2,1,6,7,0,6,0,1,0.52,0.5,0.72,0.1045,9,135,77,770,86,905
12316,2012-06-02,2,1,6,8,0,6,0,1,0.54,0.5152,0.64,0.1642,30,450,180,1800,210,2250
12317,2012-06-02,2,1,6,9,0,6,0,1,0.56,0.5303,0.6,0.2537,89,1335,243,2430,332,3765
12318,2012-06-02,2,1,6,10,0,6,0,1,0.6,0.6212,0.53,0.2985,145,2175,348,3480,493,5655
12319,2012-06-02,2,1,6,11,0,6,0,1,0.58,0.5455,0.46,0.2836,179,2685,357,3570,536,6255
12320,2012-06-02,2,1,6,12,0,6,0,1,0.62,0.6212,0.43,0.3582,250,3750,418,4180,668,7930
12321,2012-06-02,2,1,6,13,0,6,0,1,0.62,0.6212,0.41,0.2537,279,4185,400,4000,679,8185
12322,2012-06-02,2,1,6,14,0,6,0,1,0.64,0.6212,0.38,0.2985,259,3885,388,3880,647,7765
12323,2012-06-02,2,1,6,15,0,6,0,1,0.64,0.6212,0.38,0.2537,297,4455,405,4050,702,8505
12324,2012-06-02,2,1,6,16,0,6,0,1,0.64,0.6212,0.38,0.2537,275,4125,369,3690,644,7815
12325,2012-06-02,2,1,6,17,0,6,0,1,0.64,0.6212,0.36,0.0,248,3720,338,3380,586,7100
12326,2012-06-02,2,1,6,18,0,6,0,1,0.64,0.6212,0.36,0.0,171,2565,341,3410,512,5975
12327,2012-06-02,2,1,6,19,0,6,0,1,0.64,0.6212,0.36,0.1642,185,2775,369,3690,554,6465
12328,2012-06-02,2,1,6,20,0,6,0,1,0.62,0.6212,0.35,0.2836,139,2085,260,2600,399,4685
12329,2012-06-02,2,1,6,21,0,6,0,1,0.6,0.6212,0.4,0.1045,96,1440,220,2200,316,3640
12330,2012-06-02,2,1,6,22,0,6,0,1,0.58,0.5455,0.46,0.1343,52,780,176,1760,228,2540
12331,2012-06-02,2,1,6,23,0,6,0,1,0.56,0.5303,0.52,0.1045,53,795,185,1850,238,2645
12332,2012-06-03,2,1,6,0,0,0,0,1,0.54,0.5152,0.6,0.1642,27,405,142,1420,169,1825
12333,2012-06-03,2,1,6,1,0,0,0,1,0.54,0.5152,0.56,0.1343,21,315,100,1000,121,1315
12334,2012-06-03,2,1,6,2,0,0,0,1,0.52,0.5,0.59,0.1045,22,330,67,670,89,1000
12335,2012-06-03,2,1,6,3,0,0,0,1,0.52,0.5,0.63,0.1045,16,240,34,340,50,580
12336,2012-06-03,2,1,6,4,0,0,0,1,0.5,0.4848,0.72,0.0896,1,15,12,120,13,135
12337,2012-06-03,2,1,6,5,0,0,0,1,0.5,0.4848,0.68,0.0,1,15,11,110,12,125
12338,2012-06-03,2,1,6,6,0,0,0,1,0.46,0.4545,0.82,0.1045,6,90,16,160,22,250
12339,2012-06-03,2,1,6,7,0,0,0,1,0.5,0.4848,0.68,0.1045,6,90,29,290,35,380
12340,2012-06-03,2,1,6,8,0,0,0,1,0.54,0.5152,0.6,0.0896,30,450,110,1100,140,1550
12341,2012-06-03,2,1,6,9,0,0,0,1,0.6,0.6212,0.46,0.194,70,1050,230,2300,300,3350
12342,2012-06-03,2,1,6,10,0,0,0,1,0.62,0.6212,0.43,0.2239,127,1905,277,2770,404,4675
12343,2012-06-03,2,1,6,11,0,0,0,1,0.64,0.6212,0.41,0.2537,199,2985,312,3120,511,6105
12344,2012-06-03,2,1,6,12,0,0,0,1,0.66,0.6212,0.39,0.2985,276,4140,408,4080,684,8220
12345,2012-06-03,2,1,6,13,0,0,0,1,0.68,0.6364,0.36,0.2836,265,3975,421,4210,686,8185
12346,2012-06-03,2,1,6,14,0,0,0,1,0.68,0.6364,0.36,0.3284,267,4005,411,4110,678,8115
12347,2012-06-03,2,1,6,15,0,0,0,1,0.7,0.6364,0.34,0.0,236,3540,408,4080,644,7620
12348,2012-06-03,2,1,6,16,0,0,0,1,0.7,0.6364,0.34,0.2985,226,3390,436,4360,662,7750
12349,2012-06-03,2,1,6,17,0,0,0,1,0.7,0.6364,0.34,0.2537,192,2880,386,3860,578,6740
12350,2012-06-03,2,1,6,18,0,0,0,1,0.7,0.6364,0.34,0.2537,153,2295,343,3430,496,5725
12351,2012-06-03,2,1,6,19,0,0,0,1,0.68,0.6364,0.34,0.2836,116,1740,337,3370,453,5110
12352,2012-06-03,2,1,6,20,0,0,0,1,0.66,0.6212,0.39,0.194,84,1260,230,2300,314,3560
12353,2012-06-03,2,1,6,21,0,0,0,1,0.62,0.6212,0.43,0.1642,66,990,180,1800,246,2790
12354,2012-06-03,2,1,6,22,0,0,0,1,0.62,0.6212,0.5,0.3881,61,915,165,1650,226,2565
12355,2012-06-03,2,1,6,23,0,0,0,1,0.58,0.5455,0.53,0.1045,26,390,82,820,108,1210
12356,2012-06-04,2,1,6,0,0,1,1,1,0.58,0.5455,0.53,0.0,11,165,38,380,49,545
12357,2012-06-04,2,1,6,1,0,1,1,3,0.56,0.5303,0.6,0.1642,4,60,10,100,14,160
12358,2012-06-04,2,1,6,2,0,1,1,1,0.56,0.5303,0.6,0.2239,1,15,10,100,11,115
12359,2012-06-04,2,1,6,3,0,1,1,2,0.56,0.5303,0.6,0.1642,0,0,5,50,5,50
12360,2012-06-04,2,1,6,4,0,1,1,1,0.54,0.5152,0.64,0.0896,2,30,6,60,8,90
12361,2012-06-04,2,1,6,5,0,1,1,1,0.52,0.5,0.68,0.0,2,30,33,330,35,360
12362,2012-06-04,2,1,6,6,0,1,1,1,0.52,0.5,0.68,0.0,4,60,135,1350,139,1410
12363,2012-06-04,2,1,6,7,0,1,1,1,0.56,0.5303,0.6,0.2239,13,195,504,5040,517,5235
12364,2012-06-04,2,1,6,8,0,1,1,1,0.6,0.6212,0.49,0.2239,22,330,643,6430,665,6760
12365,2012-06-04,2,1,6,9,0,1,1,1,0.62,0.6212,0.43,0.2836,38,570,244,2440,282,3010
12366,2012-06-04,2,1,6,10,0,1,1,1,0.64,0.6212,0.41,0.4627,67,1005,120,1200,187,2205
12367,2012-06-04,2,1,6,11,0,1,1,1,0.64,0.6212,0.38,0.4925,71,1065,168,1680,239,2745
12368,2012-06-04,2,1,6,12,0,1,1,1,0.64,0.6212,0.41,0.4478,62,930,220,2200,282,3130
12369,2012-06-04,2,1,6,13,0,1,1,1,0.64,0.6212,0.41,0.3582,85,1275,189,1890,274,3165
12370,2012-06-04,2,1,6,14,0,1,1,1,0.62,0.6212,0.41,0.4925,84,1260,186,1860,270,3120
12371,2012-06-04,2,1,6,15,0,1,1,1,0.66,0.6212,0.39,0.2985,77,1155,215,2150,292,3305
12372,2012-06-04,2,1,6,16,0,1,1,1,0.66,0.6212,0.39,0.4627,73,1095,375,3750,448,4845
12373,2012-06-04,2,1,6,17,0,1,1,1,0.64,0.6212,0.38,0.4478,101,1515,733,7330,834,8845
12374,2012-06-04,2,1,6,18,0,1,1,1,0.64,0.6212,0.38,0.3881,103,1545,719,7190,822,8735
12375,2012-06-04,2,1,6,19,0,1,1,1,0.62,0.6212,0.38,0.4179,91,1365,554,5540,645,6905
12376,2012-06-04,2,1,6,20,0,1,1,1,0.6,0.6212,0.4,0.3582,71,1065,390,3900,461,4965
12377,2012-06-04,2,1,6,21,0,1,1,1,0.58,0.5455,0.49,0.2537,40,600,225,2250,265,2850
12378,2012-06-04,2,1,6,22,0,1,1,1,0.56,0.5303,0.52,0.2836,41,615,127,1270,168,1885
12379,2012-06-04,2,1,6,23,0,1,1,1,0.58,0.5455,0.49,0.2985,8,120,78,780,86,900
12380,2012-06-05,2,1,6,0,0,2,1,1,0.54,0.5152,0.68,0.4179,6,90,28,280,34,370
12381,2012-06-05,2,1,6,1,0,2,1,2,0.52,0.5,0.77,0.3284,2,30,18,180,20,210
12382,2012-06-05,2,1,6,2,0,2,1,3,0.52,0.5,0.72,0.2985,0,0,8,80,8,80
12383,2012-06-05,2,1,6,3,0,2,1,3,0.5,0.4848,0.82,0.194,0,0,5,50,5,50
12384,2012-06-05,2,1,6,4,0,2,1,3,0.5,0.4848,0.82,0.194,1,15,4,40,5,55
12385,2012-06-05,2,1,6,5,0,2,1,3,0.48,0.4697,0.82,0.1642,1,15,35,350,36,365
12386,2012-06-05,2,1,6,6,0,2,1,1,0.48,0.4697,0.82,0.2537,7,105,177,1770,184,1875
12387,2012-06-05,2,1,6,7,0,2,1,1,0.48,0.4697,0.77,0.2985,29,435,540,5400,569,5835
12388,2012-06-05,2,1,6,8,0,2,1,2,0.48,0.4697,0.77,0.2239,30,450,680,6800,710,7250
12389,2012-06-05,2,1,6,9,0,2,1,2,0.52,0.5,0.72,0.2537,50,750,285,2850,335,3600
12390,2012-06-05,2,1,6,10,0,2,1,2,0.52,0.5,0.63,0.2985,58,870,118,1180,176,2050
12391,2012-06-05,2,1,6,11,0,2,1,2,0.56,0.5303,0.56,0.194,65,975,162,1620,227,2595
12392,2012-06-05,2,1,6,12,0,2,1,2,0.54,0.5152,0.56,0.2239,45,675,202,2020,247,2695
12393,2012-06-05,2,1,6,13,0,2,1,2,0.6,0.6212,0.46,0.1642,66,990,201,2010,267,3000
12394,2012-06-05,2,1,6,14,0,2,1,2,0.58,0.5455,0.46,0.1642,82,1230,194,1940,276,3170
12395,2012-06-05,2,1,6,15,0,2,1,2,0.58,0.5455,0.46,0.1343,54,810,218,2180,272,2990
12396,2012-06-05,2,1,6,16,0,2,1,1,0.6,0.6212,0.43,0.194,91,1365,382,3820,473,5185
12397,2012-06-05,2,1,6,17,0,2,1,1,0.6,0.6212,0.43,0.0,86,1290,764,7640,850,8930
12398,2012-06-05,2,1,6,18,0,2,1,1,0.6,0.6212,0.43,0.194,111,1665,679,6790,790,8455
12399,2012-06-05,2,1,6,19,0,2,1,1,0.58,0.5455,0.46,0.2537,68,1020,445,4450,513,5470
12400,2012-06-05,2,1,6,20,0,2,1,1,0.56,0.5303,0.49,0.2239,44,660,371,3710,415,4370
12401,2012-06-05,2,1,6,21,0,2,1,1,0.54,0.5152,0.56,0.1642,30,450,253,2530,283,2980
12402,2012-06-05,2,1,6,22,0,2,1,1,0.56,0.5303,0.52,0.1045,22,330,171,1710,193,2040
12403,2012-06-05,2,1,6,23,0,2,1,1,0.54,0.5152,0.56,0.0896,20,300,93,930,113,1230
12404,2012-06-06,2,1,6,0,0,3,1,1,0.52,0.5,0.59,0.0896,3,45,46,460,49,505
12405,2012-06-06,2,1,6,1,0,3,1,1,0.52,0.5,0.68,0.0,6,90,21,210,27,300
12406,2012-06-06,2,1,6,2,0,3,1,1,0.5,0.4848,0.68,0.0,4,60,7,70,11,130
12407,2012-06-06,2,1,6,3,0,3,1,1,0.46,0.4545,0.82,0.0,0,0,8,80,8,80
12408,2012-06-06,2,1,6,4,0,3,1,1,0.46,0.4545,0.82,0.1045,3,45,7,70,10,115
12409,2012-06-06,2,1,6,5,0,3,1,1,0.48,0.4697,0.77,0.0,1,15,37,370,38,385
12410,2012-06-06,2,1,6,6,0,3,1,1,0.48,0.4697,0.77,0.0,7,105,165,1650,172,1755
12411,2012-06-06,2,1,6,7,0,3,1,1,0.5,0.4848,0.72,0.0,16,240,531,5310,547,5550
12412,2012-06-06,2,1,6,8,0,3,1,1,0.54,0.5152,0.68,0.0,31,465,637,6370,668,6835
12413,2012-06-06,2,1,6,9,0,3,1,1,0.56,0.5303,0.6,0.0896,35,525,268,2680,303,3205
12414,2012-06-06,2,1,6,10,0,3,1,1,0.6,0.6212,0.46,0.0896,55,825,148,1480,203,2305
12415,2012-06-06,2,1,6,11,0,3,1,1,0.62,0.6212,0.43,0.0896,65,975,161,1610,226,2585
12416,2012-06-06,2,1,6,12,0,3,1,1,0.62,0.6212,0.38,0.0,80,1200,235,2350,315,3550
12417,2012-06-06,2,1,6,13,0,3,1,1,0.62,0.6212,0.41,0.0896,73,1095,230,2300,303,3395
12418,2012-06-06,2,1,6,14,0,3,1,1,0.64,0.6212,0.38,0.0,111,1665,191,1910,302,3575
12419,2012-06-06,2,1,6,15,0,3,1,1,0.64,0.6212,0.38,0.0,75,1125,225,2250,300,3375
12420,2012-06-06,2,1,6,16,0,3,1,1,0.64,0.6212,0.41,0.1343,107,1605,345,3450,452,5055
12421,2012-06-06,2,1,6,17,0,3,1,1,0.62,0.6212,0.43,0.1343,72,1080,652,6520,724,7600
12422,2012-06-06,2,1,6,18,0,3,1,3,0.6,0.6212,0.53,0.194,94,1410,688,6880,782,8290
12423,2012-06-06,2,1,6,19,0,3,1,1,0.56,0.5303,0.73,0.2985,52,780,486,4860,538,5640
12424,2012-06-06,2,1,6,20,0,3,1,1,0.54,0.5152,0.73,0.2836,59,885,349,3490,408,4375
12425,2012-06-06,2,1,6,21,0,3,1,1,0.54,0.5152,0.73,0.1642,38,570,260,2600,298,3170
12426,2012-06-06,2,1,6,22,0,3,1,1,0.52,0.5,0.77,0.0896,27,405,221,2210,248,2615
12427,2012-06-06,2,1,6,23,0,3,1,1,0.52,0.5,0.77,0.0,13,195,110,1100,123,1295
12428,2012-06-07,2,1,6,0,0,4,1,1,0.52,0.5,0.77,0.1343,9,135,50,500,59,635
12429,2012-06-07,2,1,6,1,0,4,1,1,0.52,0.5,0.77,0.1642,5,75,17,170,22,245
12430,2012-06-07,2,1,6,2,0,4,1,1,0.52,0.5,0.77,0.0896,0,0,12,120,12,120
12431,2012-06-07,2,1,6,3,0,4,1,1,0.5,0.4848,0.77,0.1045,0,0,5,50,5,50
12432,2012-06-07,2,1,6,4,0,4,1,1,0.46,0.4545,0.88,0.1045,0,0,6,60,6,60
12433,2012-06-07,2,1,6,5,0,4,1,1,0.48,0.4697,0.82,0.0896,0,0,34,340,34,340
12434,2012-06-07,2,1,6,6,0,4,1,1,0.46,0.4545,0.88,0.1045,5,75,165,1650,170,1725
12435,2012-06-07,2,1,6,7,0,4,1,1,0.5,0.4848,0.82,0.1642,20,300,506,5060,526,5360
12436,2012-06-07,2,1,6,8,0,4,1,1,0.52,0.5,0.77,0.0,20,300,661,6610,681,6910
12437,2012-06-07,2,1,6,9,0,4,1,1,0.58,0.5455,0.68,0.0,37,555,300,3000,337,3555
12438,2012-06-07,2,1,6,10,0,4,1,1,0.6,0.6061,0.64,0.0896,56,840,154,1540,210,2380
12439,2012-06-07,2,1,6,11,0,4,1,1,0.66,0.6212,0.47,0.2239,67,1005,170,1700,237,2705
12440,2012-06-07,2,1,6,12,0,4,1,1,0.7,0.6364,0.42,0.0,62,930,274,2740,336,3670
12441,2012-06-07,2,1,6,13,0,4,1,1,0.7,0.6364,0.37,0.2836,65,975,250,2500,315,3475
12442,2012-06-07,2,1,6,14,0,4,1,1,0.72,0.6515,0.37,0.2537,67,1005,198,1980,265,2985
12443,2012-06-07,2,1,6,15,0,4,1,1,0.74,0.6515,0.3,0.0,99,1485,234,2340,333,3825
12444,2012-06-07,2,1,6,16,0,4,1,1,0.72,0.6515,0.34,0.2239,77,1155,389,3890,466,5045
12445,2012-06-07,2,1,6,17,0,4,1,1,0.72,0.6515,0.34,0.2537,91,1365,778,7780,869,9145
12446,2012-06-07,2,1,6,18,0,4,1,1,0.7,0.6364,0.34,0.2836,110,1650,703,7030,813,8680
12447,2012-06-07,2,1,6,19,0,4,1,1,0.7,0.6364,0.34,0.2836,65,975,537,5370,602,6345
12448,2012-06-07,2,1,6,20,0,4,1,1,0.66,0.6212,0.36,0.2985,76,1140,402,4020,478,5160
12449,2012-06-07,2,1,6,21,0,4,1,1,0.62,0.6212,0.41,0.3284,30,450,283,2830,313,3280
12450,2012-06-07,2,1,6,22,0,4,1,1,0.6,0.6212,0.46,0.1642,35,525,193,1930,228,2455
12451,2012-06-07,2,1,6,23,0,4,1,1,0.56,0.5303,0.52,0.1343,42,630,135,1350,177,1980
12452,2012-06-08,2,1,6,0,0,5,1,1,0.56,0.5303,0.56,0.1642,18,270,59,590,77,860
12453,2012-06-08,2,1,6,1,0,5,1,1,0.56,0.5303,0.56,0.1642,4,60,25,250,29,310
12454,2012-06-08,2,1,6,2,0,5,1,1,0.56,0.5303,0.56,0.0,2,30,17,170,19,200
12455,2012-06-08,2,1,6,3,0,5,1,1,0.54,0.5152,0.6,0.0896,0,0,8,80,8,80
12456,2012-06-08,2,1,6,4,0,5,1,1,0.52,0.5,0.63,0.0,1,15,9,90,10,105
12457,2012-06-08,2,1,6,5,0,5,1,1,0.5,0.4848,0.72,0.1045,1,15,28,280,29,295
12458,2012-06-08,2,1,6,6,0,5,1,1,0.52,0.5,0.68,0.0896,8,120,131,1310,139,1430
12459,2012-06-08,2,1,6,7,0,5,1,1,0.52,0.5,0.72,0.1045,19,285,409,4090,428,4375
12460,2012-06-08,2,1,6,8,0,5,1,1,0.58,0.5455,0.6,0.0896,37,555,663,6630,700,7185
12461,2012-06-08,2,1,6,9,0,5,1,1,0.62,0.6212,0.53,0.1642,47,705,335,3350,382,4055
12462,2012-06-08,2,1,6,10,0,5,1,1,0.66,0.6212,0.47,0.2537,62,930,187,1870,249,2800
12463,2012-06-08,2,1,6,11,0,5,1,1,0.7,0.6364,0.42,0.2537,65,975,199,1990,264,2965
12464,2012-06-08,2,1,6,12,0,5,1,1,0.72,0.6515,0.39,0.3284,89,1335,280,2800,369,4135
12465,2012-06-08,2,1,6,13,0,5,1,1,0.74,0.6515,0.37,0.2537,129,1935,287,2870,416,4805
12466,2012-06-08,2,1,6,14,0,5,1,1,0.76,0.6667,0.31,0.3881,128,1920,245,2450,373,4370
12467,2012-06-08,2,1,6,15,0,5,1,1,0.76,0.6667,0.29,0.2836,98,1470,299,2990,397,4460
12468,2012-06-08,2,1,6,16,0,5,1,1,0.76,0.6667,0.29,0.2985,111,1665,412,4120,523,5785
12469,2012-06-08,2,1,6,17,0,5,1,1,0.76,0.6667,0.29,0.194,114,1710,679,6790,793,8500
12470,2012-06-08,2,1,6,18,0,5,1,1,0.76,0.6667,0.27,0.2239,147,2205,576,5760,723,7965
12471,2012-06-08,2,1,6,19,0,5,1,1,0.74,0.6515,0.3,0.2239,95,1425,460,4600,555,6025
12472,2012-06-08,2,1,6,20,0,5,1,1,0.72,0.6515,0.32,0.1343,117,1755,291,2910,408,4665
12473,2012-06-08,2,1,6,21,0,5,1,1,0.7,0.6364,0.37,0.1343,83,1245,256,2560,339,3805
12474,2012-06-08,2,1,6,22,0,5,1,1,0.68,0.6364,0.41,0.1045,61,915,230,2300,291,3215
12475,2012-06-08,2,1,6,23,0,5,1,1,0.64,0.6212,0.57,0.1642,52,780,163,1630,215,2410
12476,2012-06-09,2,1,6,0,0,6,0,1,0.64,0.6212,0.53,0.1045,54,810,152,1520,206,2330
12477,2012-06-09,2,1,6,1,0,6,0,1,0.64,0.6212,0.53,0.0896,34,510,89,890,123,1400
12478,2012-06-09,2,1,6,2,0,6,0,1,0.64,0.6212,0.5,0.2239,21,315,68,680,89,995
12479,2012-06-09,2,1,6,3,0,6,0,1,0.62,0.6212,0.57,0.0,12,180,28,280,40,460
12480,2012-06-09,2,1,6,4,0,6,0,1,0.62,0.6212,0.57,0.0,2,30,6,60,8,90
12481,2012-06-09,2,1,6,5,0,6,0,1,0.6,0.6212,0.56,0.1045,4,60,15,150,19,210
12482,2012-06-09,2,1,6,6,0,6,0,1,0.56,0.5303,0.64,0.1045,17,255,63,630,80,885
12483,2012-06-09,2,1,6,7,0,6,0,1,0.58,0.5455,0.64,0.1045,26,390,61,610,87,1000
12484,2012-06-09,2,1,6,8,0,6,0,1,0.62,0.6061,0.61,0.1045,42,630,202,2020,244,2650
12485,2012-06-09,2,1,6,9,0,6,0,1,0.64,0.6212,0.57,0.1642,99,1485,241,2410,340,3895
12486,2012-06-09,2,1,6,10,0,6,0,1,0.7,0.6515,0.51,0.1045,168,2520,298,2980,466,5500
12487,2012-06-09,2,1,6,11,0,6,0,1,0.76,0.6667,0.35,0.0,218,3270,351,3510,569,6780
12488,2012-06-09,2,1,6,12,0,6,0,1,0.8,0.697,0.29,0.2537,196,2940,335,3350,531,6290
12489,2012-06-09,2,1,6,13,0,6,0,1,0.82,0.697,0.24,0.2836,236,3540,349,3490,585,7030
12490,2012-06-09,2,1,6,14,0,6,0,1,0.82,0.697,0.23,0.194,239,3585,354,3540,593,7125
12491,2012-06-09,2,1,6,15,0,6,0,1,0.84,0.7121,0.2,0.2985,218,3270,337,3370,555,6640
12492,2012-06-09,2,1,6,16,0,6,0,1,0.82,0.697,0.24,0.194,219,3285,315,3150,534,6435
12493,2012-06-09,2,1,6,17,0,6,0,1,0.84,0.7121,0.24,0.0,238,3570,257,2570,495,6140
12494,2012-06-09,2,1,6,18,0,6,0,1,0.82,0.697,0.24,0.2239,175,2625,276,2760,451,5385
12495,2012-06-09,2,1,6,19,0,6,0,1,0.8,0.697,0.29,0.1642,128,1920,232,2320,360,4240
12496,2012-06-09,2,1,6,20,0,6,0,1,0.76,0.6667,0.35,0.2239,125,1875,238,2380,363,4255
12497,2012-06-09,2,1,6,21,0,6,0,1,0.74,0.6515,0.4,0.194,105,1575,211,2110,316,3685
12498,2012-06-09,2,1,6,22,0,6,0,1,0.7,0.6515,0.58,0.1642,63,945,151,1510,214,2455
12499,2012-06-09,2,1,6,23,0,6,0,1,0.68,0.6364,0.61,0.1642,69,1035,161,1610,230,2645
12500,2012-06-10,2,1,6,0,0,0,0,1,0.66,0.6212,0.69,0.1045,33,495,125,1250,158,1745
12501,2012-06-10,2,1,6,1,0,0,0,1,0.64,0.6061,0.73,0.1343,32,480,84,840,116,1320
12502,2012-06-10,2,1,6,2,0,0,0,1,0.64,0.6061,0.69,0.1343,17,255,56,560,73,815
12503,2012-06-10,2,1,6,3,0,0,0,1,0.64,0.6061,0.73,0.1045,6,90,23,230,29,320
12504,2012-06-10,2,1,6,4,0,0,0,1,0.62,0.5909,0.78,0.0896,1,15,9,90,10,105
12505,2012-06-10,2,1,6,5,0,0,0,1,0.62,0.6061,0.69,0.0896,3,45,10,100,13,145
12506,2012-06-10,2,1,6,6,0,0,0,1,0.62,0.5909,0.73,0.0,3,45,27,270,30,315
12507,2012-06-10,2,1,6,7,0,0,0,1,0.6,0.5758,0.78,0.1045,21,315,41,410,62,725
12508,2012-06-10,2,1,6,8,0,0,0,1,0.64,0.6061,0.73,0.0896,59,885,122,1220,181,2105
12509,2012-06-10,2,1,6,9,0,0,0,1,0.7,0.6515,0.58,0.0,91,1365,175,1750,266,3115
12510,2012-06-10,2,1,6,10,0,0,0,1,0.76,0.6818,0.4,0.1045,148,2220,265,2650,413,4870
12511,2012-06-10,2,1,6,11,0,0,0,1,0.76,0.6818,0.45,0.0896,184,2760,315,3150,499,5910
12512,2012-06-10,2,1,6,12,0,0,0,1,0.82,0.7121,0.3,0.0,173,2595,329,3290,502,5885
12513,2012-06-10,2,1,6,13,0,0,0,1,0.84,0.7273,0.28,0.1343,204,3060,288,2880,492,5940
12514,2012-06-10,2,1,6,14,0,0,0,1,0.84,0.7273,0.3,0.1343,186,2790,314,3140,500,5930
12515,2012-06-10,2,1,6,15,0,0,0,1,0.84,0.7273,0.3,0.2239,159,2385,316,3160,475,5545
12516,2012-06-10,2,1,6,16,0,0,0,1,0.84,0.7424,0.36,0.2836,173,2595,335,3350,508,5945
12517,2012-06-10,2,1,6,17,0,0,0,1,0.82,0.7424,0.41,0.2836,184,2760,337,3370,521,6130
12518,2012-06-10,2,1,6,18,0,0,0,1,0.82,0.7273,0.38,0.2239,164,2460,326,3260,490,5720
12519,2012-06-10,2,1,6,19,0,0,0,1,0.82,0.7121,0.28,0.2836,115,1725,260,2600,375,4325
12520,2012-06-10,2,1,6,20,0,0,0,1,0.76,0.6818,0.48,0.1642,113,1695,250,2500,363,4195
12521,2012-06-10,2,1,6,21,0,0,0,1,0.72,0.6818,0.62,0.1642,83,1245,170,1700,253,2945
12522,2012-06-10,2,1,6,22,0,0,0,1,0.7,0.6515,0.65,0.1642,42,630,117,1170,159,1800
12523,2012-06-10,2,1,6,23,0,0,0,1,0.72,0.6667,0.58,0.1045,30,450,80,800,110,1250
12524,2012-06-11,2,1,6,0,0,1,1,1,0.7,0.6515,0.65,0.1045,8,120,33,330,41,450
12525,2012-06-11,2,1,6,1,0,1,1,1,0.66,0.6212,0.74,0.1642,9,135,15,150,24,285
12526,2012-06-11,2,1,6,2,0,1,1,1,0.66,0.6212,0.74,0.1045,5,75,12,120,17,195
12527,2012-06-11,2,1,6,3,0,1,1,1,0.64,0.5909,0.78,0.1045,2,30,4,40,6,70
12528,2012-06-11,2,1,6,4,0,1,1,1,0.64,0.5909,0.78,0.1343,0,0,7,70,7,70
12529,2012-06-11,2,1,6,5,0,1,1,1,0.64,0.5909,0.78,0.1343,1,15,36,360,37,375
12530,2012-06-11,2,1,6,6,0,1,1,1,0.62,0.5758,0.83,0.1045,8,120,136,1360,144,1480
12531,2012-06-11,2,1,6,7,0,1,1,1,0.64,0.5909,0.78,0.1045,25,375,478,4780,503,5155
12532,2012-06-11,2,1,6,8,0,1,1,1,0.66,0.6212,0.74,0.1343,38,570,613,6130,651,6700
12533,2012-06-11,2,1,6,9,0,1,1,1,0.7,0.6515,0.65,0.1343,57,855,259,2590,316,3445
12534,2012-06-11,2,1,6,10,0,1,1,1,0.72,0.6818,0.62,0.1642,52,780,95,950,147,1730
12535,2012-06-11,2,1,6,11,0,1,1,2,0.76,0.6818,0.48,0.2239,59,885,143,1430,202,2315
12536,2012-06-11,2,1,6,12,0,1,1,2,0.8,0.7273,0.43,0.194,63,945,198,1980,261,2925
12537,2012-06-11,2,1,6,13,0,1,1,2,0.8,0.7121,0.41,0.2985,63,945,185,1850,248,2795
12538,2012-06-11,2,1,6,14,0,1,1,2,0.82,0.7273,0.34,0.2836,66,990,193,1930,259,2920
12539,2012-06-11,2,1,6,15,0,1,1,1,0.8,0.7121,0.41,0.3582,72,1080,187,1870,259,2950
12540,2012-06-11,2,1,6,16,0,1,1,2,0.8,0.7121,0.41,0.4179,87,1305,340,3400,427,4705
12541,2012-06-11,2,1,6,17,0,1,1,2,0.8,0.7121,0.41,0.3582,85,1275,715,7150,800,8425
12542,2012-06-11,2,1,6,18,0,1,1,2,0.8,0.7273,0.43,0.2985,105,1575,726,7260,831,8835
12543,2012-06-11,2,1,6,19,0,1,1,2,0.76,0.6818,0.48,0.3284,89,1335,507,5070,596,6405
12544,2012-06-11,2,1,6,20,0,1,1,2,0.74,0.6667,0.48,0.2239,61,915,333,3330,394,4245
12545,2012-06-11,2,1,6,21,0,1,1,2,0.72,0.6667,0.58,0.194,32,480,218,2180,250,2660
12546,2012-06-11,2,1,6,22,0,1,1,2,0.72,0.6667,0.58,0.194,22,330,142,1420,164,1750
12547,2012-06-11,2,1,6,23,0,1,1,2,0.7,0.6515,0.58,0.2239,8,120,72,720,80,840
12548,2012-06-12,2,1,6,0,0,2,1,2,0.7,0.6515,0.58,0.2239,2,30,26,260,28,290
12549,2012-06-12,2,1,6,1,0,2,1,2,0.68,0.6364,0.65,0.1642,5,75,11,110,16,185
12550,2012-06-12,2,1,6,2,0,2,1,2,0.68,0.6364,0.65,0.194,0,0,6,60,6,60
12551,2012-06-12,2,1,6,3,0,2,1,2,0.66,0.6212,0.69,0.2537,3,45,9,90,12,135
12552,2012-06-12,2,1,6,4,0,2,1,3,0.6,0.5455,0.88,0.1642,0,0,4,40,4,40
12553,2012-06-12,2,1,6,5,0,2,1,3,0.6,0.5455,0.88,0.1343,1,15,28,280,29,295
12554,2012-06-12,2,1,6,6,0,2,1,2,0.6,0.5455,0.88,0.1343,6,90,130,1300,136,1390
12555,2012-06-12,2,1,6,7,0,2,1,3,0.62,0.5606,0.88,0.2537,16,240,287,2870,303,3110
12556,2012-06-12,2,1,6,8,0,2,1,2,0.62,0.5606,0.88,0.2239,15,225,598,5980,613,6205
12557,2012-06-12,2,1,6,9,0,2,1,2,0.64,0.5758,0.89,0.2836,31,465,254,2540,285,3005
12558,2012-06-12,2,1,6,10,0,2,1,3,0.64,0.5758,0.89,0.2836,29,435,96,960,125,1395
12559,2012-06-12,2,1,6,11,0,2,1,3,0.66,0.6061,0.83,0.3582,8,120,57,570,65,690
12560,2012-06-12,2,1,6,12,0,2,1,3,0.66,0.6061,0.83,0.2537,19,285,76,760,95,1045
12561,2012-06-12,2,1,6,13,0,2,1,3,0.66,0.6061,0.83,0.194,11,165,48,480,59,645
12562,2012-06-12,2,1,6,14,0,2,1,3,0.64,0.5758,0.89,0.2537,12,180,48,480,60,660
12563,2012-06-12,2,1,6,15,0,2,1,3,0.66,0.5909,0.89,0.194,22,330,94,940,116,1270
12564,2012-06-12,2,1,6,16,0,2,1,2,0.66,0.5909,0.89,0.2836,30,450,209,2090,239,2540
12565,2012-06-12,2,1,6,17,0,2,1,2,0.66,0.5909,0.89,0.2836,56,840,625,6250,681,7090
12566,2012-06-12,2,1,6,18,0,2,1,1,0.68,0.6364,0.83,0.194,57,855,596,5960,653,6815
12567,2012-06-12,2,1,6,19,0,2,1,1,0.68,0.6364,0.83,0.194,47,705,444,4440,491,5145
12568,2012-06-12,2,1,6,20,0,2,1,1,0.68,0.6364,0.83,0.194,36,540,350,3500,386,4040
12569,2012-06-12,2,1,6,21,0,2,1,1,0.68,0.6364,0.83,0.1045,41,615,233,2330,274,2945
12570,2012-06-12,2,1,6,22,0,2,1,1,0.66,0.5909,0.94,0.1045,19,285,188,1880,207,2165
12571,2012-06-12,2,1,6,23,0,2,1,3,0.66,0.5909,0.94,0.2239,11,165,78,780,89,945
12572,2012-06-13,2,1,6,0,0,3,1,2,0.66,0.5909,0.94,0.194,7,105,27,270,34,375
12573,2012-06-13,2,1,6,1,0,3,1,1,0.64,0.5909,0.78,0.0,7,105,21,210,28,315
12574,2012-06-13,2,1,6,2,0,3,1,1,0.62,0.5758,0.83,0.1343,0,0,4,40,4,40
12575,2012-06-13,2,1,6,3,0,3,1,1,0.62,0.5758,0.83,0.194,1,15,7,70,8,85
12576,2012-06-13,2,1,6,4,0,3,1,1,0.6,0.5606,0.83,0.1343,1,15,9,90,10,105
12577,2012-06-13,2,1,6,5,0,3,1,1,0.6,0.5606,0.83,0.194,2,30,38,380,40,410
12578,2012-06-13,2,1,6,6,0,3,1,1,0.6,0.5606,0.83,0.2239,6,90,188,1880,194,1970
12579,2012-06-13,2,1,6,7,0,3,1,1,0.6,0.5606,0.83,0.2985,25,375,480,4800,505,5175
12580,2012-06-13,2,1,6,8,0,3,1,2,0.62,0.5909,0.73,0.5224,41,615,672,6720,713,7335
12581,2012-06-13,2,1,6,9,0,3,1,2,0.64,0.6061,0.69,0.5821,54,810,298,2980,352,3790
12582,2012-06-13,2,1,6,10,0,3,1,2,0.64,0.6061,0.65,0.4179,64,960,134,1340,198,2300
12583,2012-06-13,2,1,6,11,0,3,1,2,0.66,0.6212,0.54,0.4478,64,960,182,1820,246,2780
12584,2012-06-13,2,1,6,12,0,3,1,2,0.68,0.6364,0.44,0.4179,93,1395,241,2410,334,3805
12585,2012-06-13,2,1,6,13,0,3,1,2,0.7,0.6364,0.45,0.3881,52,780,203,2030,255,2810
12586,2012-06-13,2,1,6,14,0,3,1,2,0.72,0.6515,0.37,0.4179,98,1470,222,2220,320,3690
12587,2012-06-13,2,1,6,15,0,3,1,1,0.72,0.6515,0.32,0.4925,65,975,216,2160,281,3135
12588,2012-06-13,2,1,6,16,0,3,1,1,0.72,0.6515,0.3,0.4925,72,1080,320,3200,392,4280
12589,2012-06-13,2,1,6,17,0,3,1,1,0.72,0.6515,0.32,0.4925,75,1125,782,7820,857,8945
12590,2012-06-13,2,1,6,18,0,3,1,1,0.72,0.6515,0.32,0.4478,104,1560,640,6400,744,7960
12591,2012-06-13,2,1,6,19,0,3,1,1,0.7,0.6364,0.34,0.3881,123,1845,548,5480,671,7325
12592,2012-06-13,2,1,6,20,0,3,1,1,0.68,0.6364,0.36,0.4179,86,1290,362,3620,448,4910
12593,2012-06-13,2,1,6,21,0,3,1,1,0.64,0.6212,0.44,0.3582,79,1185,317,3170,396,4355
12594,2012-06-13,2,1,6,22,0,3,1,1,0.62,0.6212,0.5,0.2985,29,435,209,2090,238,2525
12595,2012-06-13,2,1,6,23,0,3,1,1,0.62,0.6212,0.5,0.2836,25,375,128,1280,153,1655
12596,2012-06-14,2,1,6,0,0,4,1,1,0.6,0.6212,0.53,0.2985,3,45,45,450,48,495
12597,2012-06-14,2,1,6,1,0,4,1,1,0.6,0.6212,0.56,0.2239,4,60,17,170,21,230
12598,2012-06-14,2,1,6,2,0,4,1,2,0.62,0.6212,0.53,0.2537,1,15,8,80,9,95
12599,2012-06-14,2,1,6,3,0,4,1,2,0.62,0.6212,0.53,0.2836,1,15,4,40,5,55
12600,2012-06-14,2,1,6,4,0,4,1,2,0.6,0.6212,0.56,0.2537,0,0,6,60,6,60
12601,2012-06-14,2,1,6,5,0,4,1,2,0.6,0.6212,0.56,0.2537,0,0,40,400,40,400
12602,2012-06-14,2,1,6,6,0,4,1,1,0.58,0.5455,0.6,0.2836,12,180,169,1690,181,1870
12603,2012-06-14,2,1,6,7,0,4,1,1,0.6,0.6061,0.6,0.2836,26,390,480,4800,506,5190
12604,2012-06-14,2,1,6,8,0,4,1,1,0.6,0.6061,0.64,0.3284,37,555,682,6820,719,7375
12605,2012-06-14,2,1,6,9,0,4,1,1,0.62,0.6061,0.61,0.2239,45,675,312,3120,357,3795
12606,2012-06-14,2,1,6,10,0,4,1,1,0.64,0.6061,0.65,0.4179,47,705,132,1320,179,2025
12607,2012-06-14,2,1,6,11,0,4,1,1,0.66,0.6212,0.57,0.2537,60,900,168,1680,228,2580
12608,2012-06-14,2,1,6,12,0,4,1,2,0.66,0.6212,0.61,0.2239,55,825,210,2100,265,2925
12609,2012-06-14,2,1,6,13,0,4,1,1,0.68,0.6364,0.57,0.1642,71,1065,213,2130,284,3195
12610,2012-06-14,2,1,6,14,0,4,1,1,0.7,0.6515,0.54,0.2836,84,1260,214,2140,298,3400
12611,2012-06-14,2,1,6,15,0,4,1,1,0.74,0.6667,0.48,0.2985,111,1665,213,2130,324,3795
12612,2012-06-14,2,1,6,16,0,4,1,1,0.72,0.6667,0.51,0.2836,70,1050,368,3680,438,4730
12613,2012-06-14,2,1,6,17,0,4,1,1,0.72,0.6667,0.48,0.2239,117,1755,750,7500,867,9255
12614,2012-06-14,2,1,6,18,0,4,1,1,0.74,0.6667,0.42,0.194,107,1605,716,7160,823,8765
12615,2012-06-14,2,1,6,19,0,4,1,1,0.7,0.6515,0.48,0.2537,96,1440,483,4830,579,6270
12616,2012-06-14,2,1,6,20,0,4,1,1,0.66,0.6212,0.65,0.2537,84,1260,351,3510,435,4770
12617,2012-06-14,2,1,6,21,0,4,1,1,0.64,0.6061,0.65,0.1642,67,1005,270,2700,337,3705
12618,2012-06-14,2,1,6,22,0,4,1,2,0.64,0.6061,0.65,0.2239,46,690,196,1960,242,2650
12619,2012-06-14,2,1,6,23,0,4,1,2,0.62,0.6061,0.69,0.1642,36,540,136,1360,172,1900
12620,2012-06-15,2,1,6,0,0,5,1,1,0.6,0.5909,0.73,0.1642,26,390,68,680,94,1070
12621,2012-06-15,2,1,6,1,0,5,1,1,0.58,0.5455,0.78,0.194,9,135,42,420,51,555
12622,2012-06-15,2,1,6,2,0,5,1,1,0.56,0.5303,0.83,0.1045,0,0,15,150,15,150
12623,2012-06-15,2,1,6,3,0,5,1,1,0.56,0.5303,0.83,0.1642,2,30,3,30,5,60
12624,2012-06-15,2,1,6,4,0,5,1,1,0.56,0.5303,0.83,0.1642,1,15,13,130,14,145
12625,2012-06-15,2,1,6,5,0,5,1,1,0.54,0.5152,0.88,0.1045,2,30,31,310,33,340
12626,2012-06-15,2,1,6,6,0,5,1,1,0.54,0.5152,0.83,0.1343,9,135,142,1420,151,1555
12627,2012-06-15,2,1,6,7,0,5,1,1,0.56,0.5303,0.83,0.1642,17,255,413,4130,430,4385
12628,2012-06-15,2,1,6,8,0,5,1,1,0.6,0.5909,0.69,0.1642,44,660,609,6090,653,6750
12629,2012-06-15,2,1,6,9,0,5,1,1,0.62,0.6061,0.65,0.1642,58,870,308,3080,366,3950
12630,2012-06-15,2,1,6,10,0,5,1,1,0.64,0.6212,0.57,0.1642,56,840,160,1600,216,2440
12631,2012-06-15,2,1,6,11,0,5,1,1,0.66,0.6212,0.5,0.194,106,1590,180,1800,286,3390
12632,2012-06-15,2,1,6,12,0,5,1,1,0.7,0.6364,0.45,0.1642,111,1665,292,2920,403,4585
12633,2012-06-15,2,1,6,13,0,5,1,1,0.7,0.6364,0.42,0.2537,121,1815,272,2720,393,4535
12634,2012-06-15,2,1,6,14,0,5,1,1,0.72,0.6515,0.39,0.194,121,1815,255,2550,376,4365
12635,2012-06-15,2,1,6,15,0,5,1,1,0.72,0.6515,0.39,0.194,107,1605,270,2700,377,4305
12636,2012-06-15,2,1,6,16,0,5,1,1,0.72,0.6515,0.37,0.194,132,1980,426,4260,558,6240
12637,2012-06-15,2,1,6,17,0,5,1,1,0.74,0.6515,0.37,0.2836,125,1875,698,6980,823,8855
12638,2012-06-15,2,1,6,18,0,5,1,1,0.72,0.6515,0.39,0.2239,121,1815,572,5720,693,7535
12639,2012-06-15,2,1,6,19,0,5,1,1,0.7,0.6364,0.42,0.1642,98,1470,369,3690,467,5160
12640,2012-06-15,2,1,6,20,0,5,1,1,0.68,0.6364,0.44,0.194,89,1335,296,2960,385,4295
12641,2012-06-15,2,1,6,21,0,5,1,1,0.66,0.6212,0.5,0.1045,83,1245,250,2500,333,3745
12642,2012-06-15,2,1,6,22,0,5,1,1,0.64,0.6212,0.53,0.1343,79,1185,242,2420,321,3605
12643,2012-06-15,2,1,6,23,0,5,1,1,0.62,0.6212,0.53,0.2537,46,690,176,1760,222,2450
12644,2012-06-16,2,1,6,0,0,6,0,1,0.58,0.5455,0.56,0.1343,25,375,112,1120,137,1495
12645,2012-06-16,2,1,6,1,0,6,0,1,0.56,0.5303,0.56,0.0,16,240,79,790,95,1030
12646,2012-06-16,2,1,6,2,0,6,0,1,0.58,0.5455,0.53,0.0,12,180,55,550,67,730
12647,2012-06-16,2,1,6,3,0,6,0,1,0.56,0.5303,0.6,0.0896,8,120,19,190,27,310
12648,2012-06-16,2,1,6,4,0,6,0,1,0.54,0.5152,0.68,0.1343,3,45,5,50,8,95
12649,2012-06-16,2,1,6,5,0,6,0,1,0.54,0.5152,0.68,0.1045,2,30,21,210,23,240
12650,2012-06-16,2,1,6,6,0,6,0,1,0.54,0.5152,0.68,0.194,11,165,36,360,47,525
12651,2012-06-16,2,1,6,7,0,6,0,1,0.54,0.5152,0.68,0.194,10,150,68,680,78,830
12652,2012-06-16,2,1,6,8,0,6,0,1,0.58,0.5455,0.64,0.1642,47,705,157,1570,204,2275
12653,2012-06-16,2,1,6,9,0,6,0,1,0.6,0.6061,0.6,0.0896,88,1320,279,2790,367,4110
12654,2012-06-16,2,1,6,10,0,6,0,1,0.64,0.6212,0.47,0.194,139,2085,296,2960,435,5045
12655,2012-06-16,2,1,6,11,0,6,0,1,0.66,0.6212,0.39,0.1642,213,3195,353,3530,566,6725
12656,2012-06-16,2,1,6,12,0,6,0,1,0.68,0.6364,0.41,0.1045,254,3810,349,3490,603,7300
12657,2012-06-16,2,1,6,13,0,6,0,1,0.72,0.6515,0.34,0.1642,293,4395,324,3240,617,7635
12658,2012-06-16,2,1,6,14,0,6,0,1,0.72,0.6515,0.37,0.2239,264,3960,309,3090,573,7050
12659,2012-06-16,2,1,6,15,0,6,0,1,0.74,0.6515,0.35,0.2537,295,4425,288,2880,583,7305
12660,2012-06-16,2,1,6,16,0,6,0,2,0.72,0.6515,0.37,0.1045,238,3570,304,3040,542,6610
12661,2012-06-16,2,1,6,17,0,6,0,2,0.72,0.6515,0.37,0.2537,244,3660,349,3490,593,7150
12662,2012-06-16,2,1,6,18,0,6,0,2,0.72,0.6515,0.37,0.2239,256,3840,315,3150,571,6990
12663,2012-06-16,2,1,6,19,0,6,0,2,0.7,0.6364,0.42,0.194,184,2760,277,2770,461,5530
12664,2012-06-16,2,1,6,20,0,6,0,2,0.66,0.6212,0.47,0.194,123,1845,229,2290,352,4135
12665,2012-06-16,2,1,6,21,0,6,0,2,0.64,0.6212,0.5,0.2239,98,1470,192,1920,290,3390
12666,2012-06-16,2,1,6,22,0,6,0,1,0.62,0.6212,0.53,0.2985,91,1365,189,1890,280,3255
12667,2012-06-16,2,1,6,23,0,6,0,1,0.6,0.6212,0.53,0.2985,49,735,134,1340,183,2075
12668,2012-06-17,2,1,6,0,0,0,0,1,0.56,0.5303,0.56,0.1343,31,465,117,1170,148,1635
12669,2012-06-17,2,1,6,1,0,0,0,1,0.56,0.5303,0.6,0.1642,21,315,67,670,88,985
12670,2012-06-17,2,1,6,2,0,0,0,1,0.56,0.5303,0.56,0.0896,19,285,55,550,74,835
12671,2012-06-17,2,1,6,3,0,0,0,1,0.54,0.5152,0.64,0.1045,6,90,22,220,28,310
12672,2012-06-17,2,1,6,4,0,0,0,1,0.54,0.5152,0.64,0.0896,2,30,16,160,18,190
12673,2012-06-17,2,1,6,5,0,0,0,1,0.54,0.5152,0.68,0.1343,4,60,13,130,17,190
12674,2012-06-17,2,1,6,6,0,0,0,1,0.52,0.5,0.72,0.1045,7,105,16,160,23,265
12675,2012-06-17,2,1,6,7,0,0,0,1,0.52,0.5,0.72,0.0896,18,270,30,300,48,570
12676,2012-06-17,2,1,6,8,0,0,0,1,0.56,0.5303,0.68,0.2537,24,360,95,950,119,1310
12677,2012-06-17,2,1,6,9,0,0,0,1,0.56,0.5303,0.68,0.1642,91,1365,183,1830,274,3195
12678,2012-06-17,2,1,6,10,0,0,0,1,0.58,0.5455,0.64,0.0,148,2220,288,2880,436,5100
12679,2012-06-17,2,1,6,11,0,0,0,1,0.62,0.6212,0.57,0.1045,196,2940,350,3500,546,6440
12680,2012-06-17,2,1,6,12,0,0,0,1,0.62,0.6212,0.57,0.0,260,3900,355,3550,615,7450
12681,2012-06-17,2,1,6,13,0,0,0,1,0.64,0.6212,0.53,0.1642,267,4005,347,3470,614,7475
12682,2012-06-17,2,1,6,14,0,0,0,1,0.64,0.6212,0.53,0.0,255,3825,327,3270,582,7095
12683,2012-06-17,2,1,6,15,0,0,0,1,0.66,0.6212,0.5,0.2239,203,3045,260,2600,463,5645
12684,2012-06-17,2,1,6,16,0,0,0,1,0.66,0.6212,0.54,0.2985,240,3600,340,3400,580,7000
12685,2012-06-17,2,1,6,17,0,0,0,1,0.64,0.6212,0.57,0.2239,232,3480,361,3610,593,7090
12686,2012-06-17,2,1,6,18,0,0,0,1,0.64,0.6212,0.53,0.194,203,3045,310,3100,513,6145
12687,2012-06-17,2,1,6,19,0,0,0,1,0.64,0.6212,0.53,0.1642,146,2190,244,2440,390,4630
12688,2012-06-17,2,1,6,20,0,0,0,1,0.62,0.6212,0.57,0.194,101,1515,201,2010,302,3525
12689,2012-06-17,2,1,6,21,0,0,0,1,0.62,0.6212,0.57,0.194,76,1140,170,1700,246,2840
12690,2012-06-17,2,1,6,22,0,0,0,1,0.6,0.6061,0.6,0.194,55,825,98,980,153,1805
12691,2012-06-17,2,1,6,23,0,0,0,1,0.58,0.5455,0.64,0.194,29,435,79,790,108,1225
12692,2012-06-18,2,1,6,0,0,1,1,1,0.56,0.5303,0.73,0.2537,12,180,28,280,40,460
12693,2012-06-18,2,1,6,1,0,1,1,1,0.54,0.5152,0.77,0.2239,9,135,5,50,14,185
12694,2012-06-18,2,1,6,2,0,1,1,1,0.54,0.5152,0.77,0.2239,3,45,6,60,9,105
12695,2012-06-18,2,1,6,3,0,1,1,2,0.52,0.5,0.83,0.2239,1,15,3,30,4,45
12696,2012-06-18,2,1,6,4,0,1,1,2,0.54,0.5152,0.77,0.194,0,0,9,90,9,90
12697,2012-06-18,2,1,6,5,0,1,1,3,0.52,0.5,0.83,0.1343,1,15,22,220,23,235
12698,2012-06-18,2,1,6,6,0,1,1,3,0.52,0.5,0.88,0.1343,0,0,37,370,37,370
12699,2012-06-18,2,1,6,7,0,1,1,3,0.52,0.5,0.94,0.2239,10,150,135,1350,145,1500
12700,2012-06-18,2,1,6,8,0,1,1,2,0.54,0.5152,0.83,0.194,27,405,447,4470,474,4875
12701,2012-06-18,2,1,6,9,0,1,1,2,0.54,0.5152,0.83,0.2239,28,420,222,2220,250,2640
12702,2012-06-18,2,1,6,10,0,1,1,3,0.54,0.5152,0.88,0.1045,13,195,78,780,91,975
12703,2012-06-18,2,1,6,11,0,1,1,2,0.54,0.5152,0.88,0.1642,25,375,96,960,121,1335
12704,2012-06-18,2,1,6,12,0,1,1,3,0.56,0.5303,0.78,0.1343,29,435,139,1390,168,1825
12705,2012-06-18,2,1,6,13,0,1,1,2,0.58,0.5455,0.73,0.1343,51,765,174,1740,225,2505
12706,2012-06-18,2,1,6,14,0,1,1,2,0.58,0.5455,0.68,0.194,59,885,160,1600,219,2485
12707,2012-06-18,2,1,6,15,0,1,1,2,0.6,0.5909,0.69,0.194,61,915,176,1760,237,2675
12708,2012-06-18,2,1,6,16,0,1,1,2,0.6,0.5909,0.73,0.194,53,795,279,2790,332,3585
12709,2012-06-18,2,1,6,17,0,1,1,2,0.6,0.5909,0.73,0.194,54,810,669,6690,723,7500
12710,2012-06-18,2,1,6,18,0,1,1,2,0.62,0.6061,0.69,0.1642,47,705,595,5950,642,6655
12711,2012-06-18,2,1,6,19,0,1,1,2,0.62,0.5909,0.73,0.0896,52,780,411,4110,463,4890
12712,2012-06-18,2,1,6,20,0,1,1,2,0.62,0.5909,0.73,0.1343,45,675,317,3170,362,3845
12713,2012-06-18,2,1,6,21,0,1,1,2,0.62,0.5909,0.73,0.1045,35,525,238,2380,273,2905
12714,2012-06-18,2,1,6,22,0,1,1,2,0.62,0.5909,0.73,0.1642,21,315,143,1430,164,1745
12715,2012-06-18,2,1,6,23,0,1,1,3,0.6,0.5758,0.78,0.194,17,255,57,570,74,825
12716,2012-06-19,2,1,6,0,0,2,1,2,0.6,0.5758,0.78,0.1642,5,75,30,300,35,375
12717,2012-06-19,2,1,6,1,0,2,1,2,0.6,0.5758,0.78,0.1642,1,15,13,130,14,145
12718,2012-06-19,2,1,6,2,0,2,1,2,0.6,0.5758,0.78,0.1343,1,15,14,140,15,155
12719,2012-06-19,2,1,6,3,0,2,1,2,0.6,0.5758,0.78,0.1045,1,15,7,70,8,85
12720,2012-06-19,2,1,6,4,0,2,1,2,0.6,0.5758,0.78,0.1343,1,15,9,90,10,105
12721,2012-06-19,2,1,6,5,0,2,1,2,0.6,0.5758,0.78,0.194,3,45,34,340,37,385
12722,2012-06-19,2,1,6,6,0,2,1,2,0.6,0.5758,0.78,0.1045,9,135,152,1520,161,1655
12723,2012-06-19,2,1,6,7,0,2,1,2,0.6,0.5758,0.78,0.1343,18,270,462,4620,480,4890
12724,2012-06-19,2,1,6,8,0,2,1,2,0.6,0.5758,0.78,0.1642,40,600,633,6330,673,6930
12725,2012-06-19,2,1,6,9,0,2,1,1,0.64,0.6061,0.73,0.0896,40,600,288,2880,328,3480
12726,2012-06-19,2,1,6,10,0,2,1,1,0.64,0.6061,0.73,0.0896,44,660,136,1360,180,2020
12727,2012-06-19,2,1,6,11,0,2,1,1,0.66,0.6212,0.69,0.1343,56,840,174,1740,230,2580
12728,2012-06-19,2,1,6,12,0,2,1,1,0.7,0.6515,0.65,0.0896,70,1050,222,2220,292,3270
12729,2012-06-19,2,1,6,13,0,2,1,1,0.74,0.6818,0.58,0.1343,69,1035,203,2030,272,3065
12730,2012-06-19,2,1,6,14,0,2,1,1,0.76,0.7121,0.58,0.1045,61,915,166,1660,227,2575
12731,2012-06-19,2,1,6,15,0,2,1,1,0.78,0.7424,0.59,0.1642,72,1080,187,1870,259,2950
12732,2012-06-19,2,1,6,16,0,2,1,1,0.8,0.7576,0.55,0.2239,48,720,286,2860,334,3580
12733,2012-06-19,2,1,6,17,0,2,1,1,0.8,0.7576,0.55,0.194,86,1290,725,7250,811,8540
12734,2012-06-19,2,1,6,18,0,2,1,1,0.8,0.7576,0.55,0.1642,91,1365,704,7040,795,8405
12735,2012-06-19,2,1,6,19,0,2,1,1,0.8,0.7727,0.59,0.2239,82,1230,432,4320,514,5550
12736,2012-06-19,2,1,6,20,0,2,1,1,0.8,0.7576,0.55,0.2537,59,885,399,3990,458,4875
12737,2012-06-19,2,1,6,21,0,2,1,1,0.76,0.7121,0.62,0.1642,37,555,239,2390,276,2945
12738,2012-06-19,2,1,6,22,0,2,1,1,0.72,0.697,0.79,0.0896,51,765,240,2400,291,3165
12739,2012-06-19,2,1,6,23,0,2,1,1,0.72,0.697,0.79,0.1343,23,345,102,1020,125,1365
12740,2012-06-20,2,1,6,0,0,3,1,1,0.7,0.6667,0.79,0.194,5,75,48,480,53,555
12741,2012-06-20,2,1,6,1,0,3,1,1,0.68,0.6364,0.79,0.194,7,105,20,200,27,305
12742,2012-06-20,2,1,6,2,0,3,1,1,0.66,0.6061,0.83,0.1642,1,15,5,50,6,65
12743,2012-06-20,2,1,6,3,0,3,1,1,0.66,0.6061,0.83,0.1343,2,30,6,60,8,90
12744,2012-06-20,2,1,6,4,0,3,1,1,0.66,0.6061,0.83,0.0896,1,15,6,60,7,75
12745,2012-06-20,2,1,6,5,0,3,1,1,0.66,0.6061,0.83,0.0896,2,30,37,370,39,400
12746,2012-06-20,2,1,6,6,0,3,1,2,0.64,0.5758,0.89,0.0896,9,135,156,1560,165,1695
12747,2012-06-20,2,1,6,7,0,3,1,2,0.66,0.5909,0.89,0.0,20,300,444,4440,464,4740
12748,2012-06-20,2,1,6,8,0,3,1,2,0.7,0.6667,0.79,0.1045,43,645,600,6000,643,6645
12749,2012-06-20,2,1,6,9,0,3,1,2,0.72,0.697,0.74,0.0,40,600,276,2760,316,3360
12750,2012-06-20,2,1,6,10,0,3,1,1,0.82,0.7727,0.52,0.1343,41,615,126,1260,167,1875
12751,2012-06-20,2,1,6,11,0,3,1,1,0.84,0.7879,0.49,0.194,54,810,134,1340,188,2150
12752,2012-06-20,2,1,6,12,0,3,1,1,0.86,0.803,0.47,0.1642,30,450,150,1500,180,1950
12753,2012-06-20,2,1,6,13,0,3,1,1,0.86,0.7879,0.44,0.1045,48,720,163,1630,211,2350
12754,2012-06-20,2,1,6,14,0,3,1,1,0.88,0.803,0.39,0.194,56,840,134,1340,190,2180
12755,2012-06-20,2,1,6,15,0,3,1,1,0.9,0.8182,0.35,0.0,36,540,143,1430,179,1970
12756,2012-06-20,2,1,6,16,0,3,1,1,0.9,0.8182,0.35,0.1045,51,765,284,2840,335,3605
12757,2012-06-20,2,1,6,17,0,3,1,1,0.9,0.8182,0.37,0.0,80,1200,611,6110,691,7310
12758,2012-06-20,2,1,6,18,0,3,1,1,0.9,0.8182,0.37,0.0,81,1215,591,5910,672,7125
12759,2012-06-20,2,1,6,19,0,3,1,1,0.88,0.7879,0.37,0.2537,90,1350,449,4490,539,5840
12760,2012-06-20,2,1,6,20,0,3,1,1,0.86,0.7727,0.39,0.2239,81,1215,326,3260,407,4475
12761,2012-06-20,2,1,6,21,0,3,1,1,0.84,0.7576,0.44,0.0896,42,630,302,3020,344,3650
12762,2012-06-20,2,1,6,22,0,3,1,1,0.82,0.7576,0.46,0.1045,31,465,226,2260,257,2725
12763,2012-06-20,2,1,6,23,0,3,1,1,0.78,0.7424,0.59,0.1045,21,315,102,1020,123,1335
12764,2012-06-21,3,1,6,0,0,4,1,1,0.74,0.697,0.7,0.0896,16,240,53,530,69,770
12765,2012-06-21,3,1,6,1,0,4,1,1,0.72,0.697,0.79,0.1343,2,30,16,160,18,190
12766,2012-06-21,3,1,6,2,0,4,1,1,0.72,0.697,0.79,0.1045,11,165,7,70,18,235
12767,2012-06-21,3,1,6,3,0,4,1,1,0.72,0.697,0.74,0.0,3,45,8,80,11,125
12768,2012-06-21,3,1,6,4,0,4,1,1,0.7,0.6667,0.84,0.0896,1,15,11,110,12,125
12769,2012-06-21,3,1,6,5,0,4,1,1,0.7,0.6667,0.84,0.1045,3,45,37,370,40,415
12770,2012-06-21,3,1,6,6,0,4,1,2,0.7,0.6667,0.84,0.0896,3,45,147,1470,150,1515
12771,2012-06-21,3,1,6,7,0,4,1,2,0.7,0.6667,0.84,0.0896,26,390,437,4370,463,4760
12772,2012-06-21,3,1,6,8,0,4,1,1,0.74,0.697,0.7,0.0,27,405,563,5630,590,6035
12773,2012-06-21,3,1,6,9,0,4,1,1,0.8,0.7576,0.55,0.194,32,480,224,2240,256,2720
12774,2012-06-21,3,1,6,10,0,4,1,1,0.84,0.7879,0.49,0.1045,36,540,114,1140,150,1680
12775,2012-06-21,3,1,6,11,0,4,1,1,0.86,0.7879,0.41,0.1343,40,600,121,1210,161,1810
12776,2012-06-21,3,1,6,12,0,4,1,1,0.9,0.8182,0.35,0.194,33,495,182,1820,215,2315
12777,2012-06-21,3,1,6,13,0,4,1,1,0.9,0.8182,0.35,0.0,31,465,141,1410,172,1875
12778,2012-06-21,3,1,6,14,0,4,1,1,0.88,0.7879,0.37,0.1642,27,405,149,1490,176,1895
12779,2012-06-21,3,1,6,15,0,4,1,1,0.92,0.8333,0.33,0.1642,40,600,154,1540,194,2140
12780,2012-06-21,3,1,6,16,0,4,1,1,0.9,0.8182,0.35,0.1343,37,555,283,2830,320,3385
12781,2012-06-21,3,1,6,17,0,4,1,1,0.88,0.7879,0.37,0.0,80,1200,535,5350,615,6550
12782,2012-06-21,3,1,6,18,0,4,1,1,0.86,0.7879,0.41,0.194,78,1170,562,5620,640,6790
12783,2012-06-21,3,1,6,19,0,4,1,1,0.88,0.803,0.39,0.2239,84,1260,415,4150,499,5410
12784,2012-06-21,3,1,6,20,0,4,1,1,0.86,0.7879,0.44,0.194,79,1185,357,3570,436,4755
12785,2012-06-21,3,1,6,21,0,4,1,1,0.82,0.7727,0.52,0.194,55,825,256,2560,311,3385
12786,2012-06-21,3,1,6,22,0,4,1,1,0.8,0.7879,0.63,0.1642,22,330,221,2210,243,2540
12787,2012-06-21,3,1,6,23,0,4,1,1,0.8,0.7727,0.59,0.0896,12,180,134,1340,146,1520
12788,2012-06-22,3,1,6,0,0,5,1,2,0.76,0.7273,0.7,0.1045,16,240,77,770,93,1010
12789,2012-06-22,3,1,6,1,0,5,1,1,0.76,0.7424,0.75,0.1642,3,45,28,280,31,325
12790,2012-06-22,3,1,6,2,0,5,1,1,0.74,0.7121,0.79,0.0,0,0,12,120,12,120
12791,2012-06-22,3,1,6,3,0,5,1,1,0.74,0.7121,0.79,0.0,1,15,6,60,7,75
12792,2012-06-22,3,1,6,4,0,5,1,2,0.76,0.7273,0.66,0.0,3,45,7,70,10,115
12793,2012-06-22,3,1,6,5,0,5,1,2,0.74,0.697,0.66,0.0896,3,45,35,350,38,395
12794,2012-06-22,3,1,6,6,0,5,1,2,0.74,0.697,0.66,0.0,4,60,118,1180,122,1240
12795,2012-06-22,3,1,6,7,0,5,1,1,0.74,0.6818,0.58,0.1642,19,285,340,3400,359,3685
12796,2012-06-22,3,1,6,8,0,5,1,1,0.76,0.697,0.55,0.1343,49,735,564,5640,613,6375
12797,2012-06-22,3,1,6,9,0,5,1,1,0.76,0.7121,0.58,0.2239,55,825,278,2780,333,3605
12798,2012-06-22,3,1,6,10,0,5,1,1,0.8,0.7424,0.52,0.3582,52,780,133,1330,185,2110
12799,2012-06-22,3,1,6,11,0,5,1,1,0.8,0.7424,0.49,0.1642,76,1140,160,1600,236,2740
12800,2012-06-22,3,1,6,12,0,5,1,1,0.84,0.7879,0.49,0.1343,63,945,191,1910,254,2855
12801,2012-06-22,3,1,6,13,0,5,1,1,0.88,0.803,0.39,0.2239,72,1080,228,2280,300,3360
12802,2012-06-22,3,1,6,14,0,5,1,1,0.88,0.803,0.39,0.2239,65,975,198,1980,263,2955
12803,2012-06-22,3,1,6,15,0,5,1,1,0.9,0.8182,0.35,0.3582,72,1080,212,2120,284,3200
12804,2012-06-22,3,1,6,16,0,5,1,1,0.9,0.803,0.31,0.2239,67,1005,313,3130,380,4135
12805,2012-06-22,3,1,6,17,0,5,1,2,0.82,0.7273,0.38,0.1642,95,1425,551,5510,646,6935
12806,2012-06-22,3,1,6,18,0,5,1,2,0.8,0.7576,0.55,0.194,62,930,443,4430,505,5360
12807,2012-06-22,3,1,6,19,0,5,1,2,0.76,0.697,0.55,0.5224,45,675,317,3170,362,3845
12808,2012-06-22,3,1,6,20,0,5,1,2,0.76,0.697,0.55,0.5224,31,465,171,1710,202,2175
12809,2012-06-22,3,1,6,21,0,5,1,3,0.68,0.6364,0.65,0.2836,40,600,177,1770,217,2370
12810,2012-06-22,3,1,6,22,0,5,1,1,0.68,0.6364,0.69,0.1343,42,630,155,1550,197,2180
12811,2012-06-22,3,1,6,23,0,5,1,2,0.66,0.6212,0.74,0.0,29,435,145,1450,174,1885
12812,2012-06-23,3,1,6,0,0,6,0,1,0.64,0.5758,0.83,0.0,14,210,102,1020,116,1230
12813,2012-06-23,3,1,6,1,0,6,0,1,0.66,0.6061,0.78,0.1343,16,240,107,1070,123,1310
12814,2012-06-23,3,1,6,2,0,6,0,2,0.64,0.5758,0.83,0.194,18,270,75,750,93,1020
12815,2012-06-23,3,1,6,3,0,6,0,2,0.64,0.5758,0.83,0.0896,10,150,32,320,42,470
12816,2012-06-23,3,1,6,4,0,6,0,2,0.64,0.5758,0.83,0.1642,6,90,13,130,19,220
12817,2012-06-23,3,1,6,5,0,6,0,2,0.64,0.5758,0.83,0.194,1,15,11,110,12,125
12818,2012-06-23,3,1,6,6,0,6,0,1,0.64,0.5758,0.83,0.0896,10,150,37,370,47,520
12819,2012-06-23,3,1,6,7,0,6,0,1,0.64,0.5758,0.83,0.1642,19,285,59,590,78,875
12820,2012-06-23,3,1,6,8,0,6,0,1,0.68,0.6364,0.69,0.2239,34,510,133,1330,167,1840
12821,2012-06-23,3,1,6,9,0,6,0,1,0.72,0.6818,0.62,0.194,85,1275,247,2470,332,3745
12822,2012-06-23,3,1,6,10,0,6,0,1,0.74,0.6818,0.55,0.194,177,2655,317,3170,494,5825
12823,2012-06-23,3,1,6,11,0,6,0,1,0.76,0.6818,0.48,0.2239,167,2505,349,3490,516,5995
12824,2012-06-23,3,1,6,12,0,6,0,1,0.8,0.7273,0.43,0.194,203,3045,399,3990,602,7035
12825,2012-06-23,3,1,6,13,0,6,0,1,0.82,0.7273,0.34,0.194,226,3390,338,3380,564,6770
12826,2012-06-23,3,1,6,14,0,6,0,1,0.78,0.6818,0.33,0.2537,238,3570,371,3710,609,7280
12827,2012-06-23,3,1,6,15,0,6,0,1,0.84,0.7273,0.3,0.3284,217,3255,266,2660,483,5915
12828,2012-06-23,3,1,6,16,0,6,0,1,0.84,0.7121,0.26,0.2985,196,2940,317,3170,513,6110
12829,2012-06-23,3,1,6,17,0,6,0,1,0.82,0.7121,0.26,0.2537,214,3210,316,3160,530,6370
12830,2012-06-23,3,1,6,18,0,6,0,1,0.82,0.7121,0.26,0.2985,194,2910,287,2870,481,5780
12831,2012-06-23,3,1,6,19,0,6,0,1,0.8,0.697,0.27,0.194,185,2775,240,2400,425,5175
12832,2012-06-23,3,1,6,20,0,6,0,1,0.78,0.6818,0.31,0.194,158,2370,228,2280,386,4650
12833,2012-06-23,3,1,6,21,0,6,0,1,0.76,0.6667,0.33,0.1343,99,1485,223,2230,322,3715
12834,2012-06-23,3,1,6,22,0,6,0,1,0.74,0.6515,0.37,0.1045,101,1515,178,1780,279,3295
12835,2012-06-23,3,1,6,23,0,6,0,1,0.72,0.6515,0.44,0.0,69,1035,156,1560,225,2595
12836,2012-06-24,3,1,6,0,0,0,0,1,0.7,0.6515,0.51,0.0,31,465,132,1320,163,1785
12837,2012-06-24,3,1,6,1,0,0,0,2,0.68,0.6364,0.54,0.0896,39,585,88,880,127,1465
12838,2012-06-24,3,1,6,2,0,0,0,2,0.68,0.6364,0.51,0.0,34,510,80,800,114,1310
12839,2012-06-24,3,1,6,3,0,0,0,2,0.66,0.6212,0.65,0.0896,19,285,41,410,60,695
12840,2012-06-24,3,1,6,4,0,0,0,2,0.66,0.6212,0.65,0.0,4,60,9,90,13,150
12841,2012-06-24,3,1,6,5,0,0,0,1,0.62,0.6061,0.69,0.1343,1,15,7,70,8,85
12842,2012-06-24,3,1,6,6,0,0,0,1,0.64,0.6061,0.65,0.1642,6,90,19,190,25,280
12843,2012-06-24,3,1,6,7,0,0,0,1,0.64,0.6061,0.69,0.1045,23,345,48,480,71,825
12844,2012-06-24,3,1,6,8,0,0,0,1,0.7,0.6515,0.58,0.0,38,570,103,1030,141,1600
12845,2012-06-24,3,1,6,9,0,0,0,1,0.72,0.6667,0.51,0.0,63,945,169,1690,232,2635
12846,2012-06-24,3,1,6,10,0,0,0,1,0.76,0.6818,0.4,0.0,161,2415,291,2910,452,5325
12847,2012-06-24,3,1,6,11,0,0,0,1,0.76,0.6818,0.4,0.1343,215,3225,291,2910,506,6135
12848,2012-06-24,3,1,6,12,0,0,0,1,0.8,0.697,0.33,0.2239,227,3405,329,3290,556,6695
12849,2012-06-24,3,1,6,13,0,0,0,1,0.8,0.697,0.33,0.2836,237,3555,348,3480,585,7035
12850,2012-06-24,3,1,6,14,0,0,0,1,0.84,0.7273,0.3,0.2985,253,3795,298,2980,551,6775
12851,2012-06-24,3,1,6,15,0,0,0,1,0.86,0.7424,0.28,0.2239,197,2955,290,2900,487,5855
12852,2012-06-24,3,1,6,16,0,0,0,1,0.84,0.7273,0.3,0.2537,181,2715,280,2800,461,5515
12853,2012-06-24,3,1,6,17,0,0,0,1,0.84,0.7273,0.32,0.2537,203,3045,329,3290,532,6335
12854,2012-06-24,3,1,6,18,0,0,0,1,0.82,0.7273,0.34,0.2537,186,2790,348,3480,534,6270
12855,2012-06-24,3,1,6,19,0,0,0,1,0.8,0.7121,0.38,0.2985,176,2640,247,2470,423,5110
12856,2012-06-24,3,1,6,20,0,0,0,1,0.78,0.697,0.46,0.2537,108,1620,224,2240,332,3860
12857,2012-06-24,3,1,6,21,0,0,0,1,0.76,0.697,0.55,0.2239,76,1140,177,1770,253,2910
12858,2012-06-24,3,1,6,22,0,0,0,1,0.74,0.6818,0.55,0.1045,53,795,125,1250,178,2045
12859,2012-06-24,3,1,6,23,0,0,0,1,0.74,0.6818,0.58,0.1045,20,300,67,670,87,970
12860,2012-06-25,3,1,6,0,0,1,1,1,0.72,0.6818,0.62,0.2537,31,465,37,370,68,835
12861,2012-06-25,3,1,6,1,0,1,1,1,0.7,0.6515,0.65,0.2239,11,165,20,200,31,365
12862,2012-06-25,3,1,6,2,0,1,1,1,0.7,0.6515,0.7,0.2239,4,60,10,100,14,160
12863,2012-06-25,3,1,6,3,0,1,1,1,0.68,0.6364,0.69,0.2537,1,15,4,40,5,55
12864,2012-06-25,3,1,6,4,0,1,1,1,0.66,0.6061,0.78,0.2537,0,0,4,40,4,40
12865,2012-06-25,3,1,6,5,0,1,1,1,0.66,0.6212,0.74,0.1642,1,15,42,420,43,435
12866,2012-06-25,3,1,6,6,0,1,1,1,0.64,0.5909,0.78,0.1642,11,165,147,1470,158,1635
12867,2012-06-25,3,1,6,7,0,1,1,1,0.66,0.6212,0.74,0.2239,30,450,455,4550,485,5000
12868,2012-06-25,3,1,6,8,0,1,1,1,0.66,0.6212,0.69,0.194,53,795,555,5550,608,6345
12869,2012-06-25,3,1,6,9,0,1,1,1,0.7,0.6515,0.65,0.194,37,555,231,2310,268,2865
12870,2012-06-25,3,1,6,10,0,1,1,1,0.76,0.697,0.55,0.1642,58,870,126,1260,184,2130
12871,2012-06-25,3,1,6,11,0,1,1,1,0.8,0.7273,0.43,0.3284,54,810,127,1270,181,2080
12872,2012-06-25,3,1,6,12,0,1,1,2,0.76,0.6818,0.45,0.2985,74,1110,196,1960,270,3070
12873,2012-06-25,3,1,6,13,0,1,1,1,0.72,0.6667,0.51,0.2985,79,1185,181,1810,260,2995
12874,2012-06-25,3,1,6,14,0,1,1,1,0.78,0.697,0.43,0.2537,90,1350,161,1610,251,2960
12875,2012-06-25,3,1,6,15,0,1,1,1,0.78,0.6818,0.38,0.4627,65,975,168,1680,233,2655
12876,2012-06-25,3,1,6,16,0,1,1,1,0.8,0.697,0.31,0.3881,104,1560,310,3100,414,4660
12877,2012-06-25,3,1,6,17,0,1,1,1,0.8,0.6818,0.24,0.4627,76,1140,757,7570,833,8710
12878,2012-06-25,3,1,6,18,0,1,1,1,0.76,0.6667,0.27,0.4478,100,1500,691,6910,791,8410
12879,2012-06-25,3,1,6,19,0,1,1,1,0.74,0.6515,0.27,0.4627,74,1110,508,5080,582,6190
12880,2012-06-25,3,1,6,20,0,1,1,1,0.72,0.6515,0.3,0.4478,100,1500,375,3750,475,5250
12881,2012-06-25,3,1,6,21,0,1,1,1,0.68,0.6212,0.3,0.3284,50,750,281,2810,331,3560
12882,2012-06-25,3,1,6,22,0,1,1,1,0.66,0.6212,0.29,0.3881,21,315,166,1660,187,1975
12883,2012-06-25,3,1,6,23,0,1,1,1,0.64,0.6212,0.33,0.3284,15,225,88,880,103,1105
12884,2012-06-26,3,1,6,0,0,2,1,1,0.62,0.6212,0.33,0.3284,8,120,29,290,37,410
12885,2012-06-26,3,1,6,1,0,2,1,1,0.6,0.6212,0.35,0.3881,11,165,19,190,30,355
12886,2012-06-26,3,1,6,2,0,2,1,1,0.56,0.5303,0.43,0.2836,2,30,7,70,9,100
12887,2012-06-26,3,1,6,3,0,2,1,1,0.54,0.5152,0.45,0.2836,2,30,7,70,9,100
12888,2012-06-26,3,1,6,4,0,2,1,1,0.54,0.5152,0.45,0.2985,1,15,9,90,10,105
12889,2012-06-26,3,1,6,5,0,2,1,1,0.52,0.5,0.48,0.3881,3,45,36,360,39,405
12890,2012-06-26,3,1,6,6,0,2,1,1,0.52,0.5,0.52,0.2985,12,180,176,1760,188,1940
12891,2012-06-26,3,1,6,7,0,2,1,1,0.52,0.5,0.52,0.3582,21,315,531,5310,552,5625
12892,2012-06-26,3,1,6,8,0,2,1,1,0.56,0.5303,0.49,0.3284,34,510,622,6220,656,6730
12893,2012-06-26,3,1,6,9,0,2,1,1,0.58,0.5455,0.46,0.4179,30,450,298,2980,328,3430
12894,2012-06-26,3,1,6,10,0,2,1,1,0.62,0.6212,0.41,0.3582,37,555,153,1530,190,2085
12895,2012-06-26,3,1,6,11,0,2,1,1,0.64,0.6212,0.36,0.4179,46,690,189,1890,235,2580
12896,2012-06-26,3,1,6,12,0,2,1,1,0.66,0.6212,0.34,0.4478,80,1200,228,2280,308,3480
12897,2012-06-26,3,1,6,13,0,2,1,1,0.7,0.6364,0.3,0.4627,74,1110,232,2320,306,3430
12898,2012-06-26,3,1,6,14,0,2,1,1,0.7,0.6364,0.3,0.4627,81,1215,186,1860,267,3075
12899,2012-06-26,3,1,6,15,0,2,1,1,0.72,0.6515,0.28,0.4627,88,1320,229,2290,317,3610
12900,2012-06-26,3,1,6,16,0,2,1,1,0.72,0.6364,0.26,0.4925,67,1005,349,3490,416,4495
12901,2012-06-26,3,1,6,17,0,2,1,1,0.72,0.6515,0.28,0.4179,104,1560,796,7960,900,9520
12902,2012-06-26,3,1,6,18,0,2,1,1,0.72,0.6515,0.28,0.3582,105,1575,719,7190,824,8765
12903,2012-06-26,3,1,6,19,0,2,1,1,0.72,0.6515,0.28,0.2239,83,1245,529,5290,612,6535
12904,2012-06-26,3,1,6,20,0,2,1,1,0.7,0.6364,0.3,0.2836,88,1320,417,4170,505,5490
12905,2012-06-26,3,1,6,21,0,2,1,1,0.68,0.6364,0.34,0.194,61,915,267,2670,328,3585
12906,2012-06-26,3,1,6,22,0,2,1,1,0.66,0.6212,0.34,0.2537,26,390,219,2190,245,2580
12907,2012-06-26,3,1,6,23,0,2,1,1,0.62,0.6212,0.41,0.1343,13,195,118,1180,131,1375
12908,2012-06-27,3,1,6,0,0,3,1,1,0.62,0.6212,0.41,0.194,15,225,39,390,54,615
12909,2012-06-27,3,1,6,1,0,3,1,1,0.6,0.6212,0.43,0.1642,5,75,18,180,23,255
12910,2012-06-27,3,1,6,2,0,3,1,1,0.56,0.5303,0.49,0.1343,2,30,12,120,14,150
12911,2012-06-27,3,1,6,3,0,3,1,1,0.58,0.5455,0.46,0.0896,1,15,7,70,8,85
12912,2012-06-27,3,1,6,4,0,3,1,1,0.6,0.6212,0.4,0.2537,0,0,11,110,11,110
12913,2012-06-27,3,1,6,5,0,3,1,1,0.6,0.6212,0.43,0.2836,2,30,34,340,36,370
12914,2012-06-27,3,1,6,6,0,3,1,1,0.58,0.5455,0.46,0.2836,7,105,193,1930,200,2035
12915,2012-06-27,3,1,6,7,0,3,1,1,0.6,0.6212,0.43,0.3582,29,435,498,4980,527,5415
12916,2012-06-27,3,1,6,8,0,3,1,1,0.62,0.6212,0.43,0.3284,49,735,638,6380,687,7115
12917,2012-06-27,3,1,6,9,0,3,1,1,0.66,0.6212,0.41,0.3582,29,435,253,2530,282,2965
12918,2012-06-27,3,1,6,10,0,3,1,1,0.7,0.6364,0.37,0.2537,34,510,138,1380,172,1890
12919,2012-06-27,3,1,6,11,0,3,1,1,0.74,0.6515,0.3,0.3284,64,960,145,1450,209,2410
12920,2012-06-27,3,1,6,12,0,3,1,1,0.76,0.6667,0.29,0.2985,77,1155,245,2450,322,3605
12921,2012-06-27,3,1,6,13,0,3,1,1,0.8,0.697,0.27,0.3284,77,1155,244,2440,321,3595
12922,2012-06-27,3,1,6,14,0,3,1,1,0.8,0.6818,0.24,0.3582,78,1170,192,1920,270,3090
12923,2012-06-27,3,1,6,15,0,3,1,1,0.8,0.697,0.26,0.4627,61,915,188,1880,249,2795
12924,2012-06-27,3,1,6,16,0,3,1,1,0.82,0.697,0.24,0.4478,55,825,337,3370,392,4195
12925,2012-06-27,3,1,6,17,0,3,1,1,0.82,0.697,0.24,0.3881,113,1695,730,7300,843,8995
12926,2012-06-27,3,1,6,18,0,3,1,1,0.8,0.697,0.27,0.3284,85,1275,719,7190,804,8465
12927,2012-06-27,3,1,6,19,0,3,1,1,0.78,0.6818,0.29,0.3284,101,1515,542,5420,643,6935
12928,2012-06-27,3,1,6,20,0,3,1,1,0.76,0.6667,0.31,0.194,76,1140,369,3690,445,4830
12929,2012-06-27,3,1,6,21,0,3,1,1,0.74,0.6515,0.35,0.1343,54,810,313,3130,367,3940
12930,2012-06-27,3,1,6,22,0,3,1,1,0.72,0.6515,0.39,0.0896,52,780,245,2450,297,3230
12931,2012-06-27,3,1,6,23,0,3,1,1,0.68,0.6364,0.47,0.1343,11,165,148,1480,159,1645
12932,2012-06-28,3,1,6,0,0,4,1,1,0.66,0.6212,0.5,0.1045,2,30,52,520,54,550
12933,2012-06-28,3,1,6,1,0,4,1,1,0.66,0.6212,0.54,0.0,11,165,14,140,25,305
12934,2012-06-28,3,1,6,2,0,4,1,1,0.66,0.6212,0.5,0.0896,1,15,12,120,13,135
12935,2012-06-28,3,1,6,3,0,4,1,1,0.66,0.6212,0.5,0.0896,1,15,6,60,7,75
12936,2012-06-28,3,1,6,4,0,4,1,1,0.62,0.6061,0.61,0.1045,0,0,11,110,11,110
12937,2012-06-28,3,1,6,5,0,4,1,1,0.62,0.6212,0.57,0.0896,8,120,39,390,47,510
12938,2012-06-28,3,1,6,6,0,4,1,1,0.62,0.6212,0.57,0.0896,8,120,185,1850,193,1970
12939,2012-06-28,3,1,6,7,0,4,1,1,0.62,0.6061,0.61,0.1045,24,360,484,4840,508,5200
12940,2012-06-28,3,1,6,8,0,4,1,1,0.66,0.6212,0.5,0.1343,40,600,577,5770,617,6370
12941,2012-06-28,3,1,6,9,0,4,1,1,0.7,0.6515,0.54,0.1642,33,495,318,3180,351,3675
12942,2012-06-28,3,1,6,10,0,4,1,1,0.74,0.6667,0.48,0.194,40,600,144,1440,184,2040
12943,2012-06-28,3,1,6,11,0,4,1,1,0.8,0.697,0.31,0.194,41,615,170,1700,211,2315
12944,2012-06-28,3,1,6,12,0,4,1,1,0.84,0.7121,0.26,0.2836,49,735,227,2270,276,3005
12945,2012-06-28,3,1,6,13,0,4,1,1,0.86,0.7424,0.26,0.2239,31,465,205,2050,236,2515
12946,2012-06-28,3,1,6,14,0,4,1,1,0.86,0.7273,0.25,0.3284,66,990,188,1880,254,2870
12947,2012-06-28,3,1,6,15,0,4,1,1,0.86,0.7273,0.25,0.3284,24,360,195,1950,219,2310
12948,2012-06-28,3,1,6,16,0,4,1,1,0.88,0.7424,0.23,0.194,56,840,331,3310,387,4150
12949,2012-06-28,3,1,6,17,0,4,1,1,0.88,0.7424,0.22,0.194,71,1065,634,6340,705,7405
12950,2012-06-28,3,1,6,18,0,4,1,1,0.86,0.7273,0.25,0.2239,100,1500,597,5970,697,7470
12951,2012-06-28,3,1,6,19,0,4,1,1,0.84,0.7273,0.3,0.2985,79,1185,492,4920,571,6105
12952,2012-06-28,3,1,6,20,0,4,1,1,0.82,0.7273,0.34,0.194,71,1065,399,3990,470,5055
12953,2012-06-28,3,1,6,21,0,4,1,1,0.76,0.697,0.55,0.194,89,1335,309,3090,398,4425
12954,2012-06-28,3,1,6,22,0,4,1,1,0.76,0.697,0.52,0.1642,50,750,224,2240,274,2990
12955,2012-06-28,3,1,6,23,0,4,1,1,0.74,0.6667,0.48,0.1343,26,390,145,1450,171,1840
12956,2012-06-29,3,1,6,0,0,5,1,1,0.74,0.6667,0.48,0.1343,24,360,90,900,114,1260
12957,2012-06-29,3,1,6,1,0,5,1,1,0.74,0.6667,0.51,0.1642,9,135,33,330,42,465
12958,2012-06-29,3,1,6,2,0,5,1,1,0.72,0.6667,0.58,0.194,3,45,15,150,18,195
12959,2012-06-29,3,1,6,3,0,5,1,1,0.72,0.6667,0.58,0.194,3,45,5,50,8,95
12960,2012-06-29,3,1,6,4,0,5,1,1,0.7,0.6515,0.65,0.1642,1,15,9,90,10,105
12961,2012-06-29,3,1,6,5,0,5,1,1,0.7,0.6515,0.61,0.1045,6,90,39,390,45,480
12962,2012-06-29,3,1,6,6,0,5,1,2,0.7,0.6515,0.61,0.1642,15,225,148,1480,163,1705
12963,2012-06-29,3,1,6,7,0,5,1,1,0.7,0.6515,0.61,0.1045,19,285,361,3610,380,3895
12964,2012-06-29,3,1,6,8,0,5,1,2,0.74,0.6818,0.55,0.1045,48,720,576,5760,624,6480
12965,2012-06-29,3,1,6,9,0,5,1,1,0.76,0.697,0.55,0.1642,39,585,261,2610,300,3195
12966,2012-06-29,3,1,6,10,0,5,1,1,0.9,0.8333,0.39,0.2985,32,480,139,1390,171,1870
12967,2012-06-29,3,1,6,11,0,5,1,2,0.9,0.8485,0.42,0.2836,51,765,137,1370,188,2135
12968,2012-06-29,3,1,6,12,0,5,1,2,0.92,0.8788,0.4,0.2537,53,795,173,1730,226,2525
12969,2012-06-29,3,1,6,13,0,5,1,1,0.94,0.8788,0.38,0.194,45,675,194,1940,239,2615
12970,2012-06-29,3,1,6,14,0,5,1,1,0.96,0.9091,0.36,0.2239,49,735,184,1840,233,2575
12971,2012-06-29,3,1,6,15,0,5,1,1,0.96,0.9091,0.36,0.0,47,705,183,1830,230,2535
12972,2012-06-29,3,1,6,16,0,5,1,1,0.96,0.9091,0.36,0.0,59,885,292,2920,351,3805
12973,2012-06-29,3,1,6,17,0,5,1,1,0.98,0.9242,0.34,0.194,82,1230,457,4570,539,5800
12974,2012-06-29,3,1,6,18,0,5,1,1,0.96,0.8636,0.31,0.0,50,750,414,4140,464,4890
12975,2012-06-29,3,1,6,19,0,5,1,1,0.9,0.8788,0.47,0.194,60,900,303,3030,363,3930
12976,2012-06-29,3,1,6,20,0,5,1,1,0.92,0.8939,0.42,0.2537,53,795,255,2550,308,3345
12977,2012-06-29,3,1,6,21,0,5,1,2,0.86,0.8333,0.53,0.194,41,615,195,1950,236,2565
12978,2012-06-29,3,1,6,22,0,5,1,3,0.82,0.8333,0.63,0.194,34,510,129,1290,163,1800
12979,2012-06-29,3,1,6,23,0,5,1,3,0.82,0.8333,0.63,0.194,6,90,42,420,48,510
12980,2012-06-30,3,1,6,0,0,6,0,3,0.64,0.5758,0.89,0.1642,4,60,65,650,69,710
12981,2012-06-30,3,1,6,1,0,6,0,3,0.64,0.5758,0.89,0.2239,3,45,55,550,58,595
12982,2012-06-30,3,1,6,2,0,6,0,2,0.64,0.5758,0.89,0.0,7,105,54,540,61,645
12983,2012-06-30,3,1,6,3,0,6,0,2,0.64,0.5758,0.89,0.0,3,45,20,200,23,245
12984,2012-06-30,3,1,6,4,0,6,0,2,0.62,0.5455,0.94,0.0,3,45,15,150,18,195
12985,2012-06-30,3,1,6,5,0,6,0,1,0.64,0.5758,0.89,0.1642,3,45,7,70,10,115
12986,2012-06-30,3,1,6,6,0,6,0,1,0.64,0.5758,0.89,0.1642,6,90,36,360,42,450
12987,2012-06-30,3,1,6,7,0,6,0,1,0.64,0.5758,0.89,0.1642,10,150,82,820,92,970
12988,2012-06-30,3,1,6,8,0,6,0,1,0.64,0.5758,0.89,0.1642,26,390,168,1680,194,2070
12989,2012-06-30,3,1,6,9,0,6,0,1,0.64,0.5758,0.89,0.1642,41,615,234,2340,275,2955
12990,2012-06-30,3,1,6,10,0,6,0,1,0.88,0.7727,0.3,0.2537,96,1440,308,3080,404,4520
12991,2012-06-30,3,1,6,11,0,6,0,1,0.88,0.7727,0.3,0.2537,102,1530,350,3500,452,5030
12992,2012-06-30,3,1,6,12,0,6,0,1,0.88,0.7727,0.3,0.2537,143,2145,328,3280,471,5425
12993,2012-06-30,3,1,6,13,0,6,0,1,0.88,0.7727,0.3,0.2537,105,1575,323,3230,428,4805
12994,2012-06-30,3,1,6,14,0,6,0,1,0.88,0.7727,0.3,0.2537,114,1710,295,2950,409,4660
12995,2012-06-30,3,1,6,15,0,6,0,1,0.88,0.7727,0.3,0.2537,117,1755,287,2870,404,4625
12996,2012-06-30,3,1,6,16,0,6,0,1,0.9,0.7879,0.29,0.1642,109,1635,264,2640,373,4275
12997,2012-06-30,3,1,6,17,0,6,0,1,0.88,0.7727,0.32,0.1343,131,1965,231,2310,362,4275
12998,2012-06-30,3,1,6,18,0,6,0,1,0.88,0.7879,0.35,0.0,91,1365,248,2480,339,3845
12999,2012-06-30,3,1,6,19,0,6,0,1,0.84,0.7576,0.44,0.2537,134,2010,240,2400,374,4410
13000,2012-06-30,3,1,6,20,0,6,0,1,0.82,0.7727,0.52,0.1642,88,1320,204,2040,292,3360
13001,2012-06-30,3,1,6,21,0,6,0,1,0.82,0.7727,0.52,0.1642,48,720,165,1650,213,2370
13002,2012-06-30,3,1,6,22,0,6,0,1,0.78,0.7424,0.62,0.1642,38,570,134,1340,172,1910
13003,2012-06-30,3,1,6,23,0,6,0,1,0.78,0.7424,0.62,0.0896,33,495,119,1190,152,1685
13004,2012-07-01,3,1,7,0,0,0,0,1,0.76,0.7273,0.66,0.0,27,405,122,1220,149,1625
13005,2012-07-01,3,1,7,1,0,0,0,1,0.74,0.697,0.7,0.1343,12,180,81,810,93,990
13006,2012-07-01,3,1,7,2,0,0,0,1,0.72,0.697,0.74,0.0896,21,315,69,690,90,1005
13007,2012-07-01,3,1,7,3,0,0,0,1,0.72,0.7121,0.84,0.1343,6,90,27,270,33,360
13008,2012-07-01,3,1,7,4,0,0,0,1,0.7,0.6667,0.79,0.194,0,0,4,40,4,40
13009,2012-07-01,3,1,7,5,0,0,0,1,0.68,0.6364,0.79,0.1045,3,45,7,70,10,115
13010,2012-07-01,3,1,7,6,0,0,0,1,0.7,0.6667,0.79,0.0896,8,120,19,190,27,310
13011,2012-07-01,3,1,7,7,0,0,0,1,0.74,0.697,0.7,0.0,13,195,37,370,50,565
13012,2012-07-01,3,1,7,8,0,0,0,1,0.78,0.7424,0.62,0.1045,36,540,106,1060,142,1600
13013,2012-07-01,3,1,7,9,0,0,0,1,0.82,0.7879,0.56,0.0,51,765,168,1680,219,2445
13014,2012-07-01,3,1,7,10,0,0,0,1,0.86,0.7879,0.44,0.2985,98,1470,268,2680,366,4150
13015,2012-07-01,3,1,7,11,0,0,0,1,0.88,0.803,0.39,0.2239,121,1815,256,2560,377,4375
13016,2012-07-01,3,1,7,12,0,0,0,1,0.9,0.8182,0.37,0.2239,114,1710,319,3190,433,4900
13017,2012-07-01,3,1,7,13,0,0,0,1,0.92,0.8333,0.33,0.2537,111,1665,309,3090,420,4755
13018,2012-07-01,3,1,7,14,0,0,0,1,0.92,0.8333,0.33,0.2537,98,1470,346,3460,444,4930
13019,2012-07-01,3,1,7,15,0,0,0,1,0.9,0.8182,0.37,0.2836,101,1515,244,2440,345,3955
13020,2012-07-01,3,1,7,16,0,0,0,1,0.92,0.8333,0.33,0.2985,85,1275,228,2280,313,3555
13021,2012-07-01,3,1,7,17,0,0,0,1,0.92,0.803,0.26,0.2985,90,1350,323,3230,413,4580
13022,2012-07-01,3,1,7,18,0,0,0,1,0.88,0.7727,0.32,0.3582,95,1425,275,2750,370,4175
13023,2012-07-01,3,1,7,19,0,0,0,1,0.84,0.7424,0.39,0.1343,103,1545,279,2790,382,4335
13024,2012-07-01,3,1,7,20,0,0,0,1,0.84,0.7424,0.39,0.1343,88,1320,244,2440,332,3760
13025,2012-07-01,3,1,7,21,0,0,0,1,0.84,0.7424,0.39,0.1343,77,1155,181,1810,258,2965
13026,2012-07-01,3,1,7,22,0,0,0,1,0.82,0.7424,0.43,0.1343,41,615,110,1100,151,1715
13027,2012-07-01,3,1,7,23,0,0,0,3,0.78,0.7121,0.52,0.1642,22,330,88,880,110,1210
13028,2012-07-02,3,1,7,0,0,1,1,2,0.76,0.7121,0.58,0.2239,12,180,31,310,43,490
13029,2012-07-02,3,1,7,1,0,1,1,2,0.76,0.7121,0.58,0.194,3,45,14,140,17,185
13030,2012-07-02,3,1,7,2,0,1,1,2,0.74,0.6667,0.51,0.2537,1,15,14,140,15,155
13031,2012-07-02,3,1,7,3,0,1,1,2,0.72,0.6667,0.54,0.4179,0,0,5,50,5,50
13032,2012-07-02,3,1,7,4,0,1,1,2,0.72,0.6667,0.54,0.2985,2,30,10,100,12,130
13033,2012-07-02,3,1,7,5,0,1,1,2,0.72,0.6667,0.51,0.0,3,45,37,370,40,415
13034,2012-07-02,3,1,7,6,0,1,1,1,0.7,0.6515,0.58,0.1045,4,60,132,1320,136,1380
13035,2012-07-02,3,1,7,7,0,1,1,1,0.74,0.6667,0.51,0.1045,8,120,390,3900,398,4020
13036,2012-07-02,3,1,7,8,0,1,1,1,0.76,0.697,0.52,0.194,20,300,548,5480,568,5780
13037,2012-07-02,3,1,7,9,0,1,1,1,0.78,0.697,0.46,0.2537,56,840,239,2390,295,3230
13038,2012-07-02,3,1,7,10,0,1,1,1,0.8,0.7273,0.43,0.2537,70,1050,104,1040,174,2090
13039,2012-07-02,3,1,7,11,0,1,1,1,0.84,0.7273,0.28,0.2985,67,1005,134,1340,201,2345
13040,2012-07-02,3,1,7,12,0,1,1,1,0.84,0.7273,0.32,0.194,74,1110,183,1830,257,2940
13041,2012-07-02,3,1,7,13,0,1,1,1,0.86,0.7576,0.34,0.2239,74,1110,162,1620,236,2730
13042,2012-07-02,3,1,7,14,0,1,1,1,0.86,0.7576,0.34,0.2239,79,1185,151,1510,230,2695
13043,2012-07-02,3,1,7,15,0,1,1,1,0.84,0.7424,0.36,0.194,59,885,175,1750,234,2635
13044,2012-07-02,3,1,7,16,0,1,1,1,0.84,0.7424,0.36,0.2836,61,915,304,3040,365,3955
13045,2012-07-02,3,1,7,17,0,1,1,1,0.84,0.7273,0.32,0.1343,82,1230,665,6650,747,7880
13046,2012-07-02,3,1,7,18,0,1,1,1,0.84,0.7273,0.32,0.1642,72,1080,658,6580,730,7660
13047,2012-07-02,3,1,7,19,0,1,1,1,0.78,0.697,0.43,0.1343,71,1065,510,5100,581,6165
13048,2012-07-02,3,1,7,20,0,1,1,1,0.78,0.697,0.43,0.1343,38,570,357,3570,395,4140
13049,2012-07-02,3,1,7,21,0,1,1,1,0.76,0.6818,0.45,0.1343,17,255,241,2410,258,2665
13050,2012-07-02,3,1,7,22,0,1,1,1,0.74,0.6667,0.51,0.1642,19,285,169,1690,188,1975
13051,2012-07-02,3,1,7,23,0,1,1,1,0.74,0.6667,0.51,0.1045,12,180,90,900,102,1080
13052,2012-07-03,3,1,7,0,0,2,1,1,0.72,0.6667,0.54,0.0,9,135,44,440,53,575
13053,2012-07-03,3,1,7,1,0,2,1,1,0.72,0.6667,0.58,0.0,5,75,9,90,14,165
13054,2012-07-03,3,1,7,2,0,2,1,1,0.72,0.6667,0.58,0.0,2,30,8,80,10,110
13055,2012-07-03,3,1,7,3,0,2,1,1,0.7,0.6515,0.65,0.1343,0,0,2,20,2,20
13056,2012-07-03,3,1,7,4,0,2,1,1,0.68,0.6364,0.65,0.1045,0,0,6,60,6,60
13057,2012-07-03,3,1,7,5,0,2,1,1,0.7,0.6515,0.61,0.0,2,30,33,330,35,360
13058,2012-07-03,3,1,7,6,0,2,1,1,0.7,0.6515,0.65,0.1343,5,75,149,1490,154,1565
13059,2012-07-03,3,1,7,7,0,2,1,1,0.74,0.6818,0.58,0.0,21,315,462,4620,483,4935
13060,2012-07-03,3,1,7,8,0,2,1,1,0.74,0.6818,0.62,0.0896,42,630,604,6040,646,6670
13061,2012-07-03,3,1,7,9,0,2,1,1,0.8,0.7424,0.49,0.1642,46,690,226,2260,272,2950
13062,2012-07-03,3,1,7,10,0,2,1,1,0.82,0.7424,0.43,0.2239,56,840,153,1530,209,2370
13063,2012-07-03,3,1,7,11,0,2,1,1,0.86,0.7576,0.34,0.194,66,990,151,1510,217,2500
13064,2012-07-03,3,1,7,12,0,2,1,1,0.88,0.7576,0.28,0.194,74,1110,198,1980,272,3090
13065,2012-07-03,3,1,7,13,0,2,1,1,0.9,0.7727,0.25,0.1343,80,1200,203,2030,283,3230
13066,2012-07-03,3,1,7,14,0,2,1,1,0.9,0.7727,0.25,0.194,69,1035,241,2410,310,3445
13067,2012-07-03,3,1,7,15,0,2,1,2,0.9,0.7727,0.24,0.0,71,1065,330,3300,401,4365
13068,2012-07-03,3,1,7,16,0,2,1,2,0.9,0.7727,0.24,0.194,90,1350,437,4370,527,5720
13069,2012-07-03,3,1,7,17,0,2,1,2,0.86,0.7424,0.3,0.1642,102,1530,620,6200,722,7730
13070,2012-07-03,3,1,7,18,0,2,1,2,0.86,0.7424,0.3,0.0,85,1275,542,5420,627,6695
13071,2012-07-03,3,1,7,19,0,2,1,2,0.84,0.7424,0.36,0.1343,66,990,431,4310,497,5300
13072,2012-07-03,3,1,7,20,0,2,1,3,0.76,0.697,0.55,0.4925,80,1200,296,2960,376,4160
13073,2012-07-03,3,1,7,21,0,2,1,2,0.7,0.6515,0.7,0.2836,36,540,160,1600,196,2140
13074,2012-07-03,3,1,7,22,0,2,1,1,0.68,0.6364,0.79,0.194,26,390,151,1510,177,1900
13075,2012-07-03,3,1,7,23,0,2,1,1,0.66,0.6061,0.83,0.0,19,285,152,1520,171,1805
13076,2012-07-04,3,1,7,0,1,3,0,1,0.68,0.6364,0.79,0.0896,19,285,140,1400,159,1685
13077,2012-07-04,3,1,7,1,1,3,0,1,0.68,0.6364,0.74,0.0,27,405,96,960,123,1365
13078,2012-07-04,3,1,7,2,1,3,0,1,0.66,0.6061,0.83,0.1343,27,405,66,660,93,1065
13079,2012-07-04,3,1,7,3,1,3,0,1,0.68,0.6364,0.74,0.194,9,135,23,230,32,365
13080,2012-07-04,3,1,7,4,1,3,0,1,0.68,0.6364,0.69,0.2537,5,75,11,110,16,185
13081,2012-07-04,3,1,7,5,1,3,0,1,0.66,0.6212,0.69,0.0,5,75,14,140,19,215
13082,2012-07-04,3,1,7,6,1,3,0,1,0.66,0.6212,0.69,0.0,9,135,23,230,32,365
13083,2012-07-04,3,1,7,7,1,3,0,1,0.68,0.6364,0.65,0.0,10,150,62,620,72,770
13084,2012-07-04,3,1,7,8,1,3,0,1,0.7,0.6515,0.61,0.1045,43,645,110,1100,153,1745
13085,2012-07-04,3,1,7,9,1,3,0,1,0.76,0.697,0.52,0.0,90,1350,203,2030,293,3380
13086,2012-07-04,3,1,7,10,1,3,0,1,0.8,0.7273,0.46,0.0,143,2145,304,3040,447,5185
13087,2012-07-04,3,1,7,11,1,3,0,1,0.82,0.7576,0.46,0.1343,164,2460,321,3210,485,5670
13088,2012-07-04,3,1,7,12,1,3,0,1,0.86,0.7879,0.41,0.2239,164,2460,330,3300,494,5760
13089,2012-07-04,3,1,7,13,1,3,0,1,0.9,0.8182,0.35,0.0,177,2655,322,3220,499,5875
13090,2012-07-04,3,1,7,14,1,3,0,1,0.9,0.8182,0.37,0.1642,190,2850,357,3570,547,6420
13091,2012-07-04,3,1,7,15,1,3,0,1,0.92,0.8485,0.35,0.2985,155,2325,299,2990,454,5315
13092,2012-07-04,3,1,7,16,1,3,0,1,0.92,0.8485,0.35,0.2537,163,2445,226,2260,389,4705
13093,2012-07-04,3,1,7,17,1,3,0,1,0.92,0.8485,0.35,0.2985,161,2415,253,2530,414,4945
13094,2012-07-04,3,1,7,18,1,3,0,1,0.9,0.8485,0.42,0.194,159,2385,271,2710,430,5095
13095,2012-07-04,3,1,7,19,1,3,0,1,0.86,0.803,0.47,0.2239,177,2655,255,2550,432,5205
13096,2012-07-04,3,1,7,20,1,3,0,1,0.86,0.803,0.47,0.2239,237,3555,314,3140,551,6695
13097,2012-07-04,3,1,7,21,1,3,0,1,0.84,0.803,0.53,0.1343,222,3330,362,3620,584,6950
13098,2012-07-04,3,1,7,22,1,3,0,1,0.82,0.7879,0.56,0.2239,175,2625,327,3270,502,5895
13099,2012-07-04,3,1,7,23,1,3,0,2,0.78,0.697,0.43,0.0896,31,465,152,1520,183,1985
13100,2012-07-05,3,1,7,0,0,4,1,1,0.74,0.6667,0.51,0.1045,17,255,71,710,88,965
13101,2012-07-05,3,1,7,1,0,4,1,1,0.74,0.6667,0.51,0.2836,6,90,24,240,30,330
13102,2012-07-05,3,1,7,2,0,4,1,1,0.74,0.6667,0.51,0.0,4,60,14,140,18,200
13103,2012-07-05,3,1,7,3,0,4,1,1,0.72,0.6667,0.54,0.194,2,30,5,50,7,80
13104,2012-07-05,3,1,7,4,0,4,1,1,0.72,0.6667,0.58,0.0,0,0,7,70,7,70
13105,2012-07-05,3,1,7,5,0,4,1,1,0.72,0.6818,0.62,0.0,1,15,28,280,29,295
13106,2012-07-05,3,1,7,6,0,4,1,1,0.72,0.6667,0.58,0.0,3,45,130,1300,133,1345
13107,2012-07-05,3,1,7,7,0,4,1,1,0.76,0.697,0.55,0.0,27,405,316,3160,343,3565
13108,2012-07-05,3,1,7,8,0,4,1,1,0.8,0.7424,0.49,0.1343,36,540,514,5140,550,5680
13109,2012-07-05,3,1,7,9,0,4,1,1,0.84,0.7879,0.49,0.2985,47,705,246,2460,293,3165
13110,2012-07-05,3,1,7,10,0,4,1,1,0.86,0.7879,0.44,0.3582,69,1035,117,1170,186,2205
13111,2012-07-05,3,1,7,11,0,4,1,1,0.9,0.8182,0.35,0.2985,107,1605,137,1370,244,2975
13112,2012-07-05,3,1,7,12,0,4,1,1,0.9,0.8182,0.35,0.3582,88,1320,188,1880,276,3200
13113,2012-07-05,3,1,7,13,0,4,1,1,0.92,0.8333,0.33,0.2239,129,1935,181,1810,310,3745
13114,2012-07-05,3,1,7,14,0,4,1,1,0.92,0.8333,0.33,0.3284,87,1305,154,1540,241,2845
13115,2012-07-05,3,1,7,15,0,4,1,1,0.92,0.8333,0.33,0.3582,71,1065,183,1830,254,2895
13116,2012-07-05,3,1,7,16,0,4,1,1,0.92,0.8333,0.33,0.2537,109,1635,324,3240,433,4875
13117,2012-07-05,3,1,7,17,0,4,1,1,0.92,0.8485,0.35,0.1642,114,1710,575,5750,689,7460
13118,2012-07-05,3,1,7,18,0,4,1,2,0.9,0.8333,0.39,0.3284,96,1440,511,5110,607,6550
13119,2012-07-05,3,1,7,19,0,4,1,2,0.88,0.803,0.39,0.2537,128,1920,375,3750,503,5670
13120,2012-07-05,3,1,7,20,0,4,1,2,0.86,0.7879,0.41,0.2239,78,1170,243,2430,321,3600
13121,2012-07-05,3,1,7,21,0,4,1,1,0.84,0.7727,0.47,0.194,91,1365,232,2320,323,3685
13122,2012-07-05,3,1,7,22,0,4,1,1,0.82,0.803,0.59,0.1343,63,945,162,1620,225,2565
13123,2012-07-05,3,1,7,23,0,4,1,1,0.8,0.7576,0.55,0.1642,32,480,99,990,131,1470
13124,2012-07-06,3,1,7,0,0,5,1,1,0.78,0.7424,0.62,0.1343,39,585,63,630,102,1215
13125,2012-07-06,3,1,7,1,0,5,1,1,0.78,0.7273,0.55,0.2239,7,105,22,220,29,325
13126,2012-07-06,3,1,7,2,0,5,1,1,0.76,0.7121,0.62,0.1343,4,60,13,130,17,190
13127,2012-07-06,3,1,7,3,0,5,1,2,0.74,0.697,0.7,0.194,1,15,6,60,7,75
13128,2012-07-06,3,1,7,4,0,5,1,1,0.74,0.697,0.66,0.2239,2,30,4,40,6,70
13129,2012-07-06,3,1,7,5,0,5,1,1,0.74,0.697,0.66,0.194,4,60,31,310,35,370
13130,2012-07-06,3,1,7,6,0,5,1,1,0.74,0.697,0.66,0.194,4,60,127,1270,131,1330
13131,2012-07-06,3,1,7,7,0,5,1,1,0.78,0.697,0.46,0.1343,20,300,333,3330,353,3630
13132,2012-07-06,3,1,7,8,0,5,1,1,0.8,0.7121,0.41,0.1642,28,420,557,5570,585,5990
13133,2012-07-06,3,1,7,9,0,5,1,1,0.82,0.7273,0.36,0.1343,55,825,249,2490,304,3315
13134,2012-07-06,3,1,7,10,0,5,1,1,0.86,0.7424,0.3,0.0,80,1200,130,1300,210,2500
13135,2012-07-06,3,1,7,11,0,5,1,1,0.84,0.7273,0.32,0.0896,92,1380,141,1410,233,2790
13136,2012-07-06,3,1,7,12,0,5,1,1,0.88,0.7576,0.28,0.1045,111,1665,220,2200,331,3865
13137,2012-07-06,3,1,7,13,0,5,1,1,0.9,0.7879,0.27,0.1045,99,1485,194,1940,293,3425
13138,2012-07-06,3,1,7,14,0,5,1,1,0.9,0.803,0.31,0.1642,91,1365,184,1840,275,3205
13139,2012-07-06,3,1,7,15,0,5,1,1,0.92,0.8182,0.29,0.194,79,1185,206,2060,285,3245
13140,2012-07-06,3,1,7,16,0,5,1,1,0.92,0.8182,0.29,0.1045,69,1035,300,3000,369,4035
13141,2012-07-06,3,1,7,17,0,5,1,1,0.92,0.8182,0.29,0.0,90,1350,486,4860,576,6210
13142,2012-07-06,3,1,7,18,0,5,1,1,0.9,0.803,0.33,0.2537,106,1590,454,4540,560,6130
13143,2012-07-06,3,1,7,19,0,5,1,1,0.88,0.7879,0.35,0.2239,112,1680,306,3060,418,4740
13144,2012-07-06,3,1,7,20,0,5,1,1,0.86,0.7727,0.39,0.1045,91,1365,245,2450,336,3815
13145,2012-07-06,3,1,7,21,0,5,1,1,0.82,0.7727,0.52,0.1343,77,1155,223,2230,300,3385
13146,2012-07-06,3,1,7,22,0,5,1,1,0.8,0.7576,0.55,0.194,78,1170,210,2100,288,3270
13147,2012-07-06,3,1,7,23,0,5,1,1,0.8,0.7879,0.63,0.1045,27,405,137,1370,164,1775
13148,2012-07-07,3,1,7,0,0,6,0,1,0.78,0.7576,0.66,0.1343,35,525,115,1150,150,1675
13149,2012-07-07,3,1,7,1,0,6,0,1,0.76,0.7273,0.7,0.1642,16,240,55,550,71,790
13150,2012-07-07,3,1,7,2,0,6,0,1,0.76,0.7424,0.72,0.1642,11,165,47,470,58,635
13151,2012-07-07,3,1,7,3,0,6,0,1,0.74,0.7121,0.74,0.1343,12,180,19,190,31,370
13152,2012-07-07,3,1,7,4,0,6,0,1,0.74,0.7121,0.74,0.1642,3,45,13,130,16,175
13153,2012-07-07,3,1,7,5,0,6,0,1,0.74,0.7121,0.74,0.194,2,30,12,120,14,150
13154,2012-07-07,3,1,7,6,0,6,0,1,0.74,0.7121,0.74,0.1045,4,60,27,270,31,330
13155,2012-07-07,3,1,7,7,0,6,0,1,0.78,0.7576,0.66,0.1045,8,120,63,630,71,750
13156,2012-07-07,3,1,7,8,0,6,0,1,0.82,0.8333,0.63,0.194,32,480,120,1200,152,1680
13157,2012-07-07,3,1,7,9,0,6,0,1,0.84,0.8333,0.59,0.1642,69,1035,187,1870,256,2905
13158,2012-07-07,3,1,7,10,0,6,0,1,0.92,0.8636,0.37,0.2239,100,1500,225,2250,325,3750
13159,2012-07-07,3,1,7,11,0,6,0,1,0.94,0.8788,0.38,0.194,122,1830,245,2450,367,4280
13160,2012-07-07,3,1,7,12,0,6,0,1,0.96,0.8636,0.31,0.3582,124,1860,218,2180,342,4040
13161,2012-07-07,3,1,7,13,0,6,0,2,0.96,0.8636,0.31,0.2537,116,1740,244,2440,360,4180
13162,2012-07-07,3,1,7,14,0,6,0,2,0.96,0.8636,0.3,0.1343,105,1575,203,2030,308,3605
13163,2012-07-07,3,1,7,15,0,6,0,1,0.96,0.8485,0.26,0.0,113,1695,193,1930,306,3625
13164,2012-07-07,3,1,7,16,0,6,0,1,1.0,0.8636,0.19,0.1642,102,1530,192,1920,294,3450
13165,2012-07-07,3,1,7,17,0,6,0,1,0.96,0.8485,0.26,0.1343,103,1545,176,1760,279,3305
13166,2012-07-07,3,1,7,18,0,6,0,1,0.94,0.8333,0.29,0.0896,83,1245,194,1940,277,3185
13167,2012-07-07,3,1,7,19,0,6,0,1,0.92,0.8333,0.33,0.1343,68,1020,219,2190,287,3210
13168,2012-07-07,3,1,7,20,0,6,0,1,0.9,0.8182,0.37,0.1642,79,1185,197,1970,276,3155
13169,2012-07-07,3,1,7,21,0,6,0,1,0.88,0.7879,0.37,0.194,51,765,150,1500,201,2265
13170,2012-07-07,3,1,7,22,0,6,0,1,0.84,0.8333,0.59,0.194,56,840,164,1640,220,2480
13171,2012-07-07,3,1,7,23,0,6,0,1,0.84,0.8182,0.56,0.1642,34,510,114,1140,148,1650
13172,2012-07-08,3,1,7,0,0,0,0,1,0.82,0.7879,0.56,0.1343,22,330,125,1250,147,1580
13173,2012-07-08,3,1,7,1,0,0,0,1,0.82,0.7879,0.56,0.1045,25,375,99,990,124,1365
13174,2012-07-08,3,1,7,2,0,0,0,1,0.82,0.7727,0.52,0.1045,11,165,59,590,70,755
13175,2012-07-08,3,1,7,3,0,0,0,1,0.8,0.7727,0.59,0.1045,1,15,34,340,35,355
13176,2012-07-08,3,1,7,4,0,0,0,1,0.78,0.7576,0.66,0.1045,2,30,11,110,13,140
13177,2012-07-08,3,1,7,5,0,0,0,1,0.78,0.7424,0.62,0.0,1,15,5,50,6,65
13178,2012-07-08,3,1,7,6,0,0,0,1,0.78,0.7727,0.7,0.1343,5,75,16,160,21,235
13179,2012-07-08,3,1,7,7,0,0,0,1,0.8,0.803,0.66,0.0,19,285,33,330,52,615
13180,2012-07-08,3,1,7,8,0,0,0,1,0.84,0.803,0.53,0.1343,35,525,95,950,130,1475
13181,2012-07-08,3,1,7,9,0,0,0,1,0.86,0.8182,0.5,0.1045,70,1050,172,1720,242,2770
13182,2012-07-08,3,1,7,10,0,0,0,1,0.9,0.8636,0.45,0.0,85,1275,234,2340,319,3615
13183,2012-07-08,3,1,7,11,0,0,0,1,0.92,0.8939,0.42,0.2985,120,1800,269,2690,389,4490
13184,2012-07-08,3,1,7,12,0,0,0,1,0.92,0.8939,0.42,0.194,105,1575,271,2710,376,4285
13185,2012-07-08,3,1,7,13,0,0,0,1,0.94,0.8788,0.38,0.2537,118,1770,219,2190,337,3960
13186,2012-07-08,3,1,7,14,0,0,0,1,0.96,0.9091,0.36,0.1642,77,1155,235,2350,312,3505
13187,2012-07-08,3,1,7,15,0,0,0,3,0.92,0.8939,0.42,0.2836,80,1200,218,2180,298,3380
13188,2012-07-08,3,1,7,16,0,0,0,2,0.8,0.803,0.66,0.2239,65,975,226,2260,291,3235
13189,2012-07-08,3,1,7,17,0,0,0,1,0.78,0.7424,0.59,0.0,68,1020,202,2020,270,3040
13190,2012-07-08,3,1,7,18,0,0,0,1,0.78,0.7424,0.62,0.1045,54,810,199,1990,253,2800
13191,2012-07-08,3,1,7,19,0,0,0,1,0.78,0.7424,0.62,0.1642,66,990,184,1840,250,2830
13192,2012-07-08,3,1,7,20,0,0,0,1,0.76,0.7273,0.7,0.0896,79,1185,206,2060,285,3245
13193,2012-07-08,3,1,7,21,0,0,0,1,0.76,0.7273,0.7,0.1343,58,870,149,1490,207,2360
13194,2012-07-08,3,1,7,22,0,0,0,3,0.74,0.697,0.7,0.0896,12,180,110,1100,122,1280
13195,2012-07-08,3,1,7,23,0,0,0,3,0.68,0.6364,0.83,0.0896,25,375,98,980,123,1355
13196,2012-07-09,3,1,7,0,0,1,1,2,0.68,0.6364,0.89,0.0896,6,90,33,330,39,420
13197,2012-07-09,3,1,7,1,0,1,1,3,0.7,0.6667,0.89,0.1045,5,75,13,130,18,205
13198,2012-07-09,3,1,7,2,0,1,1,3,0.7,0.6667,0.89,0.194,1,15,4,40,5,55
13199,2012-07-09,3,1,7,3,0,1,1,3,0.7,0.6667,0.89,0.194,0,0,5,50,5,50
13200,2012-07-09,3,1,7,4,0,1,1,3,0.66,0.5909,0.89,0.3881,1,15,1,10,2,25
13201,2012-07-09,3,1,7,5,0,1,1,2,0.66,0.6061,0.83,0.2239,1,15,27,270,28,285
13202,2012-07-09,3,1,7,6,0,1,1,3,0.64,0.5758,0.89,0.2537,6,90,86,860,92,950
13203,2012-07-09,3,1,7,7,0,1,1,3,0.66,0.6061,0.83,0.2239,7,105,223,2230,230,2335
13204,2012-07-09,3,1,7,8,0,1,1,2,0.66,0.6061,0.83,0.1642,26,390,429,4290,455,4680
13205,2012-07-09,3,1,7,9,0,1,1,2,0.66,0.6061,0.83,0.1642,38,570,325,3250,363,3820
13206,2012-07-09,3,1,7,10,0,1,1,2,0.66,0.6061,0.83,0.194,58,870,117,1170,175,2040
13207,2012-07-09,3,1,7,11,0,1,1,2,0.72,0.6818,0.62,0.1343,72,1080,144,1440,216,2520
13208,2012-07-09,3,1,7,12,0,1,1,2,0.74,0.6818,0.58,0.1343,61,915,205,2050,266,2965
13209,2012-07-09,3,1,7,13,0,1,1,2,0.76,0.697,0.55,0.2537,67,1005,188,1880,255,2885
13210,2012-07-09,3,1,7,14,0,1,1,2,0.74,0.6818,0.55,0.2537,58,870,184,1840,242,2710
13211,2012-07-09,3,1,7,15,0,1,1,2,0.76,0.6818,0.45,0.2239,66,990,214,2140,280,3130
13212,2012-07-09,3,1,7,16,0,1,1,1,0.78,0.697,0.4,0.2836,88,1320,325,3250,413,4570
13213,2012-07-09,3,1,7,17,0,1,1,1,0.78,0.697,0.4,0.1642,108,1620,741,7410,849,9030
13214,2012-07-09,3,1,7,18,0,1,1,1,0.76,0.6818,0.48,0.1343,82,1230,790,7900,872,9130
13215,2012-07-09,3,1,7,19,0,1,1,1,0.74,0.6818,0.55,0.1642,88,1320,543,5430,631,6750
13216,2012-07-09,3,1,7,20,0,1,1,2,0.74,0.6818,0.55,0.1045,69,1035,378,3780,447,4815
13217,2012-07-09,3,1,7,21,0,1,1,2,0.74,0.6818,0.55,0.0896,33,495,298,2980,331,3475
13218,2012-07-09,3,1,7,22,0,1,1,2,0.72,0.6667,0.58,0.1045,35,525,189,1890,224,2415
13219,2012-07-09,3,1,7,23,0,1,1,2,0.7,0.6515,0.65,0.1045,22,330,109,1090,131,1420
13220,2012-07-10,3,1,7,0,0,2,1,1,0.7,0.6515,0.7,0.0896,16,240,53,530,69,770
13221,2012-07-10,3,1,7,1,0,2,1,1,0.7,0.6667,0.74,0.1343,0,0,15,150,15,150
13222,2012-07-10,3,1,7,2,0,2,1,1,0.7,0.6667,0.74,0.1343,1,15,15,150,16,165
13223,2012-07-10,3,1,7,3,0,2,1,1,0.68,0.6364,0.79,0.0,0,0,3,30,3,30
13224,2012-07-10,3,1,7,4,0,2,1,1,0.68,0.6364,0.79,0.1343,0,0,4,40,4,40
13225,2012-07-10,3,1,7,5,0,2,1,1,0.66,0.6061,0.83,0.1343,3,45,39,390,42,435
13226,2012-07-10,3,1,7,6,0,2,1,2,0.68,0.6364,0.79,0.1045,4,60,183,1830,187,1890
13227,2012-07-10,3,1,7,7,0,2,1,2,0.7,0.6667,0.74,0.1045,31,465,489,4890,520,5355
13228,2012-07-10,3,1,7,8,0,2,1,1,0.72,0.697,0.74,0.1343,34,510,615,6150,649,6660
13229,2012-07-10,3,1,7,9,0,2,1,1,0.74,0.697,0.66,0.1343,47,705,284,2840,331,3545
13230,2012-07-10,3,1,7,10,0,2,1,1,0.76,0.7121,0.62,0.194,56,840,134,1340,190,2180
13231,2012-07-10,3,1,7,11,0,2,1,1,0.8,0.7273,0.46,0.194,92,1380,157,1570,249,2950
13232,2012-07-10,3,1,7,12,0,2,1,1,0.8,0.7121,0.41,0.1343,69,1035,203,2030,272,3065
13233,2012-07-10,3,1,7,13,0,2,1,1,0.82,0.7273,0.38,0.194,77,1155,203,2030,280,3185
13234,2012-07-10,3,1,7,14,0,2,1,1,0.82,0.7273,0.38,0.1642,71,1065,171,1710,242,2775
13235,2012-07-10,3,1,7,15,0,2,1,1,0.8,0.7121,0.41,0.2239,77,1155,188,1880,265,3035
13236,2012-07-10,3,1,7,16,0,2,1,1,0.8,0.7273,0.43,0.2239,89,1335,346,3460,435,4795
13237,2012-07-10,3,1,7,17,0,2,1,1,0.78,0.7121,0.49,0.194,103,1545,769,7690,872,9235
13238,2012-07-10,3,1,7,18,0,2,1,3,0.7,0.6667,0.74,0.2239,70,1050,749,7490,819,8540
13239,2012-07-10,3,1,7,19,0,2,1,3,0.7,0.6667,0.74,0.2239,55,825,359,3590,414,4415
13240,2012-07-10,3,1,7,20,0,2,1,3,0.64,0.5758,0.83,0.2239,9,135,75,750,84,885
13241,2012-07-10,3,1,7,21,0,2,1,3,0.64,0.5758,0.89,0.1045,7,105,83,830,90,935
13242,2012-07-10,3,1,7,22,0,2,1,2,0.64,0.5758,0.83,0.1343,14,210,125,1250,139,1460
13243,2012-07-10,3,1,7,23,0,2,1,2,0.64,0.5758,0.89,0.1045,29,435,74,740,103,1175
13244,2012-07-11,3,1,7,0,0,3,1,2,0.66,0.6061,0.83,0.1343,6,90,38,380,44,470
13245,2012-07-11,3,1,7,1,0,3,1,1,0.64,0.5758,0.89,0.0,3,45,11,110,14,155
13246,2012-07-11,3,1,7,2,0,3,1,1,0.64,0.5758,0.89,0.0,0,0,5,50,5,50
13247,2012-07-11,3,1,7,3,0,3,1,1,0.64,0.5758,0.89,0.1343,0,0,5,50,5,50
13248,2012-07-11,3,1,7,4,0,3,1,1,0.64,0.5758,0.89,0.1343,1,15,6,60,7,75
13249,2012-07-11,3,1,7,5,0,3,1,1,0.64,0.5758,0.89,0.0,5,75,36,360,41,435
13250,2012-07-11,3,1,7,6,0,3,1,1,0.64,0.5758,0.89,0.1343,17,255,168,1680,185,1935
13251,2012-07-11,3,1,7,7,0,3,1,2,0.66,0.6061,0.83,0.1045,26,390,471,4710,497,5100
13252,2012-07-11,3,1,7,8,0,3,1,2,0.68,0.6364,0.79,0.1642,30,450,644,6440,674,6890
13253,2012-07-11,3,1,7,9,0,3,1,2,0.7,0.6667,0.74,0.1343,30,450,298,2980,328,3430
13254,2012-07-11,3,1,7,10,0,3,1,2,0.72,0.6818,0.62,0.1343,47,705,148,1480,195,2185
13255,2012-07-11,3,1,7,11,0,3,1,2,0.76,0.7121,0.58,0.1343,56,840,173,1730,229,2570
13256,2012-07-11,3,1,7,12,0,3,1,2,0.78,0.697,0.43,0.0,69,1035,223,2230,292,3265
13257,2012-07-11,3,1,7,13,0,3,1,2,0.8,0.7121,0.42,0.1642,65,975,208,2080,273,3055
13258,2012-07-11,3,1,7,14,0,3,1,1,0.8,0.7121,0.41,0.2239,66,990,175,1750,241,2740
13259,2012-07-11,3,1,7,15,0,3,1,1,0.8,0.7121,0.41,0.2537,56,840,220,2200,276,3040
13260,2012-07-11,3,1,7,16,0,3,1,1,0.8,0.7121,0.38,0.194,53,795,358,3580,411,4375
13261,2012-07-11,3,1,7,17,0,3,1,1,0.8,0.697,0.31,0.2239,90,1350,740,7400,830,8750
13262,2012-07-11,3,1,7,18,0,3,1,1,0.78,0.6818,0.38,0.2537,79,1185,735,7350,814,8535
13263,2012-07-11,3,1,7,19,0,3,1,1,0.74,0.6667,0.48,0.2239,73,1095,560,5600,633,6695
13264,2012-07-11,3,1,7,20,0,3,1,1,0.74,0.6667,0.51,0.1642,73,1095,410,4100,483,5195
13265,2012-07-11,3,1,7,21,0,3,1,1,0.72,0.6667,0.58,0.2239,69,1035,322,3220,391,4255
13266,2012-07-11,3,1,7,22,0,3,1,1,0.72,0.6667,0.58,0.2537,41,615,203,2030,244,2645
13267,2012-07-11,3,1,7,23,0,3,1,2,0.7,0.6515,0.58,0.2537,20,300,132,1320,152,1620
13268,2012-07-12,3,1,7,0,0,4,1,2,0.68,0.6364,0.61,0.0,1,15,55,550,56,565
13269,2012-07-12,3,1,7,1,0,4,1,2,0.66,0.6212,0.61,0.0,0,0,21,210,21,210
13270,2012-07-12,3,1,7,2,0,4,1,2,0.66,0.6212,0.65,0.0896,0,0,9,90,9,90
13271,2012-07-12,3,1,7,3,0,4,1,1,0.64,0.6061,0.69,0.1045,0,0,10,100,10,100
13272,2012-07-12,3,1,7,4,0,4,1,1,0.64,0.6061,0.73,0.1045,0,0,5,50,5,50
13273,2012-07-12,3,1,7,5,0,4,1,1,0.62,0.5909,0.73,0.1045,4,60,40,400,44,460
13274,2012-07-12,3,1,7,6,0,4,1,1,0.64,0.6061,0.73,0.0896,7,105,171,1710,178,1815
13275,2012-07-12,3,1,7,7,0,4,1,1,0.64,0.6061,0.73,0.1343,32,480,480,4800,512,5280
13276,2012-07-12,3,1,7,8,0,4,1,1,0.68,0.6364,0.65,0.1343,49,735,653,6530,702,7265
13277,2012-07-12,3,1,7,9,0,4,1,1,0.72,0.6667,0.58,0.1045,42,630,285,2850,327,3480
13278,2012-07-12,3,1,7,10,0,4,1,1,0.74,0.6667,0.48,0.1642,69,1035,145,1450,214,2485
13279,2012-07-12,3,1,7,11,0,4,1,1,0.76,0.6818,0.45,0.1045,49,735,166,1660,215,2395
13280,2012-07-12,3,1,7,12,0,4,1,1,0.78,0.6818,0.35,0.1343,71,1065,221,2210,292,3275
13281,2012-07-12,3,1,7,13,0,4,1,1,0.8,0.697,0.33,0.2239,52,780,225,2250,277,3030
13282,2012-07-12,3,1,7,14,0,4,1,1,0.78,0.6818,0.33,0.2239,42,630,167,1670,209,2300
13283,2012-07-12,3,1,7,15,0,4,1,1,0.8,0.7121,0.36,0.194,63,945,208,2080,271,3025
13284,2012-07-12,3,1,7,16,0,4,1,1,0.8,0.7121,0.36,0.194,69,1035,370,3700,439,4735
13285,2012-07-12,3,1,7,17,0,4,1,1,0.76,0.6818,0.43,0.2239,91,1365,704,7040,795,8405
13286,2012-07-12,3,1,7,18,0,4,1,1,0.76,0.6818,0.45,0.1343,86,1290,739,7390,825,8680
13287,2012-07-12,3,1,7,19,0,4,1,1,0.74,0.6667,0.48,0.2239,97,1455,532,5320,629,6775
13288,2012-07-12,3,1,7,20,0,4,1,1,0.74,0.6667,0.48,0.2239,75,1125,439,4390,514,5515
13289,2012-07-12,3,1,7,21,0,4,1,1,0.72,0.6667,0.48,0.2239,44,660,329,3290,373,3950
13290,2012-07-12,3,1,7,22,0,4,1,1,0.72,0.6667,0.51,0.1642,56,840,262,2620,318,3460
13291,2012-07-12,3,1,7,23,0,4,1,2,0.7,0.6515,0.51,0.2239,33,495,178,1780,211,2275
13292,2012-07-13,3,1,7,0,0,5,1,2,0.7,0.6515,0.54,0.1642,19,285,76,760,95,1045
13293,2012-07-13,3,1,7,1,0,5,1,2,0.68,0.6364,0.54,0.1045,17,255,42,420,59,675
13294,2012-07-13,3,1,7,2,0,5,1,2,0.66,0.6212,0.61,0.0896,2,30,15,150,17,180
13295,2012-07-13,3,1,7,3,0,5,1,2,0.68,0.6364,0.61,0.0,2,30,7,70,9,100
13296,2012-07-13,3,1,7,4,0,5,1,2,0.66,0.6212,0.61,0.0,0,0,11,110,11,110
13297,2012-07-13,3,1,7,5,0,5,1,2,0.66,0.6364,0.56,0.0896,4,60,30,300,34,360
13298,2012-07-13,3,1,7,6,0,5,1,2,0.7,0.6515,0.54,0.0,7,105,120,1200,127,1305
13299,2012-07-13,3,1,7,7,0,5,1,2,0.7,0.6515,0.54,0.0,27,405,353,3530,380,3935
13300,2012-07-13,3,1,7,8,0,5,1,2,0.7,0.6515,0.54,0.0,53,795,660,6600,713,7395
13301,2012-07-13,3,1,7,9,0,5,1,2,0.72,0.6667,0.51,0.0,70,1050,344,3440,414,4490
13302,2012-07-13,3,1,7,10,0,5,1,2,0.74,0.6667,0.48,0.0,78,1170,190,1900,268,3070
13303,2012-07-13,3,1,7,11,0,5,1,2,0.76,0.6818,0.45,0.1343,68,1020,220,2200,288,3220
13304,2012-07-13,3,1,7,12,0,5,1,2,0.76,0.6818,0.4,0.1045,125,1875,254,2540,379,4415
13305,2012-07-13,3,1,7,13,0,5,1,2,0.8,0.7121,0.38,0.1343,100,1500,274,2740,374,4240
13306,2012-07-13,3,1,7,14,0,5,1,2,0.8,0.7121,0.38,0.0,120,1800,249,2490,369,4290
13307,2012-07-13,3,1,7,15,0,5,1,2,0.8,0.7121,0.36,0.1045,92,1380,261,2610,353,3990
13308,2012-07-13,3,1,7,16,0,5,1,2,0.8,0.7121,0.36,0.2239,111,1665,381,3810,492,5475
13309,2012-07-13,3,1,7,17,0,5,1,2,0.8,0.7121,0.36,0.1642,138,2070,697,6970,835,9040
13310,2012-07-13,3,1,7,18,0,5,1,1,0.78,0.697,0.46,0.194,108,1620,523,5230,631,6850
13311,2012-07-13,3,1,7,19,0,5,1,1,0.74,0.6667,0.51,0.1642,103,1545,385,3850,488,5395
13312,2012-07-13,3,1,7,20,0,5,1,1,0.74,0.6667,0.48,0.1343,95,1425,294,2940,389,4365
13313,2012-07-13,3,1,7,21,0,5,1,1,0.72,0.6667,0.54,0.0,76,1140,223,2230,299,3370
13314,2012-07-13,3,1,7,22,0,5,1,1,0.74,0.6667,0.45,0.0,59,885,204,2040,263,2925
13315,2012-07-13,3,1,7,23,0,5,1,2,0.72,0.6515,0.45,0.1343,37,555,175,1750,212,2305
13316,2012-07-14,3,1,7,0,0,6,0,2,0.72,0.6667,0.48,0.0896,35,525,156,1560,191,2085
13317,2012-07-14,3,1,7,1,0,6,0,2,0.7,0.6515,0.51,0.1045,13,195,105,1050,118,1245
13318,2012-07-14,3,1,7,2,0,6,0,2,0.7,0.6515,0.54,0.1045,10,150,91,910,101,1060
13319,2012-07-14,3,1,7,3,0,6,0,2,0.7,0.6515,0.54,0.1045,9,135,31,310,40,445
13320,2012-07-14,3,1,7,4,0,6,0,3,0.66,0.6212,0.61,0.1045,3,45,6,60,9,105
13321,2012-07-14,3,1,7,5,0,6,0,2,0.64,0.6061,0.73,0.1045,0,0,5,50,5,50
13322,2012-07-14,3,1,7,6,0,6,0,2,0.64,0.5909,0.78,0.0896,6,90,29,290,35,380
13323,2012-07-14,3,1,7,7,0,6,0,1,0.64,0.5909,0.78,0.2836,7,105,41,410,48,515
13324,2012-07-14,3,1,7,8,0,6,0,1,0.62,0.5909,0.78,0.2836,33,495,118,1180,151,1675
13325,2012-07-14,3,1,7,9,0,6,0,1,0.66,0.6212,0.74,0.194,82,1230,200,2000,282,3230
13326,2012-07-14,3,1,7,10,0,6,0,2,0.72,0.6818,0.7,0.0896,123,1845,278,2780,401,4625
13327,2012-07-14,3,1,7,11,0,6,0,2,0.72,0.6818,0.7,0.1045,143,2145,296,2960,439,5105
13328,2012-07-14,3,1,7,12,0,6,0,2,0.74,0.697,0.66,0.0896,181,2715,318,3180,499,5895
13329,2012-07-14,3,1,7,13,0,6,0,2,0.76,0.7121,0.62,0.0896,219,3285,372,3720,591,7005
13330,2012-07-14,3,1,7,14,0,6,0,1,0.8,0.7576,0.55,0.1045,269,4035,363,3630,632,7665
13331,2012-07-14,3,1,7,15,0,6,0,1,0.8,0.7576,0.55,0.1642,243,3645,317,3170,560,6815
13332,2012-07-14,3,1,7,16,0,6,0,2,0.72,0.697,0.79,0.3582,226,3390,340,3400,566,6790
13333,2012-07-14,3,1,7,17,0,6,0,3,0.7,0.6667,0.79,0.1642,199,2985,259,2590,458,5575
13334,2012-07-14,3,1,7,18,0,6,0,1,0.72,0.697,0.79,0.1343,108,1620,243,2430,351,4050
13335,2012-07-14,3,1,7,19,0,6,0,1,0.72,0.7121,0.84,0.0896,156,2340,275,2750,431,5090
13336,2012-07-14,3,1,7,20,0,6,0,1,0.72,0.7121,0.84,0.0896,101,1515,255,2550,356,4065
13337,2012-07-14,3,1,7,21,0,6,0,1,0.7,0.6667,0.84,0.2239,69,1035,200,2000,269,3035
13338,2012-07-14,3,1,7,22,0,6,0,1,0.7,0.6667,0.79,0.194,65,975,160,1600,225,2575
13339,2012-07-14,3,1,7,23,0,6,0,2,0.68,0.6364,0.83,0.0896,55,825,156,1560,211,2385
13340,2012-07-15,3,1,7,0,0,0,0,1,0.68,0.6364,0.89,0.1642,40,600,147,1470,187,2070
13341,2012-07-15,3,1,7,1,0,0,0,2,0.68,0.6364,0.89,0.1343,49,735,119,1190,168,1925
13342,2012-07-15,3,1,7,2,0,0,0,2,0.68,0.6364,0.89,0.1642,29,435,86,860,115,1295
13343,2012-07-15,3,1,7,3,0,0,0,2,0.68,0.6364,0.89,0.1642,15,225,42,420,57,645
13344,2012-07-15,3,1,7,4,0,0,0,2,0.68,0.6364,0.89,0.1045,8,120,11,110,19,230
13345,2012-07-15,3,1,7,5,0,0,0,1,0.68,0.6364,0.89,0.1343,2,30,7,70,9,100
13346,2012-07-15,3,1,7,6,0,0,0,1,0.68,0.6364,0.83,0.1343,6,90,9,90,15,180
13347,2012-07-15,3,1,7,7,0,0,0,1,0.7,0.6667,0.79,0.0896,17,255,30,300,47,555
13348,2012-07-15,3,1,7,8,0,0,0,2,0.7,0.6667,0.84,0.1343,37,555,96,960,133,1515
13349,2012-07-15,3,1,7,9,0,0,0,2,0.72,0.697,0.79,0.0,58,870,163,1630,221,2500
13350,2012-07-15,3,1,7,10,0,0,0,1,0.76,0.7273,0.66,0.1343,141,2115,241,2410,382,4525
13351,2012-07-15,3,1,7,11,0,0,0,1,0.82,0.7727,0.52,0.1642,170,2550,281,2810,451,5360
13352,2012-07-15,3,1,7,12,0,0,0,1,0.84,0.7727,0.47,0.1045,153,2295,336,3360,489,5655
13353,2012-07-15,3,1,7,13,0,0,0,1,0.86,0.7879,0.41,0.1045,171,2565,309,3090,480,5655
13354,2012-07-15,3,1,7,14,0,0,0,1,0.9,0.8182,0.37,0.2537,162,2430,314,3140,476,5570
13355,2012-07-15,3,1,7,15,0,0,0,1,0.86,0.803,0.47,0.1343,182,2730,307,3070,489,5800
13356,2012-07-15,3,1,7,16,0,0,0,1,0.86,0.7879,0.41,0.2239,152,2280,343,3430,495,5710
13357,2012-07-15,3,1,7,17,0,0,0,1,0.8,0.7727,0.59,0.4925,122,1830,314,3140,436,4970
13358,2012-07-15,3,1,7,18,0,0,0,3,0.72,0.697,0.79,0.3582,84,1260,228,2280,312,3540
13359,2012-07-15,3,1,7,19,0,0,0,1,0.72,0.7121,0.84,0.2239,109,1635,203,2030,312,3665
13360,2012-07-15,3,1,7,20,0,0,0,1,0.72,0.697,0.79,0.2537,95,1425,199,1990,294,3415
13361,2012-07-15,3,1,7,21,0,0,0,1,0.72,0.697,0.79,0.0896,59,885,164,1640,223,2525
13362,2012-07-15,3,1,7,22,0,0,0,1,0.72,0.697,0.74,0.1045,34,510,96,960,130,1470
13363,2012-07-15,3,1,7,23,0,0,0,1,0.72,0.697,0.79,0.1343,25,375,66,660,91,1035
13364,2012-07-16,3,1,7,0,0,1,1,3,0.72,0.697,0.79,0.1045,11,165,32,320,43,485
13365,2012-07-16,3,1,7,1,0,1,1,2,0.7,0.6667,0.74,0.194,1,15,10,100,11,115
13366,2012-07-16,3,1,7,2,0,1,1,1,0.7,0.6667,0.74,0.1045,4,60,11,110,15,170
13367,2012-07-16,3,1,7,3,0,1,1,1,0.68,0.6364,0.79,0.0896,2,30,4,40,6,70
13368,2012-07-16,3,1,7,4,0,1,1,1,0.68,0.6364,0.79,0.1045,1,15,11,110,12,125
13369,2012-07-16,3,1,7,5,0,1,1,1,0.66,0.6061,0.78,0.1045,10,150,40,400,50,550
13370,2012-07-16,3,1,7,6,0,1,1,1,0.68,0.6364,0.79,0.1343,8,120,132,1320,140,1440
13371,2012-07-16,3,1,7,7,0,1,1,1,0.72,0.6818,0.7,0.0896,24,360,459,4590,483,4950
13372,2012-07-16,3,1,7,8,0,1,1,1,0.74,0.697,0.66,0.1045,48,720,619,6190,667,6910
13373,2012-07-16,3,1,7,9,0,1,1,1,0.76,0.7121,0.62,0.1642,51,765,297,2970,348,3735
13374,2012-07-16,3,1,7,10,0,1,1,1,0.8,0.7727,0.59,0.0,69,1035,117,1170,186,2205
13375,2012-07-16,3,1,7,11,0,1,1,1,0.84,0.803,0.53,0.2239,57,855,125,1250,182,2105
13376,2012-07-16,3,1,7,12,0,1,1,1,0.84,0.7879,0.49,0.1343,79,1185,158,1580,237,2765
13377,2012-07-16,3,1,7,13,0,1,1,1,0.84,0.7879,0.49,0.2836,63,945,176,1760,239,2705
13378,2012-07-16,3,1,7,14,0,1,1,1,0.88,0.8182,0.42,0.1045,53,795,159,1590,212,2385
13379,2012-07-16,3,1,7,15,0,1,1,1,0.86,0.803,0.47,0.2537,61,915,176,1760,237,2675
13380,2012-07-16,3,1,7,16,0,1,1,3,0.76,0.7273,0.66,0.5821,77,1155,309,3090,386,4245
13381,2012-07-16,3,1,7,17,0,1,1,3,0.76,0.7273,0.66,0.5821,86,1290,669,6690,755,7980
13382,2012-07-16,3,1,7,18,0,1,1,1,0.84,0.803,0.53,0.0,97,1455,697,6970,794,8425
13383,2012-07-16,3,1,7,19,0,1,1,1,0.8,0.7879,0.63,0.1343,92,1380,503,5030,595,6410
13384,2012-07-16,3,1,7,20,0,1,1,1,0.8,0.7727,0.59,0.1343,66,990,388,3880,454,4870
13385,2012-07-16,3,1,7,21,0,1,1,1,0.76,0.7273,0.66,0.1343,45,675,283,2830,328,3505
13386,2012-07-16,3,1,7,22,0,1,1,1,0.76,0.7121,0.62,0.0896,56,840,228,2280,284,3120
13387,2012-07-16,3,1,7,23,0,1,1,1,0.74,0.7121,0.74,0.0896,27,405,139,1390,166,1795
13388,2012-07-17,3,1,7,0,0,2,1,1,0.72,0.7121,0.84,0.1045,10,150,43,430,53,580
13389,2012-07-17,3,1,7,1,0,2,1,1,0.74,0.697,0.7,0.0,4,60,21,210,25,270
13390,2012-07-17,3,1,7,2,0,2,1,1,0.72,0.6818,0.7,0.0896,1,15,6,60,7,75
13391,2012-07-17,3,1,7,3,0,2,1,1,0.72,0.6818,0.66,0.0,0,0,3,30,3,30
13392,2012-07-17,3,1,7,4,0,2,1,1,0.72,0.6818,0.62,0.0,0,0,7,70,7,70
13393,2012-07-17,3,1,7,5,0,2,1,1,0.68,0.6364,0.74,0.0896,7,105,31,310,38,415
13394,2012-07-17,3,1,7,6,0,2,1,1,0.72,0.6818,0.66,0.1045,16,240,197,1970,213,2210
13395,2012-07-17,3,1,7,7,0,2,1,2,0.74,0.697,0.7,0.0,26,390,500,5000,526,5390
13396,2012-07-17,3,1,7,8,0,2,1,2,0.8,0.7576,0.55,0.0,43,645,618,6180,661,6825
13397,2012-07-17,3,1,7,9,0,2,1,2,0.82,0.7727,0.49,0.2239,32,480,288,2880,320,3360
13398,2012-07-17,3,1,7,10,0,2,1,2,0.84,0.7879,0.49,0.194,37,555,122,1220,159,1775
13399,2012-07-17,3,1,7,11,0,2,1,2,0.86,0.803,0.47,0.0,60,900,146,1460,206,2360
13400,2012-07-17,3,1,7,12,0,2,1,2,0.9,0.8182,0.35,0.0,80,1200,174,1740,254,2940
13401,2012-07-17,3,1,7,13,0,2,1,1,0.92,0.8182,0.31,0.194,53,795,168,1680,221,2475
13402,2012-07-17,3,1,7,14,0,2,1,1,0.94,0.8333,0.29,0.2537,54,810,160,1600,214,2410
13403,2012-07-17,3,1,7,15,0,2,1,1,0.92,0.8182,0.31,0.1642,57,855,187,1870,244,2725
13404,2012-07-17,3,1,7,16,0,2,1,1,0.92,0.8182,0.29,0.1642,64,960,317,3170,381,4130
13405,2012-07-17,3,1,7,17,0,2,1,1,0.92,0.8182,0.29,0.0,95,1425,675,6750,770,8175
13406,2012-07-17,3,1,7,18,0,2,1,1,0.9,0.803,0.33,0.194,60,900,712,7120,772,8020
13407,2012-07-17,3,1,7,19,0,2,1,1,0.88,0.7879,0.35,0.2537,69,1035,478,4780,547,5815
13408,2012-07-17,3,1,7,20,0,2,1,1,0.86,0.7576,0.34,0.1642,52,780,375,3750,427,4530
13409,2012-07-17,3,1,7,21,0,2,1,1,0.82,0.7727,0.52,0.1343,50,750,283,2830,333,3580
13410,2012-07-17,3,1,7,22,0,2,1,1,0.8,0.7576,0.55,0.2239,29,435,215,2150,244,2585
13411,2012-07-17,3,1,7,23,0,2,1,1,0.78,0.7424,0.59,0.194,22,330,139,1390,161,1720
13412,2012-07-18,3,1,7,0,0,3,1,1,0.76,0.7273,0.66,0.1642,8,120,45,450,53,570
13413,2012-07-18,3,1,7,1,0,3,1,1,0.76,0.7273,0.66,0.1045,2,30,14,140,16,170
13414,2012-07-18,3,1,7,2,0,3,1,1,0.74,0.697,0.66,0.1343,3,45,5,50,8,95
13415,2012-07-18,3,1,7,3,0,3,1,1,0.74,0.697,0.66,0.1343,2,30,2,20,4,50
13416,2012-07-18,3,1,7,4,0,3,1,1,0.72,0.6818,0.7,0.1343,0,0,6,60,6,60
13417,2012-07-18,3,1,7,5,0,3,1,1,0.72,0.6818,0.7,0.1642,5,75,41,410,46,485
13418,2012-07-18,3,1,7,6,0,3,1,1,0.72,0.6818,0.7,0.1642,10,150,152,1520,162,1670
13419,2012-07-18,3,1,7,7,0,3,1,1,0.74,0.697,0.66,0.1642,23,345,472,4720,495,5065
13420,2012-07-18,3,1,7,8,0,3,1,1,0.78,0.7424,0.62,0.1045,55,825,624,6240,679,7065
13421,2012-07-18,3,1,7,9,0,3,1,1,0.82,0.7879,0.56,0.0,44,660,253,2530,297,3190
13422,2012-07-18,3,1,7,10,0,3,1,1,0.9,0.8485,0.42,0.194,39,585,99,990,138,1575
13423,2012-07-18,3,1,7,11,0,3,1,1,0.9,0.8485,0.42,0.0,47,705,136,1360,183,2065
13424,2012-07-18,3,1,7,12,0,3,1,1,0.92,0.8636,0.37,0.1343,36,540,166,1660,202,2200
13425,2012-07-18,3,1,7,13,0,3,1,1,0.94,0.8485,0.33,0.0,49,735,154,1540,203,2275
13426,2012-07-18,3,1,7,14,0,3,1,1,0.94,0.8788,0.38,0.3284,54,810,116,1160,170,1970
13427,2012-07-18,3,1,7,15,0,3,1,3,0.92,0.8485,0.35,0.3582,42,630,152,1520,194,2150
13428,2012-07-18,3,1,7,16,0,3,1,1,0.74,0.697,0.66,0.2537,34,510,190,1900,224,2410
13429,2012-07-18,3,1,7,17,0,3,1,1,0.74,0.697,0.7,0.2537,35,525,335,3350,370,3875
13430,2012-07-18,3,1,7,18,0,3,1,2,0.76,0.7121,0.62,0.1343,63,945,580,5800,643,6745
13431,2012-07-18,3,1,7,19,0,3,1,2,0.76,0.7121,0.62,0.1045,78,1170,438,4380,516,5550
13432,2012-07-18,3,1,7,20,0,3,1,1,0.74,0.6818,0.62,0.0896,56,840,310,3100,366,3940
13433,2012-07-18,3,1,7,21,0,3,1,1,0.76,0.7121,0.62,0.0,53,795,266,2660,319,3455
13434,2012-07-18,3,1,7,22,0,3,1,1,0.76,0.7121,0.58,0.0896,42,630,246,2460,288,3090
13435,2012-07-18,3,1,7,23,0,3,1,1,0.76,0.7121,0.58,0.0896,19,285,112,1120,131,1405
13436,2012-07-19,3,1,7,0,0,4,1,1,0.74,0.697,0.66,0.0896,16,240,50,500,66,740
13437,2012-07-19,3,1,7,1,0,4,1,1,0.74,0.697,0.66,0.0896,6,90,19,190,25,280
13438,2012-07-19,3,1,7,2,0,4,1,1,0.72,0.6818,0.7,0.194,0,0,7,70,7,70
13439,2012-07-19,3,1,7,3,0,4,1,1,0.72,0.6818,0.7,0.1045,1,15,4,40,5,55
13440,2012-07-19,3,1,7,4,0,4,1,1,0.72,0.6818,0.7,0.1045,0,0,8,80,8,80
13441,2012-07-19,3,1,7,5,0,4,1,2,0.72,0.6818,0.7,0.1045,5,75,35,350,40,425
13442,2012-07-19,3,1,7,6,0,4,1,1,0.72,0.6818,0.66,0.1343,8,120,144,1440,152,1560
13443,2012-07-19,3,1,7,7,0,4,1,1,0.74,0.6818,0.58,0.2836,23,345,450,4500,473,4845
13444,2012-07-19,3,1,7,8,0,4,1,1,0.76,0.7121,0.58,0.2537,32,480,625,6250,657,6730
13445,2012-07-19,3,1,7,9,0,4,1,2,0.76,0.7121,0.58,0.2836,36,540,282,2820,318,3360
13446,2012-07-19,3,1,7,10,0,4,1,1,0.76,0.7121,0.58,0.194,41,615,157,1570,198,2185
13447,2012-07-19,3,1,7,11,0,4,1,1,0.8,0.7576,0.55,0.1045,54,810,162,1620,216,2430
13448,2012-07-19,3,1,7,12,0,4,1,1,0.84,0.7879,0.49,0.2836,59,885,215,2150,274,3035
13449,2012-07-19,3,1,7,13,0,4,1,1,0.84,0.7727,0.47,0.1343,74,1110,180,1800,254,2910
13450,2012-07-19,3,1,7,14,0,4,1,1,0.86,0.7879,0.44,0.0896,46,690,151,1510,197,2200
13451,2012-07-19,3,1,7,15,0,4,1,1,0.84,0.7727,0.47,0.0896,66,990,226,2260,292,3250
13452,2012-07-19,3,1,7,16,0,4,1,1,0.84,0.7727,0.47,0.0896,70,1050,288,2880,358,3930
13453,2012-07-19,3,1,7,17,0,4,1,1,0.86,0.7879,0.41,0.0,93,1395,678,6780,771,8175
13454,2012-07-19,3,1,7,18,0,4,1,1,0.86,0.7879,0.41,0.194,93,1395,684,6840,777,8235
13455,2012-07-19,3,1,7,19,0,4,1,1,0.84,0.7576,0.44,0.2537,53,795,480,4800,533,5595
13456,2012-07-19,3,1,7,20,0,4,1,1,0.82,0.7727,0.49,0.1642,65,975,440,4400,505,5375
13457,2012-07-19,3,1,7,21,0,4,1,3,0.66,0.5909,0.89,0.2537,38,570,294,2940,332,3510
13458,2012-07-19,3,1,7,22,0,4,1,3,0.66,0.5909,0.89,0.2537,6,90,62,620,68,710
13459,2012-07-19,3,1,7,23,0,4,1,3,0.66,0.5909,0.89,0.2239,3,45,62,620,65,665
13460,2012-07-20,3,1,7,0,0,5,1,3,0.66,0.5909,0.89,0.0896,2,30,32,320,34,350
13461,2012-07-20,3,1,7,1,0,5,1,1,0.66,0.5909,0.89,0.1343,2,30,9,90,11,120
13462,2012-07-20,3,1,7,2,0,5,1,2,0.66,0.5909,0.89,0.0896,5,75,14,140,19,215
13463,2012-07-20,3,1,7,3,0,5,1,2,0.66,0.5909,0.89,0.1045,7,105,29,290,36,395
13464,2012-07-20,3,1,7,4,0,5,1,2,0.66,0.5909,0.89,0.1642,3,45,6,60,9,105
13465,2012-07-20,3,1,7,5,0,5,1,2,0.66,0.5909,0.89,0.1343,2,30,40,400,42,430
13466,2012-07-20,3,1,7,6,0,5,1,2,0.66,0.5909,0.89,0.1642,3,45,123,1230,126,1275
13467,2012-07-20,3,1,7,7,0,5,1,2,0.66,0.5909,0.89,0.194,14,210,346,3460,360,3670
13468,2012-07-20,3,1,7,8,0,5,1,2,0.68,0.6364,0.83,0.1642,39,585,652,6520,691,7105
13469,2012-07-20,3,1,7,9,0,5,1,2,0.7,0.6667,0.79,0.1343,45,675,328,3280,373,3955
13470,2012-07-20,3,1,7,10,0,5,1,2,0.7,0.6667,0.79,0.1642,51,765,182,1820,233,2585
13471,2012-07-20,3,1,7,11,0,5,1,3,0.72,0.697,0.74,0.194,51,765,161,1610,212,2375
13472,2012-07-20,3,1,7,12,0,5,1,3,0.68,0.6364,0.83,0.1642,41,615,233,2330,274,2945
13473,2012-07-20,3,1,7,13,0,5,1,3,0.68,0.6364,0.83,0.1045,20,300,136,1360,156,1660
13474,2012-07-20,3,1,7,14,0,5,1,3,0.7,0.6667,0.84,0.1642,53,795,176,1760,229,2555
13475,2012-07-20,3,1,7,15,0,5,1,2,0.7,0.6667,0.84,0.2985,47,705,169,1690,216,2395
13476,2012-07-20,3,1,7,16,0,5,1,2,0.68,0.6364,0.83,0.3284,70,1050,366,3660,436,4710
13477,2012-07-20,3,1,7,17,0,5,1,2,0.66,0.5909,0.89,0.4179,95,1425,620,6200,715,7625
13478,2012-07-20,3,1,7,18,0,5,1,2,0.66,0.6061,0.78,0.3284,73,1095,549,5490,622,6585
13479,2012-07-20,3,1,7,19,0,5,1,2,0.64,0.5758,0.83,0.2836,44,660,358,3580,402,4240
13480,2012-07-20,3,1,7,20,0,5,1,3,0.64,0.5758,0.83,0.3881,35,525,216,2160,251,2685
13481,2012-07-20,3,1,7,21,0,5,1,3,0.62,0.5758,0.83,0.3284,14,210,108,1080,122,1290
13482,2012-07-20,3,1,7,22,0,5,1,2,0.62,0.5758,0.83,0.194,13,195,122,1220,135,1415
13483,2012-07-20,3,1,7,23,0,5,1,2,0.62,0.5758,0.83,0.2836,18,270,148,1480,166,1750
13484,2012-07-21,3,1,7,0,0,6,0,3,0.62,0.5758,0.83,0.2836,11,165,92,920,103,1085
13485,2012-07-21,3,1,7,1,0,6,0,2,0.62,0.5758,0.83,0.2537,10,150,62,620,72,770
13486,2012-07-21,3,1,7,2,0,6,0,3,0.6,0.5455,0.88,0.2836,5,75,55,550,60,625
13487,2012-07-21,3,1,7,3,0,6,0,3,0.6,0.5455,0.88,0.2537,7,105,18,180,25,285
13488,2012-07-21,3,1,7,4,0,6,0,3,0.58,0.5455,0.88,0.2836,11,165,5,50,16,215
13489,2012-07-21,3,1,7,5,0,6,0,3,0.58,0.5455,0.88,0.2537,7,105,10,100,17,205
13490,2012-07-21,3,1,7,6,0,6,0,3,0.58,0.5455,0.88,0.2537,3,45,12,120,15,165
13491,2012-07-21,3,1,7,7,0,6,0,2,0.58,0.5455,0.88,0.2537,8,120,29,290,37,410
13492,2012-07-21,3,1,7,8,0,6,0,2,0.58,0.5455,0.83,0.2537,18,270,94,940,112,1210
13493,2012-07-21,3,1,7,9,0,6,0,2,0.58,0.5455,0.83,0.194,32,480,175,1750,207,2230
13494,2012-07-21,3,1,7,10,0,6,0,3,0.58,0.5455,0.88,0.2537,49,735,219,2190,268,2925
13495,2012-07-21,3,1,7,11,0,6,0,2,0.6,0.5606,0.83,0.2537,80,1200,225,2250,305,3450
13496,2012-07-21,3,1,7,12,0,6,0,3,0.6,0.5606,0.83,0.2239,156,2340,301,3010,457,5350
13497,2012-07-21,3,1,7,13,0,6,0,3,0.6,0.5606,0.83,0.1642,106,1590,248,2480,354,4070
13498,2012-07-21,3,1,7,14,0,6,0,2,0.6,0.5455,0.88,0.2537,121,1815,222,2220,343,4035
13499,2012-07-21,3,1,7,15,0,6,0,3,0.6,0.5455,0.88,0.2537,148,2220,232,2320,380,4540
13500,2012-07-21,3,1,7,16,0,6,0,3,0.6,0.5455,0.88,0.194,130,1950,196,1960,326,3910
13501,2012-07-21,3,1,7,17,0,6,0,3,0.6,0.5455,0.88,0.1642,92,1380,149,1490,241,2870
13502,2012-07-21,3,1,7,18,0,6,0,2,0.6,0.5455,0.88,0.194,51,765,126,1260,177,2025
13503,2012-07-21,3,1,7,19,0,6,0,2,0.6,0.5455,0.88,0.1642,67,1005,171,1710,238,2715
13504,2012-07-21,3,1,7,20,0,6,0,3,0.6,0.5455,0.88,0.1642,51,765,163,1630,214,2395
13505,2012-07-21,3,1,7,21,0,6,0,2,0.6,0.5455,0.88,0.1642,29,435,134,1340,163,1775
13506,2012-07-21,3,1,7,22,0,6,0,2,0.6,0.5455,0.88,0.1045,40,600,140,1400,180,2000
13507,2012-07-21,3,1,7,23,0,6,0,2,0.6,0.5455,0.88,0.0,32,480,117,1170,149,1650
13508,2012-07-22,3,1,7,0,0,0,0,2,0.6,0.5455,0.88,0.1045,17,255,96,960,113,1215
13509,2012-07-22,3,1,7,1,0,0,0,2,0.6,0.5455,0.88,0.1642,31,465,99,990,130,1455
13510,2012-07-22,3,1,7,2,0,0,0,2,0.6,0.5455,0.88,0.1045,32,480,90,900,122,1380
13511,2012-07-22,3,1,7,3,0,0,0,2,0.6,0.5455,0.88,0.1045,13,195,30,300,43,495
13512,2012-07-22,3,1,7,4,0,0,0,1,0.6,0.5455,0.88,0.0,6,90,10,100,16,190
13513,2012-07-22,3,1,7,5,0,0,0,1,0.6,0.5455,0.88,0.0,0,0,6,60,6,60
13514,2012-07-22,3,1,7,6,0,0,0,2,0.62,0.5758,0.83,0.0896,5,75,14,140,19,215
13515,2012-07-22,3,1,7,7,0,0,0,2,0.62,0.5758,0.83,0.0,13,195,25,250,38,445
13516,2012-07-22,3,1,7,8,0,0,0,2,0.64,0.5909,0.78,0.0,31,465,122,1220,153,1685
13517,2012-07-22,3,1,7,9,0,0,0,2,0.66,0.6212,0.69,0.0,79,1185,179,1790,258,2975
13518,2012-07-22,3,1,7,10,0,0,0,2,0.66,0.6212,0.74,0.0,114,1710,265,2650,379,4360
13519,2012-07-22,3,1,7,11,0,0,0,2,0.66,0.6212,0.74,0.0,191,2865,314,3140,505,6005
13520,2012-07-22,3,1,7,12,0,0,0,2,0.7,0.6515,0.7,0.1045,178,2670,326,3260,504,5930
13521,2012-07-22,3,1,7,13,0,0,0,2,0.7,0.6515,0.65,0.0896,238,3570,388,3880,626,7450
13522,2012-07-22,3,1,7,14,0,0,0,1,0.72,0.6818,0.66,0.1045,256,3840,360,3600,616,7440
13523,2012-07-22,3,1,7,15,0,0,0,1,0.72,0.6818,0.66,0.1045,254,3810,370,3700,624,7510
13524,2012-07-22,3,1,7,16,0,0,0,1,0.74,0.697,0.66,0.1045,245,3675,383,3830,628,7505
13525,2012-07-22,3,1,7,17,0,0,0,1,0.74,0.697,0.66,0.2239,188,2820,368,3680,556,6500
13526,2012-07-22,3,1,7,18,0,0,0,1,0.74,0.697,0.66,0.1642,173,2595,342,3420,515,6015
13527,2012-07-22,3,1,7,19,0,0,0,1,0.72,0.6818,0.7,0.1642,180,2700,342,3420,522,6120
13528,2012-07-22,3,1,7,20,0,0,0,1,0.7,0.6667,0.74,0.1642,124,1860,254,2540,378,4400
13529,2012-07-22,3,1,7,21,0,0,0,1,0.7,0.6667,0.79,0.1045,88,1320,257,2570,345,3890
13530,2012-07-22,3,1,7,22,0,0,0,1,0.7,0.6667,0.74,0.194,55,825,136,1360,191,2185
13531,2012-07-22,3,1,7,23,0,0,0,1,0.68,0.6364,0.79,0.1642,33,495,90,900,123,1395
13532,2012-07-23,3,1,7,0,0,1,1,1,0.66,0.5909,0.89,0.0896,11,165,36,360,47,525
13533,2012-07-23,3,1,7,1,0,1,1,1,0.66,0.5909,0.89,0.194,7,105,20,200,27,305
13534,2012-07-23,3,1,7,2,0,1,1,2,0.66,0.5909,0.94,0.0896,3,45,14,140,17,185
13535,2012-07-23,3,1,7,3,0,1,1,2,0.66,0.5909,0.94,0.0896,0,0,2,20,2,20
13536,2012-07-23,3,1,7,4,0,1,1,2,0.66,0.5909,0.94,0.1343,0,0,8,80,8,80
13537,2012-07-23,3,1,7,5,0,1,1,2,0.66,0.5909,0.94,0.1343,3,45,48,480,51,525
13538,2012-07-23,3,1,7,6,0,1,1,2,0.68,0.6364,0.89,0.0896,9,135,148,1480,157,1615
13539,2012-07-23,3,1,7,7,0,1,1,1,0.7,0.6667,0.84,0.1343,17,255,404,4040,421,4295
13540,2012-07-23,3,1,7,8,0,1,1,1,0.72,0.697,0.79,0.1045,47,705,691,6910,738,7615
13541,2012-07-23,3,1,7,9,0,1,1,2,0.74,0.7121,0.74,0.1343,57,855,288,2880,345,3735
13542,2012-07-23,3,1,7,10,0,1,1,2,0.78,0.7424,0.62,0.0,63,945,137,1370,200,2315
13543,2012-07-23,3,1,7,11,0,1,1,2,0.8,0.7424,0.52,0.1642,69,1035,129,1290,198,2325
13544,2012-07-23,3,1,7,12,0,1,1,2,0.8,0.7424,0.52,0.1642,109,1635,205,2050,314,3685
13545,2012-07-23,3,1,7,13,0,1,1,2,0.8,0.7424,0.52,0.1045,64,960,176,1760,240,2720
13546,2012-07-23,3,1,7,14,0,1,1,2,0.78,0.7424,0.59,0.1642,82,1230,189,1890,271,3120
13547,2012-07-23,3,1,7,15,0,1,1,1,0.8,0.7576,0.55,0.194,76,1140,205,2050,281,3190
13548,2012-07-23,3,1,7,16,0,1,1,1,0.82,0.7727,0.52,0.1343,111,1665,346,3460,457,5125
13549,2012-07-23,3,1,7,17,0,1,1,1,0.82,0.7727,0.52,0.1343,87,1305,760,7600,847,8905
13550,2012-07-23,3,1,7,18,0,1,1,1,0.82,0.7576,0.46,0.1045,69,1035,672,6720,741,7755
13551,2012-07-23,3,1,7,19,0,1,1,1,0.8,0.7424,0.52,0.2537,94,1410,488,4880,582,6290
13552,2012-07-23,3,1,7,20,0,1,1,1,0.76,0.7121,0.62,0.1642,56,840,347,3470,403,4310
13553,2012-07-23,3,1,7,21,0,1,1,1,0.76,0.7121,0.62,0.194,45,675,251,2510,296,3185
13554,2012-07-23,3,1,7,22,0,1,1,1,0.74,0.6818,0.62,0.194,40,600,169,1690,209,2290
13555,2012-07-23,3,1,7,23,0,1,1,1,0.72,0.6818,0.66,0.1642,16,240,98,980,114,1220
13556,2012-07-24,3,1,7,0,0,2,1,1,0.7,0.6667,0.74,0.1343,12,180,52,520,64,700
13557,2012-07-24,3,1,7,1,0,2,1,1,0.68,0.6364,0.79,0.1642,7,105,10,100,17,205
13558,2012-07-24,3,1,7,2,0,2,1,1,0.66,0.6061,0.83,0.1642,6,90,10,100,16,190
13559,2012-07-24,3,1,7,3,0,2,1,1,0.66,0.6061,0.83,0.1642,1,15,5,50,6,65
13560,2012-07-24,3,1,7,4,0,2,1,1,0.66,0.6061,0.83,0.0896,0,0,6,60,6,60
13561,2012-07-24,3,1,7,5,0,2,1,1,0.66,0.6061,0.83,0.1045,5,75,45,450,50,525
13562,2012-07-24,3,1,7,6,0,2,1,1,0.66,0.6061,0.83,0.1343,17,255,173,1730,190,1985
13563,2012-07-24,3,1,7,7,0,2,1,1,0.7,0.6667,0.74,0.1642,24,360,492,4920,516,5280
13564,2012-07-24,3,1,7,8,0,2,1,1,0.74,0.697,0.7,0.194,49,735,694,6940,743,7675
13565,2012-07-24,3,1,7,9,0,2,1,1,0.84,0.803,0.53,0.0,40,600,299,2990,339,3590
13566,2012-07-24,3,1,7,10,0,2,1,1,0.82,0.7879,0.56,0.2985,62,930,156,1560,218,2490
13567,2012-07-24,3,1,7,11,0,2,1,2,0.84,0.803,0.53,0.3284,45,675,156,1560,201,2235
13568,2012-07-24,3,1,7,12,0,2,1,2,0.82,0.7879,0.56,0.2239,60,900,169,1690,229,2590
13569,2012-07-24,3,1,7,13,0,2,1,2,0.84,0.803,0.53,0.2985,73,1095,200,2000,273,3095
13570,2012-07-24,3,1,7,14,0,2,1,2,0.84,0.803,0.53,0.2239,48,720,196,1960,244,2680
13571,2012-07-24,3,1,7,15,0,2,1,1,0.82,0.7727,0.49,0.2985,73,1095,212,2120,285,3215
13572,2012-07-24,3,1,7,16,0,2,1,1,0.8,0.7576,0.55,0.2985,86,1290,369,3690,455,4980
13573,2012-07-24,3,1,7,17,0,2,1,1,0.8,0.7424,0.52,0.3284,94,1410,775,7750,869,9160
13574,2012-07-24,3,1,7,18,0,2,1,1,0.76,0.7121,0.62,0.3284,110,1650,767,7670,877,9320
13575,2012-07-24,3,1,7,19,0,2,1,1,0.76,0.7121,0.62,0.1642,109,1635,523,5230,632,6865
13576,2012-07-24,3,1,7,20,0,2,1,1,0.74,0.697,0.66,0.1642,85,1275,438,4380,523,5655
13577,2012-07-24,3,1,7,21,0,2,1,1,0.74,0.697,0.66,0.2239,53,795,325,3250,378,4045
13578,2012-07-24,3,1,7,22,0,2,1,1,0.74,0.697,0.66,0.2537,43,645,226,2260,269,2905
13579,2012-07-24,3,1,7,23,0,2,1,1,0.74,0.6818,0.58,0.3284,38,570,154,1540,192,2110
13580,2012-07-25,3,1,7,0,0,3,1,1,0.72,0.6667,0.58,0.2985,9,135,57,570,66,705
13581,2012-07-25,3,1,7,1,0,3,1,1,0.7,0.6515,0.58,0.194,2,30,26,260,28,290
13582,2012-07-25,3,1,7,2,0,3,1,1,0.68,0.6364,0.61,0.2239,1,15,11,110,12,125
13583,2012-07-25,3,1,7,3,0,3,1,1,0.66,0.6212,0.65,0.2239,1,15,11,110,12,125
13584,2012-07-25,3,1,7,4,0,3,1,1,0.64,0.6061,0.65,0.2239,0,0,4,40,4,40
13585,2012-07-25,3,1,7,5,0,3,1,1,0.64,0.6061,0.65,0.1642,5,75,54,540,59,615
13586,2012-07-25,3,1,7,6,0,3,1,1,0.64,0.6061,0.65,0.194,11,165,179,1790,190,1955
13587,2012-07-25,3,1,7,7,0,3,1,1,0.66,0.6212,0.5,0.3284,34,510,473,4730,507,5240
13588,2012-07-25,3,1,7,8,0,3,1,1,0.7,0.6364,0.42,0.2537,43,645,745,7450,788,8095
13589,2012-07-25,3,1,7,9,0,3,1,1,0.72,0.6515,0.37,0.2985,65,975,277,2770,342,3745
13590,2012-07-25,3,1,7,10,0,3,1,1,0.74,0.6515,0.37,0.0,68,1020,163,1630,231,2650
13591,2012-07-25,3,1,7,11,0,3,1,1,0.76,0.6667,0.33,0.0,79,1185,202,2020,281,3205
13592,2012-07-25,3,1,7,12,0,3,1,1,0.76,0.6667,0.33,0.0,77,1155,233,2330,310,3485
13593,2012-07-25,3,1,7,13,0,3,1,1,0.78,0.6818,0.31,0.1642,81,1215,231,2310,312,3525
13594,2012-07-25,3,1,7,14,0,3,1,1,0.8,0.697,0.29,0.1343,88,1320,159,1590,247,2910
13595,2012-07-25,3,1,7,15,0,3,1,1,0.78,0.6818,0.31,0.0896,94,1410,223,2230,317,3640
13596,2012-07-25,3,1,7,16,0,3,1,1,0.8,0.697,0.29,0.1642,91,1365,393,3930,484,5295
13597,2012-07-25,3,1,7,17,0,3,1,1,0.8,0.697,0.31,0.0,130,1950,783,7830,913,9780
13598,2012-07-25,3,1,7,18,0,3,1,1,0.8,0.697,0.27,0.1343,104,1560,787,7870,891,9430
13599,2012-07-25,3,1,7,19,0,3,1,1,0.76,0.6667,0.33,0.1343,116,1740,582,5820,698,7560
13600,2012-07-25,3,1,7,20,0,3,1,1,0.74,0.6515,0.4,0.1642,106,1590,461,4610,567,6200
13601,2012-07-25,3,1,7,21,0,3,1,1,0.72,0.6515,0.45,0.1343,71,1065,326,3260,397,4325
13602,2012-07-25,3,1,7,22,0,3,1,1,0.7,0.6515,0.58,0.1343,55,825,223,2230,278,3055
13603,2012-07-25,3,1,7,23,0,3,1,1,0.68,0.6364,0.57,0.2985,52,780,187,1870,239,2650
13604,2012-07-26,3,1,7,0,0,4,1,1,0.66,0.6212,0.65,0.194,27,405,65,650,92,1055
13605,2012-07-26,3,1,7,1,0,4,1,1,0.66,0.6212,0.65,0.2239,6,90,23,230,29,320
13606,2012-07-26,3,1,7,2,0,4,1,1,0.66,0.6212,0.69,0.2537,5,75,16,160,21,235
13607,2012-07-26,3,1,7,3,0,4,1,1,0.66,0.6212,0.69,0.2239,0,0,8,80,8,80
13608,2012-07-26,3,1,7,4,0,4,1,1,0.66,0.6212,0.74,0.194,0,0,4,40,4,40
13609,2012-07-26,3,1,7,5,0,4,1,1,0.66,0.6212,0.74,0.194,2,30,40,400,42,430
13610,2012-07-26,3,1,7,6,0,4,1,1,0.66,0.6061,0.78,0.2537,16,240,165,1650,181,1890
13611,2012-07-26,3,1,7,7,0,4,1,1,0.7,0.6667,0.74,0.2537,17,255,478,4780,495,5035
13612,2012-07-26,3,1,7,8,0,4,1,2,0.7,0.6667,0.74,0.2537,49,735,680,6800,729,7535
13613,2012-07-26,3,1,7,9,0,4,1,2,0.72,0.6818,0.7,0.1343,55,825,289,2890,344,3715
13614,2012-07-26,3,1,7,10,0,4,1,1,0.74,0.697,0.7,0.2239,79,1185,143,1430,222,2615
13615,2012-07-26,3,1,7,11,0,4,1,1,0.8,0.803,0.66,0.2239,69,1035,143,1430,212,2465
13616,2012-07-26,3,1,7,12,0,4,1,1,0.84,0.8182,0.56,0.2537,73,1095,206,2060,279,3155
13617,2012-07-26,3,1,7,13,0,4,1,1,0.86,0.8333,0.53,0.2985,53,795,189,1890,242,2685
13618,2012-07-26,3,1,7,14,0,4,1,1,0.9,0.8788,0.47,0.2537,62,930,151,1510,213,2440
13619,2012-07-26,3,1,7,15,0,4,1,1,0.92,0.8939,0.42,0.2985,65,975,173,1730,238,2705
13620,2012-07-26,3,1,7,16,0,4,1,1,0.94,0.8788,0.38,0.3881,62,930,312,3120,374,4050
13621,2012-07-26,3,1,7,17,0,4,1,1,0.9,0.8636,0.45,0.4179,110,1650,628,6280,738,7930
13622,2012-07-26,3,1,7,18,0,4,1,1,0.92,0.8788,0.4,0.3582,73,1095,615,6150,688,7245
13623,2012-07-26,3,1,7,19,0,4,1,1,0.9,0.8636,0.45,0.3284,80,1200,534,5340,614,6540
13624,2012-07-26,3,1,7,20,0,4,1,1,0.86,0.8182,0.5,0.2537,47,705,399,3990,446,4695
13625,2012-07-26,3,1,7,21,0,4,1,1,0.8,0.7424,0.49,0.6119,35,525,236,2360,271,2885
13626,2012-07-26,3,1,7,22,0,4,1,1,0.8,0.7424,0.49,0.6119,33,495,201,2010,234,2505
13627,2012-07-26,3,1,7,23,0,4,1,1,0.72,0.6818,0.7,0.1343,18,270,127,1270,145,1540
13628,2012-07-27,3,1,7,0,0,5,1,1,0.72,0.6818,0.7,0.0,14,210,83,830,97,1040
13629,2012-07-27,3,1,7,1,0,5,1,1,0.72,0.6818,0.7,0.1045,12,180,42,420,54,600
13630,2012-07-27,3,1,7,2,0,5,1,1,0.7,0.6667,0.79,0.1343,8,120,18,180,26,300
13631,2012-07-27,3,1,7,3,0,5,1,1,0.7,0.6667,0.74,0.1642,3,45,9,90,12,135
13632,2012-07-27,3,1,7,4,0,5,1,1,0.7,0.6667,0.79,0.0,3,45,5,50,8,95
13633,2012-07-27,3,1,7,5,0,5,1,1,0.7,0.6667,0.84,0.0,3,45,34,340,37,385
13634,2012-07-27,3,1,7,6,0,5,1,1,0.7,0.6667,0.79,0.0,10,150,129,1290,139,1440
13635,2012-07-27,3,1,7,7,0,5,1,1,0.72,0.6818,0.7,0.194,13,195,397,3970,410,4165
13636,2012-07-27,3,1,7,8,0,5,1,1,0.76,0.7273,0.66,0.0896,34,510,642,6420,676,6930
13637,2012-07-27,3,1,7,9,0,5,1,1,0.82,0.7727,0.49,0.2836,34,510,329,3290,363,3800
13638,2012-07-27,3,1,7,10,0,5,1,1,0.84,0.7727,0.47,0.0,85,1275,146,1460,231,2735
13639,2012-07-27,3,1,7,11,0,5,1,1,0.84,0.7727,0.47,0.3284,67,1005,184,1840,251,2845
13640,2012-07-27,3,1,7,12,0,5,1,1,0.84,0.7879,0.49,0.3582,92,1380,207,2070,299,3450
13641,2012-07-27,3,1,7,13,0,5,1,1,0.84,0.7727,0.47,0.2836,83,1245,231,2310,314,3555
13642,2012-07-27,3,1,7,14,0,5,1,1,0.86,0.803,0.47,0.2985,105,1575,221,2210,326,3785
13643,2012-07-27,3,1,7,15,0,5,1,1,0.86,0.7879,0.41,0.2239,81,1215,242,2420,323,3635
13644,2012-07-27,3,1,7,16,0,5,1,1,0.84,0.7727,0.47,0.2239,80,1200,419,4190,499,5390
13645,2012-07-27,3,1,7,17,0,5,1,1,0.86,0.7879,0.41,0.2836,101,1515,598,5980,699,7495
13646,2012-07-27,3,1,7,18,0,5,1,1,0.82,0.7576,0.46,0.1642,100,1500,522,5220,622,6720
13647,2012-07-27,3,1,7,19,0,5,1,1,0.82,0.7727,0.52,0.194,93,1395,423,4230,516,5625
13648,2012-07-27,3,1,7,20,0,5,1,1,0.78,0.7424,0.59,0.1045,85,1275,269,2690,354,3965
13649,2012-07-27,3,1,7,21,0,5,1,1,0.78,0.7424,0.59,0.1045,71,1065,189,1890,260,2955
13650,2012-07-27,3,1,7,22,0,5,1,1,0.78,0.7424,0.59,0.1343,48,720,151,1510,199,2230
13651,2012-07-27,3,1,7,23,0,5,1,1,0.76,0.7273,0.66,0.0,34,510,155,1550,189,2060
13652,2012-07-28,3,1,7,0,0,6,0,1,0.74,0.6818,0.62,0.1343,21,315,170,1700,191,2015
13653,2012-07-28,3,1,7,1,0,6,0,1,0.72,0.6818,0.7,0.0896,11,165,69,690,80,855
13654,2012-07-28,3,1,7,2,0,6,0,1,0.72,0.6818,0.7,0.0,14,210,76,760,90,970
13655,2012-07-28,3,1,7,3,0,6,0,1,0.72,0.6818,0.7,0.0,10,150,33,330,43,480
13656,2012-07-28,3,1,7,4,0,6,0,1,0.7,0.6667,0.79,0.194,1,15,10,100,11,115
13657,2012-07-28,3,1,7,5,0,6,0,1,0.68,0.6364,0.79,0.1642,4,60,10,100,14,160
13658,2012-07-28,3,1,7,6,0,6,0,1,0.7,0.6515,0.7,0.1045,10,150,40,400,50,550
13659,2012-07-28,3,1,7,7,0,6,0,1,0.72,0.6818,0.7,0.1343,18,270,58,580,76,850
13660,2012-07-28,3,1,7,8,0,6,0,1,0.74,0.697,0.66,0.1642,36,540,127,1270,163,1810
13661,2012-07-28,3,1,7,9,0,6,0,1,0.78,0.7424,0.59,0.1045,110,1650,227,2270,337,3920
13662,2012-07-28,3,1,7,10,0,6,0,1,0.82,0.7727,0.52,0.2239,129,1935,266,2660,395,4595
13663,2012-07-28,3,1,7,11,0,6,0,1,0.84,0.7424,0.39,0.2239,162,2430,295,2950,457,5380
13664,2012-07-28,3,1,7,12,0,6,0,1,0.84,0.7576,0.41,0.2239,157,2355,330,3300,487,5655
13665,2012-07-28,3,1,7,13,0,6,0,1,0.86,0.7879,0.41,0.2836,173,2595,325,3250,498,5845
13666,2012-07-28,3,1,7,14,0,6,0,1,0.86,0.7727,0.39,0.2537,186,2790,308,3080,494,5870
13667,2012-07-28,3,1,7,15,0,6,0,1,0.88,0.7727,0.32,0.2836,206,3090,291,2910,497,6000
13668,2012-07-28,3,1,7,16,0,6,0,1,0.86,0.7727,0.39,0.2239,208,3120,279,2790,487,5910
13669,2012-07-28,3,1,7,17,0,6,0,1,0.82,0.7576,0.46,0.194,199,2985,280,2800,479,5785
13670,2012-07-28,3,1,7,18,0,6,0,1,0.82,0.7424,0.43,0.2836,151,2265,330,3300,481,5565
13671,2012-07-28,3,1,7,19,0,6,0,1,0.68,0.6364,0.83,0.0,115,1725,223,2230,338,3955
13672,2012-07-28,3,1,7,20,0,6,0,1,0.66,0.6061,0.83,0.2239,79,1185,154,1540,233,2725
13673,2012-07-28,3,1,7,21,0,6,0,1,0.66,0.6061,0.78,0.0896,94,1410,206,2060,300,3470
13674,2012-07-28,3,1,7,22,0,6,0,1,0.66,0.6061,0.78,0.0896,88,1320,188,1880,276,3200
13675,2012-07-28,3,1,7,23,0,6,0,1,0.66,0.6061,0.83,0.0896,52,780,156,1560,208,2340
13676,2012-07-29,3,1,7,0,0,0,0,1,0.66,0.5909,0.89,0.1343,59,885,129,1290,188,2175
13677,2012-07-29,3,1,7,1,0,0,0,1,0.66,0.6061,0.83,0.1045,49,735,109,1090,158,1825
13678,2012-07-29,3,1,7,2,0,0,0,1,0.66,0.6212,0.74,0.1343,33,495,79,790,112,1285
13679,2012-07-29,3,1,7,3,0,0,0,1,0.66,0.6212,0.69,0.2239,18,270,37,370,55,640
13680,2012-07-29,3,1,7,4,0,0,0,1,0.64,0.6061,0.69,0.194,2,30,11,110,13,140
13681,2012-07-29,3,1,7,5,0,0,0,1,0.62,0.5909,0.78,0.194,3,45,14,140,17,185
13682,2012-07-29,3,1,7,6,0,0,0,1,0.64,0.6061,0.73,0.1642,6,90,12,120,18,210
13683,2012-07-29,3,1,7,7,0,0,0,1,0.66,0.6212,0.69,0.2537,4,60,36,360,40,420
13684,2012-07-29,3,1,7,8,0,0,0,1,0.7,0.6515,0.65,0.2239,37,555,90,900,127,1455
13685,2012-07-29,3,1,7,9,0,0,0,1,0.72,0.6818,0.62,0.2537,64,960,162,1620,226,2580
13686,2012-07-29,3,1,7,10,0,0,0,1,0.74,0.6818,0.62,0.0,123,1845,258,2580,381,4425
13687,2012-07-29,3,1,7,11,0,0,0,1,0.76,0.697,0.55,0.2239,183,2745,326,3260,509,6005
13688,2012-07-29,3,1,7,12,0,0,0,1,0.76,0.697,0.55,0.3284,154,2310,357,3570,511,5880
13689,2012-07-29,3,1,7,13,0,0,0,1,0.8,0.7424,0.49,0.2239,181,2715,302,3020,483,5735
13690,2012-07-29,3,1,7,14,0,0,0,1,0.8,0.7273,0.46,0.194,231,3465,291,2910,522,6375
13691,2012-07-29,3,1,7,15,0,0,0,1,0.8,0.7273,0.43,0.1343,195,2925,306,3060,501,5985
13692,2012-07-29,3,1,7,16,0,0,0,1,0.8,0.7273,0.43,0.1343,191,2865,330,3300,521,6165
13693,2012-07-29,3,1,7,17,0,0,0,1,0.82,0.7424,0.41,0.1642,164,2460,367,3670,531,6130
13694,2012-07-29,3,1,7,18,0,0,0,1,0.8,0.7121,0.41,0.2985,117,1755,302,3020,419,4775
13695,2012-07-29,3,1,7,19,0,0,0,1,0.76,0.697,0.55,0.1642,143,2145,300,3000,443,5145
13696,2012-07-29,3,1,7,20,0,0,0,1,0.74,0.697,0.66,0.1045,75,1125,228,2280,303,3405
13697,2012-07-29,3,1,7,21,0,0,0,1,0.72,0.6818,0.7,0.1343,72,1080,199,1990,271,3070
13698,2012-07-29,3,1,7,22,0,0,0,1,0.7,0.6515,0.7,0.1045,31,465,117,1170,148,1635
13699,2012-07-29,3,1,7,23,0,0,0,1,0.7,0.6515,0.7,0.0,18,270,82,820,100,1090
13700,2012-07-30,3,1,7,0,0,1,1,1,0.7,0.6667,0.74,0.0896,12,180,46,460,58,640
13701,2012-07-30,3,1,7,1,0,1,1,1,0.7,0.6667,0.74,0.0,4,60,15,150,19,210
13702,2012-07-30,3,1,7,2,0,1,1,1,0.68,0.6364,0.74,0.0,2,30,6,60,8,90
13703,2012-07-30,3,1,7,3,0,1,1,1,0.66,0.6061,0.83,0.0,0,0,3,30,3,30
13704,2012-07-30,3,1,7,4,0,1,1,1,0.66,0.6061,0.83,0.0,0,0,5,50,5,50
13705,2012-07-30,3,1,7,5,0,1,1,1,0.66,0.6061,0.83,0.1045,4,60,43,430,47,490
13706,2012-07-30,3,1,7,6,0,1,1,1,0.66,0.6061,0.83,0.1642,6,90,155,1550,161,1640
13707,2012-07-30,3,1,7,7,0,1,1,1,0.7,0.6667,0.79,0.0896,14,210,455,4550,469,4760
13708,2012-07-30,3,1,7,8,0,1,1,2,0.72,0.697,0.74,0.1045,31,465,720,7200,751,7665
13709,2012-07-30,3,1,7,9,0,1,1,2,0.74,0.697,0.7,0.0,34,510,259,2590,293,3100
13710,2012-07-30,3,1,7,10,0,1,1,2,0.74,0.697,0.66,0.2239,54,810,135,1350,189,2160
13711,2012-07-30,3,1,7,11,0,1,1,2,0.78,0.7273,0.55,0.1343,69,1035,146,1460,215,2495
13712,2012-07-30,3,1,7,12,0,1,1,2,0.76,0.7121,0.58,0.1045,77,1155,201,2010,278,3165
13713,2012-07-30,3,1,7,13,0,1,1,1,0.8,0.7424,0.49,0.1642,57,855,169,1690,226,2545
13714,2012-07-30,3,1,7,14,0,1,1,1,0.8,0.7424,0.49,0.2239,87,1305,167,1670,254,2975
13715,2012-07-30,3,1,7,15,0,1,1,1,0.8,0.7424,0.49,0.2537,51,765,185,1850,236,2615
13716,2012-07-30,3,1,7,16,0,1,1,1,0.8,0.7424,0.49,0.2836,88,1320,337,3370,425,4690
13717,2012-07-30,3,1,7,17,0,1,1,1,0.76,0.697,0.55,0.3284,62,930,765,7650,827,8580
13718,2012-07-30,3,1,7,18,0,1,1,1,0.76,0.7121,0.58,0.4179,77,1155,735,7350,812,8505
13719,2012-07-30,3,1,7,19,0,1,1,1,0.82,0.7727,0.52,0.1642,81,1215,584,5840,665,7055
13720,2012-07-30,3,1,7,20,0,1,1,1,0.72,0.6818,0.7,0.2239,78,1170,384,3840,462,5010
13721,2012-07-30,3,1,7,21,0,1,1,1,0.72,0.6818,0.7,0.194,71,1065,251,2510,322,3575
13722,2012-07-30,3,1,7,22,0,1,1,2,0.7,0.6667,0.74,0.2239,47,705,183,1830,230,2535
13723,2012-07-30,3,1,7,23,0,1,1,1,0.7,0.6667,0.74,0.194,34,510,116,1160,150,1670
13724,2012-07-31,3,1,7,0,0,2,1,1,0.68,0.6364,0.79,0.1343,11,165,27,270,38,435
13725,2012-07-31,3,1,7,1,0,2,1,1,0.66,0.6061,0.83,0.1343,3,45,18,180,21,225
13726,2012-07-31,3,1,7,2,0,2,1,1,0.66,0.6061,0.83,0.1343,0,0,8,80,8,80
13727,2012-07-31,3,1,7,3,0,2,1,1,0.66,0.6061,0.83,0.0896,1,15,5,50,6,65
13728,2012-07-31,3,1,7,4,0,2,1,1,0.66,0.6061,0.83,0.0896,0,0,6,60,6,60
13729,2012-07-31,3,1,7,5,0,2,1,1,0.66,0.6061,0.83,0.1642,5,75,40,400,45,475
13730,2012-07-31,3,1,7,6,0,2,1,1,0.64,0.5758,0.89,0.1642,2,30,192,1920,194,1950
13731,2012-07-31,3,1,7,7,0,2,1,1,0.68,0.6364,0.83,0.2239,21,315,492,4920,513,5235
13732,2012-07-31,3,1,7,8,0,2,1,1,0.7,0.6667,0.79,0.1343,30,450,730,7300,760,7750
13733,2012-07-31,3,1,7,9,0,2,1,1,0.72,0.6818,0.7,0.1045,31,465,302,3020,333,3485
13734,2012-07-31,3,1,7,10,0,2,1,1,0.72,0.6818,0.66,0.0,73,1095,154,1540,227,2635
13735,2012-07-31,3,1,7,11,0,2,1,1,0.76,0.7121,0.58,0.0,54,810,170,1700,224,2510
13736,2012-07-31,3,1,7,12,0,2,1,1,0.8,0.7273,0.46,0.0,50,750,198,1980,248,2730
13737,2012-07-31,3,1,7,13,0,2,1,1,0.8,0.7576,0.55,0.2836,69,1035,219,2190,288,3225
13738,2012-07-31,3,1,7,14,0,2,1,1,0.8,0.7576,0.55,0.2836,72,1080,188,1880,260,2960
13739,2012-07-31,3,1,7,15,0,2,1,1,0.76,0.7121,0.62,0.1343,29,435,115,1150,144,1585
13740,2012-07-31,3,1,7,16,0,2,1,1,0.76,0.7121,0.58,0.2239,66,990,336,3360,402,4350
13741,2012-07-31,3,1,7,17,0,2,1,1,0.78,0.7121,0.52,0.2239,94,1410,726,7260,820,8670
13742,2012-07-31,3,1,7,18,0,2,1,1,0.76,0.697,0.55,0.2836,99,1485,758,7580,857,9065
13743,2012-07-31,3,1,7,19,0,2,1,3,0.74,0.6818,0.62,0.3582,90,1350,524,5240,614,6590
13744,2012-07-31,3,1,7,20,0,2,1,3,0.7,0.6515,0.7,0.194,55,825,397,3970,452,4795
13745,2012-07-31,3,1,7,21,0,2,1,1,0.68,0.6364,0.79,0.194,60,900,292,2920,352,3820
13746,2012-07-31,3,1,7,22,0,2,1,1,0.68,0.6364,0.74,0.2537,33,495,224,2240,257,2735
13747,2012-07-31,3,1,7,23,0,2,1,2,0.66,0.6061,0.83,0.1642,20,300,127,1270,147,1570
13748,2012-08-01,3,1,8,0,0,3,1,1,0.68,0.6364,0.79,0.1642,3,45,44,440,47,485
13749,2012-08-01,3,1,8,1,0,3,1,1,0.66,0.6061,0.83,0.0896,5,75,28,280,33,355
13750,2012-08-01,3,1,8,2,0,3,1,1,0.64,0.5758,0.83,0.1045,0,0,13,130,13,130
13751,2012-08-01,3,1,8,3,0,3,1,1,0.64,0.5758,0.83,0.1045,0,0,7,70,7,70
13752,2012-08-01,3,1,8,4,0,3,1,2,0.64,0.5909,0.78,0.1343,1,15,3,30,4,45
13753,2012-08-01,3,1,8,5,0,3,1,2,0.64,0.5909,0.78,0.1343,3,45,46,460,49,505
13754,2012-08-01,3,1,8,6,0,3,1,1,0.64,0.5909,0.78,0.1343,6,90,179,1790,185,1880
13755,2012-08-01,3,1,8,7,0,3,1,2,0.64,0.5758,0.83,0.1343,19,285,468,4680,487,4965
13756,2012-08-01,3,1,8,8,0,3,1,2,0.66,0.6061,0.78,0.194,32,480,649,6490,681,6970
13757,2012-08-01,3,1,8,9,0,3,1,2,0.68,0.6364,0.74,0.0896,34,510,316,3160,350,3670
13758,2012-08-01,3,1,8,10,0,3,1,1,0.72,0.6818,0.66,0.0896,61,915,175,1750,236,2665
13759,2012-08-01,3,1,8,11,0,3,1,1,0.76,0.7121,0.58,0.0896,54,810,180,1800,234,2610
13760,2012-08-01,3,1,8,12,0,3,1,1,0.8,0.7424,0.49,0.1045,75,1125,209,2090,284,3215
13761,2012-08-01,3,1,8,13,0,3,1,1,0.8,0.7424,0.52,0.1642,59,885,221,2210,280,3095
13762,2012-08-01,3,1,8,14,0,3,1,1,0.82,0.7576,0.46,0.1642,88,1320,175,1750,263,3070
13763,2012-08-01,3,1,8,15,0,3,1,1,0.82,0.7576,0.46,0.1642,89,1335,206,2060,295,3395
13764,2012-08-01,3,1,8,16,0,3,1,1,0.8,0.7576,0.55,0.2836,93,1395,386,3860,479,5255
13765,2012-08-01,3,1,8,17,0,3,1,1,0.8,0.7424,0.49,0.1642,103,1545,734,7340,837,8885
13766,2012-08-01,3,1,8,18,0,3,1,3,0.76,0.7121,0.62,0.2239,105,1575,786,7860,891,9435
13767,2012-08-01,3,1,8,19,0,3,1,1,0.74,0.697,0.66,0.2537,88,1320,564,5640,652,6960
13768,2012-08-01,3,1,8,20,0,3,1,1,0.74,0.697,0.66,0.1642,65,975,448,4480,513,5455
13769,2012-08-01,3,1,8,21,0,3,1,1,0.72,0.6818,0.7,0.1343,36,540,284,2840,320,3380
13770,2012-08-01,3,1,8,22,0,3,1,1,0.72,0.6818,0.7,0.1045,37,555,251,2510,288,3065
13771,2012-08-01,3,1,8,23,0,3,1,1,0.7,0.6667,0.74,0.0,18,270,134,1340,152,1610
13772,2012-08-02,3,1,8,0,0,4,1,1,0.7,0.6667,0.74,0.0,8,120,55,550,63,670
13773,2012-08-02,3,1,8,1,0,4,1,1,0.68,0.6364,0.79,0.1045,6,90,36,360,42,450
13774,2012-08-02,3,1,8,2,0,4,1,1,0.66,0.6061,0.83,0.0896,3,45,8,80,11,125
13775,2012-08-02,3,1,8,3,0,4,1,1,0.66,0.6061,0.83,0.0,0,0,6,60,6,60
13776,2012-08-02,3,1,8,4,0,4,1,1,0.66,0.6061,0.83,0.0,0,0,9,90,9,90
13777,2012-08-02,3,1,8,5,0,4,1,1,0.66,0.5909,0.89,0.1343,4,60,37,370,41,430
13778,2012-08-02,3,1,8,6,0,4,1,1,0.66,0.6061,0.83,0.0,6,90,177,1770,183,1860
13779,2012-08-02,3,1,8,7,0,4,1,1,0.7,0.6667,0.79,0.0,21,315,452,4520,473,4835
13780,2012-08-02,3,1,8,8,0,4,1,1,0.72,0.697,0.74,0.1045,21,315,718,7180,739,7495
13781,2012-08-02,3,1,8,9,0,4,1,1,0.76,0.7273,0.66,0.1045,31,465,312,3120,343,3585
13782,2012-08-02,3,1,8,10,0,4,1,1,0.8,0.7576,0.55,0.0,51,765,130,1300,181,2065
13783,2012-08-02,3,1,8,11,0,4,1,1,0.82,0.7727,0.52,0.1045,59,885,167,1670,226,2555
13784,2012-08-02,3,1,8,12,0,4,1,1,0.84,0.7576,0.44,0.1343,56,840,230,2300,286,3140
13785,2012-08-02,3,1,8,13,0,4,1,1,0.86,0.7879,0.44,0.2239,98,1470,212,2120,310,3590
13786,2012-08-02,3,1,8,14,0,4,1,1,0.86,0.7879,0.41,0.1343,54,810,171,1710,225,2520
13787,2012-08-02,3,1,8,15,0,4,1,1,0.78,0.7424,0.62,0.4627,68,1020,202,2020,270,3040
13788,2012-08-02,3,1,8,16,0,4,1,1,0.82,0.7576,0.46,0.194,71,1065,335,3350,406,4415
13789,2012-08-02,3,1,8,17,0,4,1,1,0.82,0.7727,0.52,0.2537,90,1350,775,7750,865,9100
13790,2012-08-02,3,1,8,18,0,4,1,1,0.8,0.7727,0.59,0.2239,86,1290,681,6810,767,8100
13791,2012-08-02,3,1,8,19,0,4,1,1,0.8,0.7879,0.63,0.1642,98,1470,509,5090,607,6560
13792,2012-08-02,3,1,8,20,0,4,1,1,0.78,0.7576,0.66,0.0,51,765,376,3760,427,4525
13793,2012-08-02,3,1,8,21,0,4,1,1,0.76,0.7273,0.66,0.2239,41,615,301,3010,342,3625
13794,2012-08-02,3,1,8,22,0,4,1,1,0.74,0.697,0.7,0.194,35,525,227,2270,262,2795
13795,2012-08-02,3,1,8,23,0,4,1,1,0.72,0.6818,0.7,0.2537,25,375,152,1520,177,1895
13796,2012-08-03,3,1,8,0,0,5,1,1,0.72,0.6818,0.7,0.194,15,225,56,560,71,785
13797,2012-08-03,3,1,8,1,0,5,1,1,0.7,0.6667,0.74,0.194,11,165,32,320,43,485
13798,2012-08-03,3,1,8,2,0,5,1,1,0.68,0.6364,0.79,0.2239,0,0,14,140,14,140
13799,2012-08-03,3,1,8,3,0,5,1,1,0.68,0.6364,0.79,0.2239,1,15,5,50,6,65
13800,2012-08-03,3,1,8,4,0,5,1,1,0.66,0.6061,0.83,0.2537,1,15,11,110,12,125
13801,2012-08-03,3,1,8,5,0,5,1,1,0.66,0.6061,0.83,0.1642,2,30,35,350,37,380
13802,2012-08-03,3,1,8,6,0,5,1,1,0.66,0.6061,0.83,0.2239,5,75,158,1580,163,1655
13803,2012-08-03,3,1,8,7,0,5,1,1,0.7,0.6667,0.74,0.1045,25,375,396,3960,421,4335
13804,2012-08-03,3,1,8,8,0,5,1,1,0.72,0.6818,0.7,0.1343,32,480,636,6360,668,6840
13805,2012-08-03,3,1,8,9,0,5,1,2,0.74,0.697,0.66,0.1045,69,1035,327,3270,396,4305
13806,2012-08-03,3,1,8,10,0,5,1,2,0.8,0.7424,0.52,0.194,82,1230,167,1670,249,2900
13807,2012-08-03,3,1,8,11,0,5,1,2,0.84,0.7879,0.49,0.2836,77,1155,186,1860,263,3015
13808,2012-08-03,3,1,8,12,0,5,1,2,0.86,0.8182,0.5,0.2985,95,1425,243,2430,338,3855
13809,2012-08-03,3,1,8,13,0,5,1,2,0.86,0.803,0.47,0.2836,98,1470,247,2470,345,3940
13810,2012-08-03,3,1,8,14,0,5,1,2,0.86,0.7879,0.44,0.2537,102,1530,229,2290,331,3820
13811,2012-08-03,3,1,8,15,0,5,1,1,0.88,0.8182,0.42,0.2537,112,1680,268,2680,380,4360
13812,2012-08-03,3,1,8,16,0,5,1,2,0.86,0.7879,0.41,0.2239,112,1680,380,3800,492,5480
13813,2012-08-03,3,1,8,17,0,5,1,2,0.84,0.803,0.53,0.2836,95,1425,646,6460,741,7885
13814,2012-08-03,3,1,8,18,0,5,1,2,0.82,0.803,0.59,0.2537,98,1470,573,5730,671,7200
13815,2012-08-03,3,1,8,19,0,5,1,2,0.8,0.7879,0.63,0.2239,81,1215,388,3880,469,5095
13816,2012-08-03,3,1,8,20,0,5,1,2,0.78,0.7576,0.66,0.2239,89,1335,300,3000,389,4335
13817,2012-08-03,3,1,8,21,0,5,1,2,0.76,0.7273,0.66,0.194,54,810,224,2240,278,3050
13818,2012-08-03,3,1,8,22,0,5,1,1,0.76,0.7273,0.7,0.2537,46,690,156,1560,202,2250
13819,2012-08-03,3,1,8,23,0,5,1,1,0.74,0.7121,0.79,0.1343,26,390,170,1700,196,2090
13820,2012-08-04,3,1,8,0,0,6,0,1,0.74,0.7121,0.79,0.1642,24,360,137,1370,161,1730
13821,2012-08-04,3,1,8,1,0,6,0,1,0.72,0.7121,0.84,0.194,23,345,99,990,122,1335
13822,2012-08-04,3,1,8,2,0,6,0,1,0.72,0.7121,0.84,0.1343,20,300,64,640,84,940
13823,2012-08-04,3,1,8,3,0,6,0,1,0.72,0.7121,0.84,0.1343,11,165,19,190,30,355
13824,2012-08-04,3,1,8,4,0,6,0,1,0.72,0.697,0.79,0.194,2,30,11,110,13,140
13825,2012-08-04,3,1,8,5,0,6,0,1,0.7,0.6667,0.84,0.2239,1,15,16,160,17,175
13826,2012-08-04,3,1,8,6,0,6,0,1,0.7,0.6667,0.84,0.2239,12,180,37,370,49,550
13827,2012-08-04,3,1,8,7,0,6,0,1,0.72,0.697,0.77,0.1642,18,270,49,490,67,760
13828,2012-08-04,3,1,8,8,0,6,0,1,0.74,0.7273,0.72,0.194,49,735,132,1320,181,2055
13829,2012-08-04,3,1,8,9,0,6,0,1,0.78,0.7576,0.65,0.2239,61,915,217,2170,278,3085
13830,2012-08-04,3,1,8,10,0,6,0,1,0.82,0.7727,0.57,0.194,108,1620,288,2880,396,4500
13831,2012-08-04,3,1,8,11,0,6,0,1,0.86,0.803,0.47,0.2537,155,2325,315,3150,470,5475
13832,2012-08-04,3,1,8,12,0,6,0,1,0.86,0.7879,0.4,0.3582,222,3330,325,3250,547,6580
13833,2012-08-04,3,1,8,13,0,6,0,1,0.88,0.8182,0.42,0.2985,195,2925,332,3320,527,6245
13834,2012-08-04,3,1,8,14,0,6,0,1,0.88,0.803,0.4,0.3881,183,2745,289,2890,472,5635
13835,2012-08-04,3,1,8,15,0,6,0,1,0.88,0.8182,0.42,0.4179,205,3075,284,2840,489,5915
13836,2012-08-04,3,1,8,16,0,6,0,1,0.9,0.8182,0.39,0.2985,197,2955,253,2530,450,5485
13837,2012-08-04,3,1,8,17,0,6,0,1,0.88,0.7879,0.37,0.2985,179,2685,313,3130,492,5815
13838,2012-08-04,3,1,8,18,0,6,0,1,0.86,0.7879,0.41,0.3284,169,2535,321,3210,490,5745
13839,2012-08-04,3,1,8,19,0,6,0,1,0.82,0.7727,0.52,0.3582,133,1995,264,2640,397,4635
13840,2012-08-04,3,1,8,20,0,6,0,1,0.82,0.7727,0.52,0.2985,117,1755,195,1950,312,3705
13841,2012-08-04,3,1,8,21,0,6,0,1,0.8,0.7727,0.59,0.2537,96,1440,193,1930,289,3370
13842,2012-08-04,3,1,8,22,0,6,0,1,0.76,0.7273,0.66,0.2836,104,1560,165,1650,269,3210
13843,2012-08-04,3,1,8,23,0,6,0,1,0.76,0.7273,0.66,0.2985,61,915,161,1610,222,2525
13844,2012-08-05,3,1,8,0,0,0,0,1,0.74,0.697,0.7,0.2836,32,480,121,1210,153,1690
13845,2012-08-05,3,1,8,1,0,0,0,1,0.74,0.697,0.7,0.2537,8,120,79,790,87,910
13846,2012-08-05,3,1,8,2,0,0,0,1,0.74,0.697,0.7,0.2985,5,75,68,680,73,755
13847,2012-08-05,3,1,8,3,0,0,0,1,0.72,0.697,0.74,0.2537,9,135,32,320,41,455
13848,2012-08-05,3,1,8,4,0,0,0,1,0.72,0.697,0.74,0.2537,3,45,11,110,14,155
13849,2012-08-05,3,1,8,5,0,0,0,1,0.72,0.697,0.74,0.2537,1,15,18,180,19,195
13850,2012-08-05,3,1,8,6,0,0,0,1,0.72,0.697,0.79,0.2537,7,105,12,120,19,225
13851,2012-08-05,3,1,8,7,0,0,0,1,0.74,0.7121,0.74,0.2985,18,270,50,500,68,770
13852,2012-08-05,3,1,8,8,0,0,0,1,0.76,0.7273,0.66,0.3284,27,405,81,810,108,1215
13853,2012-08-05,3,1,8,9,0,0,0,1,0.8,0.7727,0.59,0.3582,61,915,168,1680,229,2595
13854,2012-08-05,3,1,8,10,0,0,0,1,0.8,0.7727,0.59,0.4179,111,1665,253,2530,364,4195
13855,2012-08-05,3,1,8,11,0,0,0,1,0.82,0.7879,0.56,0.4179,155,2325,282,2820,437,5145
13856,2012-08-05,3,1,8,12,0,0,0,1,0.86,0.803,0.47,0.5224,161,2415,330,3300,491,5715
13857,2012-08-05,3,1,8,13,0,0,0,1,0.88,0.8182,0.44,0.4627,208,3120,315,3150,523,6270
13858,2012-08-05,3,1,8,14,0,0,0,1,0.9,0.8485,0.42,0.4627,161,2415,365,3650,526,6065
13859,2012-08-05,3,1,8,15,0,0,0,1,0.9,0.8182,0.37,0.5224,164,2460,286,2860,450,5320
13860,2012-08-05,3,1,8,16,0,0,0,1,0.82,0.7576,0.46,0.2537,143,2145,278,2780,421,4925
13861,2012-08-05,3,1,8,17,0,0,0,1,0.82,0.7576,0.46,0.2537,122,1830,260,2600,382,4430
13862,2012-08-05,3,1,8,18,0,0,0,3,0.7,0.6667,0.74,0.1343,75,1125,154,1540,229,2665
13863,2012-08-05,3,1,8,19,0,0,0,1,0.7,0.6667,0.84,0.2239,46,690,139,1390,185,2080
13864,2012-08-05,3,1,8,20,0,0,0,1,0.7,0.6667,0.84,0.1045,53,795,140,1400,193,2195
13865,2012-08-05,3,1,8,21,0,0,0,1,0.72,0.697,0.79,0.1045,51,765,157,1570,208,2335
13866,2012-08-05,3,1,8,22,0,0,0,1,0.72,0.697,0.79,0.0896,57,855,100,1000,157,1855
13867,2012-08-05,3,1,8,23,0,0,0,2,0.72,0.697,0.79,0.1642,29,435,58,580,87,1015
13868,2012-08-06,3,1,8,0,0,1,1,2,0.72,0.697,0.79,0.0,9,135,24,240,33,375
13869,2012-08-06,3,1,8,1,0,1,1,1,0.72,0.697,0.79,0.0896,1,15,10,100,11,115
13870,2012-08-06,3,1,8,2,0,1,1,2,0.72,0.697,0.79,0.1343,0,0,5,50,5,50
13871,2012-08-06,3,1,8,3,0,1,1,3,0.72,0.697,0.79,0.0896,0,0,5,50,5,50
13872,2012-08-06,3,1,8,4,0,1,1,2,0.72,0.697,0.74,0.1343,3,45,8,80,11,125
13873,2012-08-06,3,1,8,5,0,1,1,1,0.7,0.6667,0.79,0.194,2,30,23,230,25,260
13874,2012-08-06,3,1,8,6,0,1,1,2,0.7,0.6667,0.79,0.2239,4,60,137,1370,141,1430
13875,2012-08-06,3,1,8,7,0,1,1,3,0.72,0.6818,0.7,0.194,14,210,393,3930,407,4140
13876,2012-08-06,3,1,8,8,0,1,1,2,0.7,0.6667,0.79,0.0,27,405,578,5780,605,6185
13877,2012-08-06,3,1,8,9,0,1,1,3,0.7,0.6667,0.79,0.1642,28,420,248,2480,276,2900
13878,2012-08-06,3,1,8,10,0,1,1,1,0.74,0.697,0.7,0.2239,54,810,159,1590,213,2400
13879,2012-08-06,3,1,8,11,0,1,1,1,0.76,0.7273,0.66,0.1343,108,1620,152,1520,260,3140
13880,2012-08-06,3,1,8,12,0,1,1,2,0.78,0.7273,0.55,0.0896,72,1080,213,2130,285,3210
13881,2012-08-06,3,1,8,13,0,1,1,1,0.8,0.7424,0.49,0.2239,85,1275,204,2040,289,3315
13882,2012-08-06,3,1,8,14,0,1,1,1,0.82,0.7576,0.46,0.0,99,1485,188,1880,287,3365
13883,2012-08-06,3,1,8,15,0,1,1,1,0.82,0.7576,0.46,0.1343,91,1365,183,1830,274,3195
13884,2012-08-06,3,1,8,16,0,1,1,1,0.84,0.7576,0.41,0.1045,88,1320,363,3630,451,4950
13885,2012-08-06,3,1,8,17,0,1,1,1,0.82,0.7424,0.41,0.0,112,1680,746,7460,858,9140
13886,2012-08-06,3,1,8,18,0,1,1,1,0.82,0.7424,0.41,0.1343,100,1500,743,7430,843,8930
13887,2012-08-06,3,1,8,19,0,1,1,1,0.78,0.7424,0.59,0.194,109,1635,531,5310,640,6945
13888,2012-08-06,3,1,8,20,0,1,1,1,0.76,0.7273,0.66,0.1642,89,1335,368,3680,457,5015
13889,2012-08-06,3,1,8,21,0,1,1,1,0.74,0.697,0.7,0.194,72,1080,245,2450,317,3530
13890,2012-08-06,3,1,8,22,0,1,1,1,0.74,0.697,0.7,0.0896,50,750,157,1570,207,2320
13891,2012-08-06,3,1,8,23,0,1,1,1,0.72,0.697,0.74,0.194,16,240,97,970,113,1210
13892,2012-08-07,3,1,8,0,0,2,1,1,0.7,0.6667,0.84,0.194,15,225,32,320,47,545
13893,2012-08-07,3,1,8,1,0,2,1,1,0.7,0.6667,0.84,0.1343,2,30,16,160,18,190
13894,2012-08-07,3,1,8,2,0,2,1,1,0.7,0.6667,0.84,0.1343,6,90,7,70,13,160
13895,2012-08-07,3,1,8,3,0,2,1,1,0.7,0.6667,0.84,0.0,0,0,6,60,6,60
13896,2012-08-07,3,1,8,4,0,2,1,1,0.68,0.6364,0.83,0.1343,2,30,7,70,9,100
13897,2012-08-07,3,1,8,5,0,2,1,1,0.7,0.6667,0.79,0.1045,3,45,33,330,36,375
13898,2012-08-07,3,1,8,6,0,2,1,2,0.7,0.6667,0.79,0.194,3,45,176,1760,179,1805
13899,2012-08-07,3,1,8,7,0,2,1,2,0.7,0.6667,0.74,0.1343,21,315,481,4810,502,5125
13900,2012-08-07,3,1,8,8,0,2,1,2,0.7,0.6515,0.7,0.1642,41,615,664,6640,705,7255
13901,2012-08-07,3,1,8,9,0,2,1,2,0.7,0.6667,0.74,0.1343,44,660,283,2830,327,3490
13902,2012-08-07,3,1,8,10,0,2,1,2,0.74,0.697,0.7,0.1343,89,1335,161,1610,250,2945
13903,2012-08-07,3,1,8,11,0,2,1,2,0.76,0.7273,0.66,0.0896,84,1260,130,1300,214,2560
13904,2012-08-07,3,1,8,12,0,2,1,2,0.8,0.7576,0.55,0.1343,86,1290,197,1970,283,3260
13905,2012-08-07,3,1,8,13,0,2,1,2,0.8,0.7424,0.52,0.194,68,1020,185,1850,253,2870
13906,2012-08-07,3,1,8,14,0,2,1,2,0.82,0.7576,0.46,0.0,76,1140,185,1850,261,2990
13907,2012-08-07,3,1,8,15,0,2,1,1,0.8,0.7424,0.52,0.0,100,1500,206,2060,306,3560
13908,2012-08-07,3,1,8,16,0,2,1,3,0.76,0.7273,0.66,0.2836,101,1515,344,3440,445,4955
13909,2012-08-07,3,1,8,17,0,2,1,2,0.78,0.7424,0.62,0.1343,125,1875,743,7430,868,9305
13910,2012-08-07,3,1,8,18,0,2,1,2,0.76,0.7121,0.62,0.1642,103,1545,711,7110,814,8655
13911,2012-08-07,3,1,8,19,0,2,1,2,0.76,0.7273,0.66,0.1045,104,1560,506,5060,610,6620
13912,2012-08-07,3,1,8,20,0,2,1,2,0.74,0.697,0.7,0.1343,74,1110,374,3740,448,4850
13913,2012-08-07,3,1,8,21,0,2,1,2,0.72,0.697,0.74,0.0,70,1050,247,2470,317,3520
13914,2012-08-07,3,1,8,22,0,2,1,1,0.72,0.697,0.74,0.1045,43,645,181,1810,224,2455
13915,2012-08-07,3,1,8,23,0,2,1,1,0.72,0.697,0.79,0.0,18,270,120,1200,138,1470
13916,2012-08-08,3,1,8,0,0,3,1,1,0.7,0.6667,0.84,0.0,12,180,46,460,58,640
13917,2012-08-08,3,1,8,1,0,3,1,1,0.72,0.697,0.79,0.0,3,45,20,200,23,245
13918,2012-08-08,3,1,8,2,0,3,1,1,0.7,0.6667,0.84,0.0,1,15,5,50,6,65
13919,2012-08-08,3,1,8,3,0,3,1,1,0.7,0.6667,0.84,0.0,1,15,6,60,7,75
13920,2012-08-08,3,1,8,4,0,3,1,1,0.7,0.6667,0.84,0.0,1,15,6,60,7,75
13921,2012-08-08,3,1,8,5,0,3,1,2,0.68,0.6364,0.89,0.1642,3,45,40,400,43,445
13922,2012-08-08,3,1,8,6,0,3,1,2,0.7,0.6667,0.84,0.1642,4,60,169,1690,173,1750
13923,2012-08-08,3,1,8,7,0,3,1,2,0.7,0.6667,0.84,0.1642,24,360,458,4580,482,4940
13924,2012-08-08,3,1,8,8,0,3,1,2,0.74,0.7273,0.72,0.0896,48,720,689,6890,737,7610
13925,2012-08-08,3,1,8,9,0,3,1,2,0.76,0.7273,0.66,0.0,33,495,308,3080,341,3575
13926,2012-08-08,3,1,8,10,0,3,1,2,0.8,0.7424,0.52,0.1343,63,945,151,1510,214,2455
13927,2012-08-08,3,1,8,11,0,3,1,2,0.8,0.7424,0.52,0.0,80,1200,159,1590,239,2790
13928,2012-08-08,3,1,8,12,0,3,1,2,0.8,0.7424,0.52,0.0,63,945,217,2170,280,3115
13929,2012-08-08,3,1,8,13,0,3,1,2,0.8,0.7424,0.52,0.0,101,1515,212,2120,313,3635
13930,2012-08-08,3,1,8,14,0,3,1,2,0.8,0.7424,0.52,0.2537,63,945,173,1730,236,2675
13931,2012-08-08,3,1,8,15,0,3,1,2,0.84,0.7576,0.44,0.194,110,1650,168,1680,278,3330
13932,2012-08-08,3,1,8,16,0,3,1,2,0.8,0.7424,0.49,0.2836,113,1695,328,3280,441,4975
13933,2012-08-08,3,1,8,17,0,3,1,2,0.8,0.7576,0.55,0.2836,107,1605,751,7510,858,9115
13934,2012-08-08,3,1,8,18,0,3,1,2,0.78,0.7273,0.55,0.1642,117,1755,745,7450,862,9205
13935,2012-08-08,3,1,8,19,0,3,1,1,0.76,0.7273,0.66,0.2239,119,1785,567,5670,686,7455
13936,2012-08-08,3,1,8,20,0,3,1,1,0.74,0.697,0.66,0.194,76,1140,424,4240,500,5380
13937,2012-08-08,3,1,8,21,0,3,1,1,0.74,0.697,0.66,0.1045,70,1050,311,3110,381,4160
13938,2012-08-08,3,1,8,22,0,3,1,1,0.72,0.697,0.74,0.1045,35,525,198,1980,233,2505
13939,2012-08-08,3,1,8,23,0,3,1,1,0.72,0.6818,0.7,0.1343,16,240,120,1200,136,1440
13940,2012-08-09,3,1,8,0,0,4,1,1,0.72,0.697,0.74,0.194,16,240,51,510,67,750
13941,2012-08-09,3,1,8,1,0,4,1,1,0.7,0.6667,0.79,0.1343,5,75,23,230,28,305
13942,2012-08-09,3,1,8,2,0,4,1,1,0.7,0.6667,0.84,0.0896,2,30,12,120,14,150
13943,2012-08-09,3,1,8,3,0,4,1,1,0.68,0.6364,0.83,0.0896,1,15,5,50,6,65
13944,2012-08-09,3,1,8,4,0,4,1,2,0.68,0.6364,0.89,0.1343,0,0,10,100,10,100
13945,2012-08-09,3,1,8,5,0,4,1,2,0.66,0.5909,0.94,0.0,4,60,37,370,41,430
13946,2012-08-09,3,1,8,6,0,4,1,1,0.66,0.6061,0.83,0.1642,5,75,162,1620,167,1695
13947,2012-08-09,3,1,8,7,0,4,1,2,0.7,0.6667,0.84,0.1642,24,360,451,4510,475,4870
13948,2012-08-09,3,1,8,8,0,4,1,1,0.72,0.697,0.74,0.1045,28,420,670,6700,698,7120
13949,2012-08-09,3,1,8,9,0,4,1,1,0.76,0.7273,0.66,0.1642,54,810,299,2990,353,3800
13950,2012-08-09,3,1,8,10,0,4,1,1,0.8,0.7576,0.55,0.2239,72,1080,133,1330,205,2410
13951,2012-08-09,3,1,8,11,0,4,1,1,0.84,0.7576,0.44,0.0,94,1410,166,1660,260,3070
13952,2012-08-09,3,1,8,12,0,4,1,1,0.84,0.7576,0.44,0.1045,85,1275,192,1920,277,3195
13953,2012-08-09,3,1,8,13,0,4,1,1,0.86,0.7879,0.41,0.1045,80,1200,201,2010,281,3210
13954,2012-08-09,3,1,8,14,0,4,1,1,0.88,0.7727,0.32,0.2239,86,1290,161,1610,247,2900
13955,2012-08-09,3,1,8,15,0,4,1,1,0.88,0.7727,0.32,0.2239,63,945,204,2040,267,2985
13956,2012-08-09,3,1,8,16,0,4,1,1,0.86,0.7727,0.39,0.2537,97,1455,320,3200,417,4655
13957,2012-08-09,3,1,8,17,0,4,1,1,0.86,0.7576,0.36,0.2537,111,1665,699,6990,810,8655
13958,2012-08-09,3,1,8,18,0,4,1,2,0.82,0.7576,0.46,0.2537,78,1170,733,7330,811,8500
13959,2012-08-09,3,1,8,19,0,4,1,1,0.8,0.7576,0.55,0.194,90,1350,533,5330,623,6680
13960,2012-08-09,3,1,8,20,0,4,1,1,0.7,0.6515,0.54,0.2836,91,1365,387,3870,478,5235
13961,2012-08-09,3,1,8,21,0,4,1,2,0.7,0.6515,0.58,0.1642,50,750,286,2860,336,3610
13962,2012-08-09,3,1,8,22,0,4,1,2,0.66,0.6212,0.69,0.2239,41,615,218,2180,259,2795
13963,2012-08-09,3,1,8,23,0,4,1,1,0.66,0.6212,0.74,0.0,19,285,137,1370,156,1655
13964,2012-08-10,3,1,8,0,0,5,1,1,0.7,0.6515,0.65,0.0896,17,255,68,680,85,935
13965,2012-08-10,3,1,8,1,0,5,1,1,0.7,0.6515,0.65,0.1045,6,90,35,350,41,440
13966,2012-08-10,3,1,8,2,0,5,1,1,0.7,0.6667,0.74,0.1642,6,90,14,140,20,230
13967,2012-08-10,3,1,8,3,0,5,1,2,0.72,0.697,0.79,0.194,3,45,6,60,9,105
13968,2012-08-10,3,1,8,4,0,5,1,3,0.7,0.6667,0.84,0.2836,0,0,7,70,7,70
13969,2012-08-10,3,1,8,5,0,5,1,3,0.7,0.6667,0.84,0.2836,4,60,29,290,33,350
13970,2012-08-10,3,1,8,6,0,5,1,3,0.64,0.5758,0.89,0.2985,3,45,41,410,44,455
13971,2012-08-10,3,1,8,7,0,5,1,3,0.64,0.5758,0.89,0.1045,5,75,128,1280,133,1355
13972,2012-08-10,3,1,8,8,0,5,1,3,0.62,0.5455,0.91,0.1642,7,105,112,1120,119,1225
13973,2012-08-10,3,1,8,9,0,5,1,2,0.64,0.5758,0.89,0.0,21,315,199,1990,220,2305
13974,2012-08-10,3,1,8,10,0,5,1,1,0.66,0.5909,0.89,0.1045,27,405,166,1660,193,2065
13975,2012-08-10,3,1,8,11,0,5,1,3,0.68,0.6364,0.79,0.1343,73,1095,178,1780,251,2875
13976,2012-08-10,3,1,8,12,0,5,1,2,0.74,0.697,0.66,0.3582,75,1125,240,2400,315,3525
13977,2012-08-10,3,1,8,13,0,5,1,2,0.76,0.7121,0.58,0.3582,66,990,224,2240,290,3230
13978,2012-08-10,3,1,8,14,0,5,1,1,0.76,0.7121,0.58,0.3582,71,1065,236,2360,307,3425
13979,2012-08-10,3,1,8,15,0,5,1,1,0.8,0.7424,0.52,0.4478,100,1500,224,2240,324,3740
13980,2012-08-10,3,1,8,16,0,5,1,1,0.78,0.7273,0.55,0.2985,96,1440,371,3710,467,5150
13981,2012-08-10,3,1,8,17,0,5,1,1,0.8,0.7424,0.52,0.2836,111,1665,619,6190,730,7855
13982,2012-08-10,3,1,8,18,0,5,1,1,0.76,0.7121,0.62,0.2985,88,1320,552,5520,640,6840
13983,2012-08-10,3,1,8,19,0,5,1,1,0.76,0.7121,0.62,0.2836,98,1470,394,3940,492,5410
13984,2012-08-10,3,1,8,20,0,5,1,1,0.74,0.697,0.66,0.2985,55,825,315,3150,370,3975
13985,2012-08-10,3,1,8,21,0,5,1,1,0.74,0.697,0.66,0.2537,50,750,236,2360,286,3110
13986,2012-08-10,3,1,8,22,0,5,1,1,0.72,0.697,0.74,0.2836,50,750,168,1680,218,2430
13987,2012-08-10,3,1,8,23,0,5,1,1,0.72,0.6818,0.7,0.2836,33,495,159,1590,192,2085
13988,2012-08-11,3,1,8,0,0,6,0,1,0.7,0.6515,0.7,0.2836,38,570,142,1420,180,1990
13989,2012-08-11,3,1,8,1,0,6,0,1,0.66,0.6212,0.74,0.2239,32,480,84,840,116,1320
13990,2012-08-11,3,1,8,2,0,6,0,3,0.64,0.5909,0.78,0.194,19,285,66,660,85,945
13991,2012-08-11,3,1,8,3,0,6,0,3,0.62,0.5758,0.83,0.1642,2,30,19,190,21,220
13992,2012-08-11,3,1,8,4,0,6,0,1,0.62,0.5758,0.83,0.1045,3,45,7,70,10,115
13993,2012-08-11,3,1,8,5,0,6,0,1,0.62,0.5606,0.88,0.1045,2,30,9,90,11,120
13994,2012-08-11,3,1,8,6,0,6,0,2,0.62,0.5606,0.88,0.1045,5,75,18,180,23,255
13995,2012-08-11,3,1,8,7,0,6,0,1,0.64,0.5758,0.83,0.0896,8,120,54,540,62,660
13996,2012-08-11,3,1,8,8,0,6,0,1,0.66,0.6061,0.83,0.1045,30,450,132,1320,162,1770
13997,2012-08-11,3,1,8,9,0,6,0,1,0.68,0.6364,0.79,0.194,54,810,217,2170,271,2980
13998,2012-08-11,3,1,8,10,0,6,0,1,0.72,0.6818,0.62,0.0896,125,1875,282,2820,407,4695
13999,2012-08-11,3,1,8,11,0,6,0,1,0.74,0.697,0.66,0.1642,203,3045,296,2960,499,6005
14000,2012-08-11,3,1,8,12,0,6,0,1,0.76,0.7121,0.58,0.2239,214,3210,332,3320,546,6530
14001,2012-08-11,3,1,8,13,0,6,0,1,0.8,0.7424,0.49,0.3582,228,3420,341,3410,569,6830
14002,2012-08-11,3,1,8,14,0,6,0,1,0.8,0.7424,0.49,0.2985,248,3720,290,2900,538,6620
14003,2012-08-11,3,1,8,15,0,6,0,1,0.8,0.7273,0.46,0.2836,246,3690,316,3160,562,6850
14004,2012-08-11,3,1,8,16,0,6,0,1,0.8,0.7273,0.46,0.2985,227,3405,304,3040,531,6445
14005,2012-08-11,3,1,8,17,0,6,0,3,0.74,0.697,0.66,0.3582,220,3300,292,2920,512,6220
14006,2012-08-11,3,1,8,18,0,6,0,2,0.7,0.6667,0.74,0.2985,107,1605,193,1930,300,3535
14007,2012-08-11,3,1,8,19,0,6,0,2,0.66,0.5909,0.89,0.1045,97,1455,178,1780,275,3235
14008,2012-08-11,3,1,8,20,0,6,0,3,0.66,0.5909,0.89,0.4179,31,465,129,1290,160,1755
14009,2012-08-11,3,1,8,21,0,6,0,2,0.66,0.5909,0.89,0.1642,26,390,102,1020,128,1410
14010,2012-08-11,3,1,8,22,0,6,0,2,0.66,0.5909,0.89,0.1642,40,600,128,1280,168,1880
14011,2012-08-11,3,1,8,23,0,6,0,3,0.66,0.6061,0.78,0.1642,42,630,121,1210,163,1840
14012,2012-08-12,3,1,8,0,0,0,0,2,0.64,0.6061,0.73,0.1343,24,360,96,960,120,1320
14013,2012-08-12,3,1,8,1,0,0,0,1,0.62,0.5909,0.78,0.1343,21,315,92,920,113,1235
14014,2012-08-12,3,1,8,2,0,0,0,1,0.64,0.6061,0.69,0.1343,19,285,67,670,86,955
14015,2012-08-12,3,1,8,3,0,0,0,1,0.62,0.5909,0.73,0.0896,11,165,37,370,48,535
14016,2012-08-12,3,1,8,4,0,0,0,1,0.64,0.6061,0.69,0.0896,2,30,8,80,10,110
14017,2012-08-12,3,1,8,5,0,0,0,1,0.64,0.6212,0.61,0.194,1,15,9,90,10,105
14018,2012-08-12,3,1,8,6,0,0,0,1,0.64,0.6061,0.65,0.1642,2,30,14,140,16,170
14019,2012-08-12,3,1,8,7,0,0,0,1,0.64,0.6061,0.65,0.1343,9,135,30,300,39,435
14020,2012-08-12,3,1,8,8,0,0,0,1,0.66,0.6212,0.54,0.2239,35,525,84,840,119,1365
14021,2012-08-12,3,1,8,9,0,0,0,1,0.7,0.6515,0.48,0.2239,64,960,153,1530,217,2490
14022,2012-08-12,3,1,8,10,0,0,0,1,0.7,0.6515,0.51,0.1642,88,1320,240,2400,328,3720
14023,2012-08-12,3,1,8,11,0,0,0,1,0.74,0.6667,0.42,0.1642,167,2505,282,2820,449,5325
14024,2012-08-12,3,1,8,12,0,0,0,1,0.74,0.6667,0.42,0.194,163,2445,342,3420,505,5865
14025,2012-08-12,3,1,8,13,0,0,0,1,0.78,0.697,0.4,0.0,178,2670,365,3650,543,6320
14026,2012-08-12,3,1,8,14,0,0,0,1,0.76,0.6818,0.4,0.194,213,3195,366,3660,579,6855
14027,2012-08-12,3,1,8,15,0,0,0,1,0.76,0.6818,0.4,0.1343,235,3525,342,3420,577,6945
14028,2012-08-12,3,1,8,16,0,0,0,1,0.76,0.6818,0.4,0.1045,213,3195,300,3000,513,6195
14029,2012-08-12,3,1,8,17,0,0,0,1,0.8,0.697,0.33,0.0,186,2790,319,3190,505,5980
14030,2012-08-12,3,1,8,18,0,0,0,1,0.78,0.6818,0.35,0.1045,164,2460,327,3270,491,5730
14031,2012-08-12,3,1,8,19,0,0,0,1,0.74,0.6515,0.4,0.1343,148,2220,317,3170,465,5390
14032,2012-08-12,3,1,8,20,0,0,0,1,0.72,0.6515,0.45,0.0,96,1440,204,2040,300,3480
14033,2012-08-12,3,1,8,21,0,0,0,1,0.72,0.6667,0.51,0.0896,78,1170,142,1420,220,2590
14034,2012-08-12,3,1,8,22,0,0,0,1,0.7,0.6515,0.58,0.1343,40,600,141,1410,181,2010
14035,2012-08-12,3,1,8,23,0,0,0,1,0.68,0.6364,0.61,0.0,25,375,85,850,110,1225
14036,2012-08-13,3,1,8,0,0,1,1,1,0.66,0.6212,0.65,0.1045,14,210,33,330,47,540
14037,2012-08-13,3,1,8,1,0,1,1,1,0.66,0.6212,0.65,0.0896,3,45,11,110,14,155
14038,2012-08-13,3,1,8,2,0,1,1,1,0.64,0.6061,0.69,0.1045,1,15,8,80,9,95
14039,2012-08-13,3,1,8,3,0,1,1,1,0.64,0.6061,0.69,0.0,1,15,5,50,6,65
14040,2012-08-13,3,1,8,4,0,1,1,1,0.64,0.6061,0.69,0.1045,0,0,11,110,11,110
14041,2012-08-13,3,1,8,5,0,1,1,1,0.64,0.6061,0.69,0.1045,3,45,33,330,36,375
14042,2012-08-13,3,1,8,6,0,1,1,1,0.62,0.5909,0.73,0.0896,4,60,155,1550,159,1610
14043,2012-08-13,3,1,8,7,0,1,1,1,0.66,0.6212,0.65,0.1343,11,165,425,4250,436,4415
14044,2012-08-13,3,1,8,8,0,1,1,2,0.72,0.6667,0.51,0.0896,25,375,648,6480,673,6855
14045,2012-08-13,3,1,8,9,0,1,1,2,0.74,0.6667,0.45,0.0,40,600,265,2650,305,3250
14046,2012-08-13,3,1,8,10,0,1,1,2,0.76,0.6818,0.4,0.0,88,1320,111,1110,199,2430
14047,2012-08-13,3,1,8,11,0,1,1,1,0.76,0.6818,0.4,0.0896,94,1410,151,1510,245,2920
14048,2012-08-13,3,1,8,12,0,1,1,1,0.78,0.697,0.4,0.194,96,1440,180,1800,276,3240
14049,2012-08-13,3,1,8,13,0,1,1,1,0.78,0.697,0.4,0.1642,79,1185,175,1750,254,2935
14050,2012-08-13,3,1,8,14,0,1,1,1,0.8,0.697,0.33,0.1045,85,1275,163,1630,248,2905
14051,2012-08-13,3,1,8,15,0,1,1,1,0.82,0.7273,0.34,0.2239,80,1200,194,1940,274,3140
14052,2012-08-13,3,1,8,16,0,1,1,1,0.8,0.7121,0.36,0.0896,116,1740,348,3480,464,5220
14053,2012-08-13,3,1,8,17,0,1,1,1,0.8,0.7121,0.36,0.1642,102,1530,716,7160,818,8690
14054,2012-08-13,3,1,8,18,0,1,1,1,0.76,0.697,0.52,0.2836,103,1545,709,7090,812,8635
14055,2012-08-13,3,1,8,19,0,1,1,1,0.74,0.6818,0.58,0.1642,88,1320,467,4670,555,5990
14056,2012-08-13,3,1,8,20,0,1,1,1,0.74,0.6818,0.62,0.2239,58,870,374,3740,432,4610
14057,2012-08-13,3,1,8,21,0,1,1,1,0.72,0.6818,0.66,0.194,44,660,246,2460,290,3120
14058,2012-08-13,3,1,8,22,0,1,1,1,0.72,0.6818,0.62,0.3284,44,660,148,1480,192,2140
14059,2012-08-13,3,1,8,23,0,1,1,1,0.7,0.6515,0.7,0.2239,28,420,100,1000,128,1420
14060,2012-08-14,3,1,8,0,0,2,1,1,0.7,0.6667,0.74,0.2239,12,180,48,480,60,660
14061,2012-08-14,3,1,8,1,0,2,1,1,0.68,0.6364,0.79,0.2537,8,120,19,190,27,310
14062,2012-08-14,3,1,8,2,0,2,1,2,0.68,0.6364,0.83,0.194,2,30,9,90,11,120
14063,2012-08-14,3,1,8,3,0,2,1,2,0.68,0.6364,0.83,0.194,0,0,3,30,3,30
14064,2012-08-14,3,1,8,4,0,2,1,2,0.68,0.6364,0.83,0.194,0,0,5,50,5,50
14065,2012-08-14,3,1,8,5,0,2,1,2,0.68,0.6364,0.89,0.194,1,15,35,350,36,365
14066,2012-08-14,3,1,8,6,0,2,1,3,0.64,0.5758,0.83,0.194,1,15,63,630,64,645
14067,2012-08-14,3,1,8,7,0,2,1,2,0.66,0.6061,0.83,0.0896,1,15,178,1780,179,1795
14068,2012-08-14,3,1,8,8,0,2,1,2,0.66,0.5909,0.89,0.0896,27,405,591,5910,618,6315
14069,2012-08-14,3,1,8,9,0,2,1,2,0.7,0.6667,0.74,0.0,48,720,354,3540,402,4260
14070,2012-08-14,3,1,8,10,0,2,1,1,0.7,0.6667,0.79,0.1045,53,795,155,1550,208,2345
14071,2012-08-14,3,1,8,11,0,2,1,1,0.74,0.6818,0.62,0.0,69,1035,127,1270,196,2305
14072,2012-08-14,3,1,8,12,0,2,1,1,0.78,0.7121,0.49,0.1343,93,1395,207,2070,300,3465
14073,2012-08-14,3,1,8,13,0,2,1,1,0.8,0.7273,0.46,0.0896,83,1245,203,2030,286,3275
14074,2012-08-14,3,1,8,14,0,2,1,1,0.82,0.7424,0.41,0.2239,80,1200,175,1750,255,2950
14075,2012-08-14,3,1,8,15,0,2,1,1,0.82,0.7576,0.46,0.2239,84,1260,199,1990,283,3250
14076,2012-08-14,3,1,8,16,0,2,1,1,0.82,0.7424,0.43,0.2239,95,1425,363,3630,458,5055
14077,2012-08-14,3,1,8,17,0,2,1,3,0.76,0.7273,0.66,0.2537,78,1170,734,7340,812,8510
14078,2012-08-14,3,1,8,18,0,2,1,1,0.76,0.7121,0.62,0.2836,97,1455,757,7570,854,9025
14079,2012-08-14,3,1,8,19,0,2,1,1,0.76,0.7273,0.66,0.194,94,1410,533,5330,627,6740
14080,2012-08-14,3,1,8,20,0,2,1,1,0.74,0.7121,0.74,0.2239,65,975,371,3710,436,4685
14081,2012-08-14,3,1,8,21,0,2,1,1,0.74,0.6818,0.62,0.2239,56,840,252,2520,308,3360
14082,2012-08-14,3,1,8,22,0,2,1,1,0.72,0.6818,0.66,0.0896,28,420,161,1610,189,2030
14083,2012-08-14,3,1,8,23,0,2,1,1,0.72,0.6818,0.66,0.1642,53,795,114,1140,167,1935
14084,2012-08-15,3,1,8,0,0,3,1,1,0.7,0.6515,0.61,0.194,8,120,52,520,60,640
14085,2012-08-15,3,1,8,1,0,3,1,1,0.7,0.6515,0.61,0.0,6,90,31,310,37,400
14086,2012-08-15,3,1,8,2,0,3,1,1,0.68,0.6364,0.65,0.0,1,15,7,70,8,85
14087,2012-08-15,3,1,8,3,0,3,1,1,0.66,0.6212,0.74,0.1045,1,15,10,100,11,115
14088,2012-08-15,3,1,8,4,0,3,1,1,0.64,0.5758,0.83,0.1045,0,0,4,40,4,40
14089,2012-08-15,3,1,8,5,0,3,1,1,0.64,0.5909,0.78,0.1045,4,60,35,350,39,410
14090,2012-08-15,3,1,8,6,0,3,1,1,0.64,0.5909,0.78,0.1045,12,180,160,1600,172,1780
14091,2012-08-15,3,1,8,7,0,3,1,2,0.66,0.6212,0.69,0.194,25,375,467,4670,492,5045
14092,2012-08-15,3,1,8,8,0,3,1,2,0.7,0.6515,0.65,0.2836,40,600,642,6420,682,7020
14093,2012-08-15,3,1,8,9,0,3,1,2,0.72,0.6818,0.62,0.194,57,855,310,3100,367,3955
14094,2012-08-15,3,1,8,10,0,3,1,2,0.72,0.6818,0.62,0.194,70,1050,163,1630,233,2680
14095,2012-08-15,3,1,8,11,0,3,1,2,0.74,0.6818,0.58,0.194,80,1200,155,1550,235,2750
14096,2012-08-15,3,1,8,12,0,3,1,1,0.74,0.6818,0.55,0.2239,77,1155,230,2300,307,3455
14097,2012-08-15,3,1,8,13,0,3,1,2,0.78,0.7121,0.49,0.194,88,1320,206,2060,294,3380
14098,2012-08-15,3,1,8,14,0,3,1,2,0.76,0.697,0.52,0.2985,94,1410,161,1610,255,3020
14099,2012-08-15,3,1,8,15,0,3,1,1,0.76,0.697,0.52,0.2537,70,1050,196,1960,266,3010
14100,2012-08-15,3,1,8,16,0,3,1,1,0.76,0.6818,0.48,0.194,91,1365,340,3400,431,4765
14101,2012-08-15,3,1,8,17,0,3,1,1,0.74,0.6818,0.55,0.2836,102,1530,749,7490,851,9020
14102,2012-08-15,3,1,8,18,0,3,1,1,0.74,0.6667,0.51,0.2239,80,1200,768,7680,848,8880
14103,2012-08-15,3,1,8,19,0,3,1,1,0.7,0.6515,0.61,0.1343,124,1860,525,5250,649,7110
14104,2012-08-15,3,1,8,20,0,3,1,1,0.7,0.6515,0.61,0.1343,72,1080,355,3550,427,4630
14105,2012-08-15,3,1,8,21,0,3,1,1,0.7,0.6515,0.61,0.194,49,735,266,2660,315,3395
14106,2012-08-15,3,1,8,22,0,3,1,1,0.7,0.6515,0.61,0.1642,29,435,197,1970,226,2405
14107,2012-08-15,3,1,8,23,0,3,1,1,0.68,0.6364,0.65,0.1045,18,270,120,1200,138,1470
14108,2012-08-16,3,1,8,0,0,4,1,1,0.66,0.6212,0.69,0.0,13,195,63,630,76,825
14109,2012-08-16,3,1,8,1,0,4,1,1,0.64,0.6061,0.73,0.0,3,45,18,180,21,225
14110,2012-08-16,3,1,8,2,0,4,1,1,0.64,0.6061,0.69,0.194,0,0,15,150,15,150
14111,2012-08-16,3,1,8,3,0,4,1,1,0.62,0.5909,0.73,0.2537,0,0,4,40,4,40
14112,2012-08-16,3,1,8,4,0,4,1,1,0.62,0.5909,0.73,0.2239,2,30,3,30,5,60
14113,2012-08-16,3,1,8,5,0,4,1,1,0.6,0.5758,0.78,0.1642,7,105,30,300,37,405
14114,2012-08-16,3,1,8,6,0,4,1,1,0.6,0.5758,0.78,0.1642,3,45,162,1620,165,1665
14115,2012-08-16,3,1,8,7,0,4,1,1,0.64,0.6061,0.69,0.2239,16,240,448,4480,464,4720
14116,2012-08-16,3,1,8,8,0,4,1,1,0.68,0.6364,0.61,0.194,33,495,649,6490,682,6985
14117,2012-08-16,3,1,8,9,0,4,1,1,0.72,0.6667,0.54,0.1045,41,615,296,2960,337,3575
14118,2012-08-16,3,1,8,10,0,4,1,1,0.74,0.6667,0.48,0.1343,78,1170,121,1210,199,2380
14119,2012-08-16,3,1,8,11,0,4,1,1,0.76,0.6667,0.37,0.0896,83,1245,191,1910,274,3155
14120,2012-08-16,3,1,8,12,0,4,1,1,0.8,0.697,0.33,0.1045,96,1440,247,2470,343,3910
14121,2012-08-16,3,1,8,13,0,4,1,1,0.8,0.697,0.31,0.2239,81,1215,219,2190,300,3405
14122,2012-08-16,3,1,8,14,0,4,1,1,0.82,0.7121,0.32,0.0,72,1080,176,1760,248,2840
14123,2012-08-16,3,1,8,15,0,4,1,1,0.8,0.697,0.33,0.2537,63,945,197,1970,260,2915
14124,2012-08-16,3,1,8,16,0,4,1,1,0.82,0.7121,0.32,0.2239,79,1185,340,3400,419,4585
14125,2012-08-16,3,1,8,17,0,4,1,1,0.82,0.7273,0.34,0.194,130,1950,767,7670,897,9620
14126,2012-08-16,3,1,8,18,0,4,1,1,0.8,0.7121,0.36,0.0,109,1635,723,7230,832,8865
14127,2012-08-16,3,1,8,19,0,4,1,1,0.76,0.6818,0.4,0.1045,119,1785,558,5580,677,7365
14128,2012-08-16,3,1,8,20,0,4,1,1,0.76,0.6818,0.4,0.0896,100,1500,414,4140,514,5640
14129,2012-08-16,3,1,8,21,0,4,1,1,0.74,0.6667,0.48,0.194,83,1245,273,2730,356,3975
14130,2012-08-16,3,1,8,22,0,4,1,1,0.72,0.6667,0.51,0.1642,69,1035,185,1850,254,2885
14131,2012-08-16,3,1,8,23,0,4,1,1,0.7,0.6515,0.54,0.1045,58,870,168,1680,226,2550
14132,2012-08-17,3,1,8,0,0,5,1,1,0.68,0.2424,0.57,0.1642,21,315,67,670,88,985
14133,2012-08-17,3,1,8,1,0,5,1,1,0.66,0.2424,0.65,0.1045,16,240,38,380,54,620
14134,2012-08-17,3,1,8,2,0,5,1,1,0.66,0.2424,0.61,0.1343,4,60,15,150,19,210
14135,2012-08-17,3,1,8,3,0,5,1,1,0.64,0.2424,0.65,0.1045,0,0,6,60,6,60
14136,2012-08-17,3,1,8,4,0,5,1,1,0.64,0.2424,0.73,0.1642,0,0,9,90,9,90
14137,2012-08-17,3,1,8,5,0,5,1,1,0.64,0.2424,0.73,0.1045,2,30,34,340,36,370
14138,2012-08-17,3,1,8,6,0,5,1,1,0.62,0.2424,0.78,0.1343,6,90,151,1510,157,1600
14139,2012-08-17,3,1,8,7,0,5,1,1,0.64,0.2424,0.73,0.1045,11,165,368,3680,379,3845
14140,2012-08-17,3,1,8,8,0,5,1,1,0.68,0.2424,0.65,0.1343,43,645,625,6250,668,6895
14141,2012-08-17,3,1,8,9,0,5,1,1,0.7,0.2424,0.58,0.1045,58,870,320,3200,378,4070
14142,2012-08-17,3,1,8,10,0,5,1,1,0.74,0.2424,0.55,0.1642,82,1230,149,1490,231,2720
14143,2012-08-17,3,1,8,11,0,5,1,1,0.76,0.2424,0.52,0.2836,98,1470,205,2050,303,3520
14144,2012-08-17,3,1,8,12,0,5,1,1,0.82,0.2424,0.41,0.2239,110,1650,255,2550,365,4200
14145,2012-08-17,3,1,8,13,0,5,1,1,0.84,0.2424,0.36,0.3881,103,1545,254,2540,357,4085
14146,2012-08-17,3,1,8,14,0,5,1,1,0.86,0.2424,0.34,0.4179,128,1920,200,2000,328,3920
14147,2012-08-17,3,1,8,15,0,5,1,1,0.86,0.2424,0.3,0.4627,127,1905,256,2560,383,4465
14148,2012-08-17,3,1,8,16,0,5,1,2,0.84,0.2424,0.32,0.4478,116,1740,372,3720,488,5460
14149,2012-08-17,3,1,8,17,0,5,1,1,0.82,0.2424,0.36,0.3284,144,2160,647,6470,791,8630
14150,2012-08-17,3,1,8,18,0,5,1,2,0.82,0.2424,0.38,0.2537,108,1620,561,5610,669,7230
14151,2012-08-17,3,1,8,19,0,5,1,2,0.74,0.2424,0.55,0.3881,88,1320,403,4030,491,5350
14152,2012-08-17,3,1,8,20,0,5,1,2,0.72,0.2424,0.58,0.2239,97,1455,262,2620,359,4075
14153,2012-08-17,3,1,8,21,0,5,1,2,0.68,0.2424,0.69,0.2985,57,855,198,1980,255,2835
14154,2012-08-17,3,1,8,22,0,5,1,3,0.66,0.2424,0.83,0.194,43,645,170,1700,213,2345
14155,2012-08-17,3,1,8,23,0,5,1,3,0.64,0.2424,0.83,0.2239,21,315,100,1000,121,1315
14156,2012-08-18,3,1,8,0,0,6,0,2,0.64,0.5758,0.83,0.2239,6,90,99,990,105,1080
14157,2012-08-18,3,1,8,1,0,6,0,3,0.62,0.5455,0.94,0.1642,14,210,78,780,92,990
14158,2012-08-18,3,1,8,2,0,6,0,3,0.62,0.5606,0.88,0.1642,4,60,39,390,43,450
14159,2012-08-18,3,1,8,3,0,6,0,1,0.62,0.5606,0.88,0.194,7,105,23,230,30,335
14160,2012-08-18,3,1,8,4,0,6,0,1,0.62,0.5909,0.73,0.2239,5,75,8,80,13,155
14161,2012-08-18,3,1,8,5,0,6,0,1,0.6,0.5758,0.78,0.2537,2,30,7,70,9,100
14162,2012-08-18,3,1,8,6,0,6,0,1,0.6,0.5606,0.83,0.2239,4,60,23,230,27,290
14163,2012-08-18,3,1,8,7,0,6,0,1,0.6,0.5606,0.83,0.2239,12,180,52,520,64,700
14164,2012-08-18,3,1,8,8,0,6,0,1,0.64,0.6061,0.69,0.2537,28,420,161,1610,189,2030
14165,2012-08-18,3,1,8,9,0,6,0,1,0.66,0.6212,0.65,0.2836,81,1215,211,2110,292,3325
14166,2012-08-18,3,1,8,10,0,6,0,1,0.7,0.6515,0.54,0.1642,166,2490,314,3140,480,5630
14167,2012-08-18,3,1,8,11,0,6,0,1,0.72,0.6667,0.51,0.0,180,2700,356,3560,536,6260
14168,2012-08-18,3,1,8,12,0,6,0,1,0.76,0.6667,0.37,0.194,266,3990,388,3880,654,7870
14169,2012-08-18,3,1,8,13,0,6,0,1,0.74,0.6515,0.4,0.194,289,4335,355,3550,644,7885
14170,2012-08-18,3,1,8,14,0,6,0,1,0.76,0.6667,0.37,0.2836,242,3630,356,3560,598,7190
14171,2012-08-18,3,1,8,15,0,6,0,1,0.76,0.6667,0.37,0.2239,250,3750,346,3460,596,7210
14172,2012-08-18,3,1,8,16,0,6,0,1,0.76,0.6667,0.37,0.2537,287,4305,354,3540,641,7845
14173,2012-08-18,3,1,8,17,0,6,0,1,0.76,0.6667,0.37,0.2239,256,3840,379,3790,635,7630
14174,2012-08-18,3,1,8,18,0,6,0,1,0.74,0.6515,0.37,0.1642,225,3375,329,3290,554,6665
14175,2012-08-18,3,1,8,19,0,6,0,1,0.7,0.6364,0.45,0.1642,164,2460,324,3240,488,5700
14176,2012-08-18,3,1,8,20,0,6,0,1,0.7,0.6364,0.45,0.1045,99,1485,242,2420,341,3905
14177,2012-08-18,3,1,8,21,0,6,0,1,0.66,0.6212,0.61,0.0,90,1350,248,2480,338,3830
14178,2012-08-18,3,1,8,22,0,6,0,1,0.66,0.6212,0.61,0.0,90,1350,171,1710,261,3060
14179,2012-08-18,3,1,8,23,0,6,0,1,0.64,0.6061,0.65,0.0896,60,900,175,1750,235,2650
14180,2012-08-19,3,1,8,0,0,0,0,1,0.66,0.6212,0.57,0.0896,44,660,143,1430,187,2090
14181,2012-08-19,3,1,8,1,0,0,0,1,0.64,0.6061,0.65,0.0,29,435,102,1020,131,1455
14182,2012-08-19,3,1,8,2,0,0,0,2,0.62,0.6061,0.69,0.0896,16,240,103,1030,119,1270
14183,2012-08-19,3,1,8,3,0,0,0,2,0.62,0.6061,0.61,0.1642,21,315,34,340,55,655
14184,2012-08-19,3,1,8,4,0,0,0,2,0.62,0.6061,0.65,0.1642,4,60,22,220,26,280
14185,2012-08-19,3,1,8,5,0,0,0,2,0.6,0.5909,0.73,0.1343,3,45,8,80,11,125
14186,2012-08-19,3,1,8,6,0,0,0,2,0.62,0.6061,0.69,0.1045,5,75,15,150,20,225
14187,2012-08-19,3,1,8,7,0,0,0,2,0.62,0.6061,0.69,0.1343,12,180,29,290,41,470
14188,2012-08-19,3,1,8,8,0,0,0,2,0.64,0.6061,0.69,0.1045,34,510,90,900,124,1410
14189,2012-08-19,3,1,8,9,0,0,0,2,0.66,0.6212,0.74,0.0,86,1290,184,1840,270,3130
14190,2012-08-19,3,1,8,10,0,0,0,2,0.68,0.6364,0.69,0.0,138,2070,287,2870,425,4940
14191,2012-08-19,3,1,8,11,0,0,0,3,0.64,0.5909,0.78,0.1642,83,1245,189,1890,272,3135
14192,2012-08-19,3,1,8,12,0,0,0,3,0.64,0.6061,0.73,0.0,112,1680,186,1860,298,3540
14193,2012-08-19,3,1,8,13,0,0,0,3,0.64,0.5758,0.83,0.1343,50,750,112,1120,162,1870
14194,2012-08-19,3,1,8,14,0,0,0,3,0.64,0.6061,0.73,0.0,41,615,108,1080,149,1695
14195,2012-08-19,3,1,8,15,0,0,0,2,0.64,0.6061,0.65,0.0,89,1335,187,1870,276,3205
14196,2012-08-19,3,1,8,16,0,0,0,2,0.66,0.6212,0.65,0.0,97,1455,259,2590,356,4045
14197,2012-08-19,3,1,8,17,0,0,0,2,0.64,0.5909,0.78,0.1045,76,1140,267,2670,343,3810
14198,2012-08-19,3,1,8,18,0,0,0,2,0.64,0.5909,0.78,0.1045,86,1290,291,2910,377,4200
14199,2012-08-19,3,1,8,19,0,0,0,2,0.64,0.6061,0.73,0.1343,72,1080,269,2690,341,3770
14200,2012-08-19,3,1,8,20,0,0,0,2,0.64,0.6061,0.73,0.194,61,915,213,2130,274,3045
14201,2012-08-19,3,1,8,21,0,0,0,3,0.62,0.5909,0.78,0.0896,36,540,154,1540,190,2080
14202,2012-08-19,3,1,8,22,0,0,0,2,0.62,0.5909,0.78,0.1642,6,90,50,500,56,590
14203,2012-08-19,3,1,8,23,0,0,0,2,0.62,0.5909,0.73,0.0,7,105,39,390,46,495
14204,2012-08-20,3,1,8,0,0,1,1,2,0.6,0.5606,0.83,0.1045,1,15,25,250,26,265
14205,2012-08-20,3,1,8,1,0,1,1,1,0.6,0.5606,0.83,0.1642,0,0,10,100,10,100
14206,2012-08-20,3,1,8,2,0,1,1,1,0.6,0.5606,0.83,0.1642,0,0,5,50,5,50
14207,2012-08-20,3,1,8,3,0,1,1,1,0.6,0.5455,0.88,0.1045,0,0,3,30,3,30
14208,2012-08-20,3,1,8,4,0,1,1,2,0.6,0.5606,0.83,0.0896,0,0,7,70,7,70
14209,2012-08-20,3,1,8,5,0,1,1,2,0.6,0.5606,0.83,0.0,2,30,35,350,37,380
14210,2012-08-20,3,1,8,6,0,1,1,2,0.6,0.5758,0.78,0.1343,6,90,155,1550,161,1640
14211,2012-08-20,3,1,8,7,0,1,1,2,0.62,0.5909,0.78,0.1343,15,225,427,4270,442,4495
14212,2012-08-20,3,1,8,8,0,1,1,2,0.62,0.5909,0.73,0.1045,37,555,618,6180,655,6735
14213,2012-08-20,3,1,8,9,0,1,1,2,0.64,0.6061,0.69,0.0,55,825,302,3020,357,3845
14214,2012-08-20,3,1,8,10,0,1,1,2,0.64,0.6061,0.69,0.0896,69,1035,124,1240,193,2275
14215,2012-08-20,3,1,8,11,0,1,1,1,0.66,0.6212,0.65,0.1045,90,1350,151,1510,241,2860
14216,2012-08-20,3,1,8,12,0,1,1,2,0.66,0.6212,0.61,0.1045,66,990,216,2160,282,3150
14217,2012-08-20,3,1,8,13,0,1,1,1,0.7,0.6515,0.58,0.1343,97,1455,194,1940,291,3395
14218,2012-08-20,3,1,8,14,0,1,1,1,0.72,0.6667,0.54,0.1642,87,1305,188,1880,275,3185
14219,2012-08-20,3,1,8,15,0,1,1,1,0.72,0.6667,0.54,0.2537,102,1530,207,2070,309,3600
14220,2012-08-20,3,1,8,16,0,1,1,1,0.72,0.6667,0.54,0.2537,103,1545,357,3570,460,5115
14221,2012-08-20,3,1,8,17,0,1,1,1,0.7,0.6515,0.58,0.2836,83,1245,810,8100,893,9345
14222,2012-08-20,3,1,8,18,0,1,1,2,0.62,0.5909,0.78,0.2537,89,1335,726,7260,815,8595
14223,2012-08-20,3,1,8,19,0,1,1,2,0.62,0.5909,0.78,0.194,33,495,266,2660,299,3155
14224,2012-08-20,3,1,8,20,0,1,1,2,0.62,0.5758,0.83,0.2836,30,450,231,2310,261,2760
14225,2012-08-20,3,1,8,21,0,1,1,1,0.6,0.5606,0.83,0.0,26,390,219,2190,245,2580
14226,2012-08-20,3,1,8,22,0,1,1,2,0.6,0.5606,0.83,0.0,25,375,136,1360,161,1735
14227,2012-08-20,3,1,8,23,0,1,1,2,0.6,0.5606,0.83,0.0,10,150,92,920,102,1070
14228,2012-08-21,3,1,8,0,0,2,1,2,0.6,0.5606,0.83,0.0896,7,105,52,520,59,625
14229,2012-08-21,3,1,8,1,0,2,1,2,0.6,0.5606,0.83,0.1343,11,165,22,220,33,385
14230,2012-08-21,3,1,8,2,0,2,1,2,0.58,0.5455,0.88,0.2836,1,15,7,70,8,85
14231,2012-08-21,3,1,8,3,0,2,1,1,0.56,0.5303,0.88,0.0,0,0,3,30,3,30
14232,2012-08-21,3,1,8,4,0,2,1,1,0.56,0.5303,0.88,0.0,0,0,4,40,4,40
14233,2012-08-21,3,1,8,5,0,2,1,1,0.56,0.5303,0.83,0.0896,4,60,30,300,34,360
14234,2012-08-21,3,1,8,6,0,2,1,1,0.56,0.5303,0.83,0.1045,5,75,164,1640,169,1715
14235,2012-08-21,3,1,8,7,0,2,1,1,0.6,0.5758,0.78,0.1045,19,285,500,5000,519,5285
14236,2012-08-21,3,1,8,8,0,2,1,1,0.6,0.5758,0.78,0.1343,27,405,696,6960,723,7365
14237,2012-08-21,3,1,8,9,0,2,1,1,0.64,0.6061,0.69,0.0,47,705,281,2810,328,3515
14238,2012-08-21,3,1,8,10,0,2,1,1,0.66,0.6212,0.61,0.1045,58,870,120,1200,178,2070
14239,2012-08-21,3,1,8,11,0,2,1,1,0.7,0.6515,0.54,0.0,61,915,195,1950,256,2865
14240,2012-08-21,3,1,8,12,0,2,1,1,0.72,0.6515,0.45,0.0,79,1185,226,2260,305,3445
14241,2012-08-21,3,1,8,13,0,2,1,1,0.74,0.6515,0.4,0.0,76,1140,255,2550,331,3690
14242,2012-08-21,3,1,8,14,0,2,1,1,0.76,0.6667,0.37,0.0896,110,1650,192,1920,302,3570
14243,2012-08-21,3,1,8,15,0,2,1,1,0.76,0.6667,0.37,0.0,76,1140,226,2260,302,3400
14244,2012-08-21,3,1,8,16,0,2,1,1,0.76,0.6667,0.37,0.0,109,1635,358,3580,467,5215
14245,2012-08-21,3,1,8,17,0,2,1,1,0.74,0.6667,0.51,0.2836,92,1380,786,7860,878,9240
14246,2012-08-21,3,1,8,18,0,2,1,1,0.72,0.6667,0.54,0.2239,93,1395,532,5320,625,6715
14247,2012-08-21,3,1,8,19,0,2,1,3,0.62,0.5909,0.73,0.1045,56,840,420,4200,476,5040
14248,2012-08-21,3,1,8,20,0,2,1,1,0.64,0.6061,0.73,0.0,62,930,296,2960,358,3890
14249,2012-08-21,3,1,8,21,0,2,1,1,0.64,0.6061,0.73,0.0,41,615,239,2390,280,3005
14250,2012-08-21,3,1,8,22,0,2,1,1,0.64,0.5909,0.78,0.0,24,360,208,2080,232,2440
14251,2012-08-21,3,1,8,23,0,2,1,1,0.62,0.5758,0.83,0.0,23,345,113,1130,136,1475
14252,2012-08-22,3,1,8,0,0,3,1,1,0.62,0.5758,0.83,0.1045,9,135,46,460,55,595
14253,2012-08-22,3,1,8,1,0,3,1,1,0.62,0.5909,0.78,0.0,1,15,20,200,21,215
14254,2012-08-22,3,1,8,2,0,3,1,1,0.62,0.5909,0.78,0.0,7,105,10,100,17,205
14255,2012-08-22,3,1,8,3,0,3,1,1,0.62,0.5909,0.78,0.0,0,0,7,70,7,70
14256,2012-08-22,3,1,8,4,0,3,1,1,0.58,0.5455,0.83,0.1045,1,15,7,70,8,85
14257,2012-08-22,3,1,8,5,0,3,1,1,0.6,0.5758,0.78,0.0,2,30,38,380,40,410
14258,2012-08-22,3,1,8,6,0,3,1,1,0.62,0.5909,0.73,0.0,12,180,175,1750,187,1930
14259,2012-08-22,3,1,8,7,0,3,1,1,0.62,0.5909,0.78,0.0,16,240,537,5370,553,5610
14260,2012-08-22,3,1,8,8,0,3,1,1,0.64,0.6061,0.73,0.0896,37,555,703,7030,740,7585
14261,2012-08-22,3,1,8,9,0,3,1,1,0.68,0.6364,0.65,0.0,41,615,335,3350,376,3965
14262,2012-08-22,3,1,8,10,0,3,1,1,0.7,0.6515,0.61,0.0896,66,990,159,1590,225,2580
14263,2012-08-22,3,1,8,11,0,3,1,1,0.72,0.6667,0.58,0.0896,71,1065,196,1960,267,3025
14264,2012-08-22,3,1,8,12,0,3,1,1,0.74,0.6667,0.51,0.0,59,885,253,2530,312,3415
14265,2012-08-22,3,1,8,13,0,3,1,1,0.76,0.6818,0.48,0.1045,74,1110,242,2420,316,3530
14266,2012-08-22,3,1,8,14,0,3,1,1,0.76,0.6818,0.45,0.1045,82,1230,184,1840,266,3070
14267,2012-08-22,3,1,8,15,0,3,1,1,0.76,0.6818,0.48,0.1343,94,1410,222,2220,316,3630
14268,2012-08-22,3,1,8,16,0,3,1,3,0.74,0.6818,0.55,0.2239,102,1530,358,3580,460,5110
14269,2012-08-22,3,1,8,17,0,3,1,3,0.74,0.6818,0.55,0.2239,72,1080,711,7110,783,8190
14270,2012-08-22,3,1,8,18,0,3,1,3,0.66,0.6212,0.61,0.2239,91,1365,592,5920,683,7285
14271,2012-08-22,3,1,8,19,0,3,1,2,0.66,0.6212,0.74,0.0,56,840,524,5240,580,6080
14272,2012-08-22,3,1,8,20,0,3,1,1,0.64,0.6061,0.73,0.194,59,885,332,3320,391,4205
14273,2012-08-22,3,1,8,21,0,3,1,1,0.64,0.6061,0.73,0.0,60,900,291,2910,351,3810
14274,2012-08-22,3,1,8,22,0,3,1,1,0.64,0.6061,0.73,0.0,55,825,226,2260,281,3085
14275,2012-08-22,3,1,8,23,0,3,1,1,0.64,0.5758,0.83,0.0,27,405,113,1130,140,1535
14276,2012-08-23,3,1,8,0,0,4,1,1,0.64,0.5909,0.78,0.0,9,135,51,510,60,645
14277,2012-08-23,3,1,8,1,0,4,1,1,0.62,0.5758,0.83,0.0,10,150,15,150,25,300
14278,2012-08-23,3,1,8,2,0,4,1,1,0.62,0.5758,0.83,0.0,9,135,11,110,20,245
14279,2012-08-23,3,1,8,3,0,4,1,1,0.62,0.5758,0.83,0.0896,3,45,6,60,9,105
14280,2012-08-23,3,1,8,4,0,4,1,1,0.62,0.5758,0.83,0.0,0,0,6,60,6,60
14281,2012-08-23,3,1,8,5,0,4,1,1,0.62,0.5758,0.83,0.0,1,15,36,360,37,375
14282,2012-08-23,3,1,8,6,0,4,1,2,0.6,0.5455,0.88,0.0896,14,210,178,1780,192,1990
14283,2012-08-23,3,1,8,7,0,4,1,2,0.62,0.5758,0.83,0.0896,18,270,463,4630,481,4900
14284,2012-08-23,3,1,8,8,0,4,1,2,0.66,0.6212,0.74,0.0896,45,675,662,6620,707,7295
14285,2012-08-23,3,1,8,9,0,4,1,2,0.7,0.6515,0.7,0.0,58,870,354,3540,412,4410
14286,2012-08-23,3,1,8,10,0,4,1,1,0.74,0.6818,0.58,0.0896,76,1140,157,1570,233,2710
14287,2012-08-23,3,1,8,11,0,4,1,1,0.76,0.6818,0.48,0.0896,86,1290,192,1920,278,3210
14288,2012-08-23,3,1,8,12,0,4,1,1,0.78,0.6818,0.38,0.0,97,1455,235,2350,332,3805
14289,2012-08-23,3,1,8,13,0,4,1,1,0.82,0.7273,0.38,0.0896,93,1395,253,2530,346,3925
14290,2012-08-23,3,1,8,14,0,4,1,1,0.78,0.697,0.46,0.2239,114,1710,191,1910,305,3620
14291,2012-08-23,3,1,8,15,0,4,1,1,0.78,0.697,0.46,0.1343,104,1560,201,2010,305,3570
14292,2012-08-23,3,1,8,16,0,4,1,1,0.76,0.6818,0.48,0.1642,121,1815,344,3440,465,5255
14293,2012-08-23,3,1,8,17,0,4,1,1,0.76,0.6818,0.45,0.2239,111,1665,709,7090,820,8755
14294,2012-08-23,3,1,8,18,0,4,1,1,0.74,0.6667,0.48,0.2239,130,1950,811,8110,941,10060
14295,2012-08-23,3,1,8,19,0,4,1,1,0.72,0.6667,0.51,0.0896,96,1440,537,5370,633,6810
14296,2012-08-23,3,1,8,20,0,4,1,1,0.7,0.6515,0.61,0.1045,70,1050,404,4040,474,5090
14297,2012-08-23,3,1,8,21,0,4,1,1,0.7,0.6515,0.61,0.1343,53,795,276,2760,329,3555
14298,2012-08-23,3,1,8,22,0,4,1,2,0.68,0.6364,0.61,0.1045,21,315,177,1770,198,2085
14299,2012-08-23,3,1,8,23,0,4,1,2,0.66,0.6212,0.69,0.0,24,360,133,1330,157,1690
14300,2012-08-24,3,1,8,0,0,5,1,2,0.66,0.6212,0.69,0.0,27,405,84,840,111,1245
14301,2012-08-24,3,1,8,1,0,5,1,2,0.64,0.6061,0.73,0.0,5,75,37,370,42,445
14302,2012-08-24,3,1,8,2,0,5,1,1,0.66,0.6212,0.69,0.0,1,15,15,150,16,165
14303,2012-08-24,3,1,8,3,0,5,1,1,0.64,0.6061,0.73,0.0,2,30,6,60,8,90
14304,2012-08-24,3,1,8,4,0,5,1,2,0.64,0.6061,0.73,0.0,2,30,6,60,8,90
14305,2012-08-24,3,1,8,5,0,5,1,1,0.64,0.5909,0.78,0.0,1,15,37,370,38,385
14306,2012-08-24,3,1,8,6,0,5,1,2,0.62,0.5758,0.83,0.0,9,135,142,1420,151,1555
14307,2012-08-24,3,1,8,7,0,5,1,2,0.64,0.5909,0.78,0.0,13,195,412,4120,425,4315
14308,2012-08-24,3,1,8,8,0,5,1,2,0.66,0.6212,0.74,0.0,41,615,703,7030,744,7645
14309,2012-08-24,3,1,8,9,0,5,1,2,0.72,0.6667,0.58,0.0,58,870,331,3310,389,4180
14310,2012-08-24,3,1,8,10,0,5,1,2,0.76,0.6818,0.48,0.0,78,1170,184,1840,262,3010
14311,2012-08-24,3,1,8,11,0,5,1,2,0.76,0.6818,0.48,0.1045,69,1035,212,2120,281,3155
14312,2012-08-24,3,1,8,12,0,5,1,2,0.76,0.6818,0.45,0.0896,95,1425,276,2760,371,4185
14313,2012-08-24,3,1,8,13,0,5,1,2,0.8,0.7121,0.41,0.1045,79,1185,272,2720,351,3905
14314,2012-08-24,3,1,8,14,0,5,1,1,0.78,0.697,0.43,0.1045,109,1635,229,2290,338,3925
14315,2012-08-24,3,1,8,15,0,5,1,2,0.76,0.6818,0.48,0.1343,99,1485,251,2510,350,3995
14316,2012-08-24,3,1,8,16,0,5,1,2,0.76,0.6818,0.48,0.1343,101,1515,414,4140,515,5655
14317,2012-08-24,3,1,8,17,0,5,1,2,0.74,0.6667,0.51,0.2239,117,1755,695,6950,812,8705
14318,2012-08-24,3,1,8,18,0,5,1,2,0.72,0.6818,0.62,0.194,109,1635,627,6270,736,7905
14319,2012-08-24,3,1,8,19,0,5,1,2,0.72,0.6667,0.58,0.1642,106,1590,430,4300,536,5890
14320,2012-08-24,3,1,8,20,0,5,1,2,0.7,0.6515,0.65,0.2239,66,990,297,2970,363,3960
14321,2012-08-24,3,1,8,21,0,5,1,2,0.7,0.6515,0.61,0.1642,58,870,248,2480,306,3350
14322,2012-08-24,3,1,8,22,0,5,1,2,0.7,0.6515,0.61,0.0,42,630,209,2090,251,2720
14323,2012-08-24,3,1,8,23,0,5,1,2,0.68,0.6364,0.69,0.0896,38,570,140,1400,178,1970
14324,2012-08-25,3,1,8,0,0,6,0,2,0.7,0.6515,0.61,0.0,21,315,114,1140,135,1455
14325,2012-08-25,3,1,8,1,0,6,0,2,0.68,0.6364,0.69,0.0,15,225,100,1000,115,1225
14326,2012-08-25,3,1,8,2,0,6,0,2,0.66,0.6212,0.74,0.0896,18,270,61,610,79,880
14327,2012-08-25,3,1,8,3,0,6,0,1,0.66,0.6212,0.69,0.0896,7,105,31,310,38,415
14328,2012-08-25,3,1,8,4,0,6,0,2,0.66,0.6212,0.69,0.1045,3,45,9,90,12,135
14329,2012-08-25,3,1,8,5,0,6,0,2,0.64,0.6061,0.73,0.1642,4,60,10,100,14,160
14330,2012-08-25,3,1,8,6,0,6,0,2,0.64,0.5909,0.78,0.1642,5,75,25,250,30,325
14331,2012-08-25,3,1,8,7,0,6,0,2,0.64,0.5909,0.78,0.194,14,210,88,880,102,1090
14332,2012-08-25,3,1,8,8,0,6,0,2,0.66,0.6212,0.74,0.2537,29,435,133,1330,162,1765
14333,2012-08-25,3,1,8,9,0,6,0,2,0.68,0.6364,0.69,0.2836,60,900,228,2280,288,3180
14334,2012-08-25,3,1,8,10,0,6,0,2,0.7,0.6515,0.65,0.2985,148,2220,294,2940,442,5160
14335,2012-08-25,3,1,8,11,0,6,0,2,0.72,0.6818,0.62,0.2836,143,2145,314,3140,457,5285
14336,2012-08-25,3,1,8,12,0,6,0,3,0.72,0.6667,0.54,0.3881,217,3255,367,3670,584,6925
14337,2012-08-25,3,1,8,13,0,6,0,2,0.72,0.6667,0.51,0.3582,186,2790,331,3310,517,6100
14338,2012-08-25,3,1,8,14,0,6,0,3,0.66,0.6212,0.65,0.2537,150,2250,332,3320,482,5570
14339,2012-08-25,3,1,8,15,0,6,0,2,0.64,0.6061,0.73,0.3284,79,1185,154,1540,233,2725
14340,2012-08-25,3,1,8,16,0,6,0,2,0.66,0.6212,0.74,0.2985,174,2610,260,2600,434,5210
14341,2012-08-25,3,1,8,17,0,6,0,2,0.66,0.6212,0.74,0.3284,132,1980,271,2710,403,4690
14342,2012-08-25,3,1,8,18,0,6,0,2,0.66,0.6212,0.69,0.4627,122,1830,261,2610,383,4440
14343,2012-08-25,3,1,8,19,0,6,0,2,0.64,0.5909,0.78,0.2985,97,1455,257,2570,354,4025
14344,2012-08-25,3,1,8,20,0,6,0,3,0.62,0.5758,0.83,0.2537,65,975,176,1760,241,2735
14345,2012-08-25,3,1,8,21,0,6,0,1,0.62,0.5758,0.83,0.3582,60,900,148,1480,208,2380
14346,2012-08-25,3,1,8,22,0,6,0,1,0.62,0.5758,0.83,0.3582,46,690,136,1360,182,2050
14347,2012-08-25,3,1,8,23,0,6,0,2,0.62,0.5758,0.83,0.2537,34,510,124,1240,158,1750
14348,2012-08-26,3,1,8,0,0,0,0,1,0.64,0.5758,0.89,0.2537,23,345,111,1110,134,1455
14349,2012-08-26,3,1,8,1,0,0,0,1,0.64,0.5758,0.89,0.194,18,270,116,1160,134,1430
14350,2012-08-26,3,1,8,2,0,0,0,2,0.64,0.5758,0.89,0.2239,12,180,104,1040,116,1220
14351,2012-08-26,3,1,8,3,0,0,0,2,0.64,0.5758,0.89,0.2537,11,165,42,420,53,585
14352,2012-08-26,3,1,8,4,0,0,0,2,0.64,0.5758,0.89,0.194,5,75,11,110,16,185
14353,2012-08-26,3,1,8,5,0,0,0,1,0.64,0.5758,0.89,0.194,3,45,13,130,16,175
14354,2012-08-26,3,1,8,6,0,0,0,1,0.62,0.5606,0.88,0.2985,5,75,16,160,21,235
14355,2012-08-26,3,1,8,7,0,0,0,1,0.64,0.5758,0.89,0.194,11,165,23,230,34,395
14356,2012-08-26,3,1,8,8,0,0,0,1,0.68,0.6364,0.79,0.2836,21,315,112,1120,133,1435
14357,2012-08-26,3,1,8,9,0,0,0,1,0.68,0.6364,0.79,0.2537,67,1005,196,1960,263,2965
14358,2012-08-26,3,1,8,10,0,0,0,1,0.74,0.697,0.66,0.3881,127,1905,258,2580,385,4485
14359,2012-08-26,3,1,8,11,0,0,0,1,0.74,0.697,0.66,0.3582,150,2250,332,3320,482,5570
14360,2012-08-26,3,1,8,12,0,0,0,3,0.72,0.697,0.74,0.3582,225,3375,401,4010,626,7385
14361,2012-08-26,3,1,8,13,0,0,0,3,0.66,0.6061,0.78,0.4179,166,2490,375,3750,541,6240
14362,2012-08-26,3,1,8,14,0,0,0,1,0.64,0.5758,0.89,0.1045,125,1875,252,2520,377,4395
14363,2012-08-26,3,1,8,15,0,0,0,3,0.64,0.5758,0.89,0.2836,132,1980,259,2590,391,4570
14364,2012-08-26,3,1,8,16,0,0,0,3,0.64,0.5758,0.89,0.2836,57,855,116,1160,173,2015
14365,2012-08-26,3,1,8,17,0,0,0,1,0.64,0.5758,0.89,0.2239,61,915,172,1720,233,2635
14366,2012-08-26,3,1,8,18,0,0,0,2,0.64,0.5758,0.89,0.0896,77,1155,187,1870,264,3025
14367,2012-08-26,3,1,8,19,0,0,0,2,0.64,0.5758,0.89,0.1642,80,1200,212,2120,292,3320
14368,2012-08-26,3,1,8,20,0,0,0,1,0.64,0.5758,0.89,0.1642,40,600,171,1710,211,2310
14369,2012-08-26,3,1,8,21,0,0,0,1,0.64,0.5758,0.83,0.1343,26,390,140,1400,166,1790
14370,2012-08-26,3,1,8,22,0,0,0,1,0.62,0.5606,0.88,0.0896,20,300,94,940,114,1240
14371,2012-08-26,3,1,8,23,0,0,0,1,0.62,0.5758,0.83,0.0896,21,315,59,590,80,905
14372,2012-08-27,3,1,8,0,0,1,1,1,0.62,0.5758,0.83,0.0,4,60,28,280,32,340
14373,2012-08-27,3,1,8,1,0,1,1,1,0.62,0.5606,0.88,0.0896,3,45,4,40,7,85
14374,2012-08-27,3,1,8,2,0,1,1,1,0.62,0.5606,0.88,0.1343,0,0,8,80,8,80
14375,2012-08-27,3,1,8,3,0,1,1,1,0.62,0.5606,0.88,0.0896,1,15,3,30,4,45
14376,2012-08-27,3,1,8,4,0,1,1,1,0.62,0.5758,0.83,0.0,1,15,11,110,12,125
14377,2012-08-27,3,1,8,5,0,1,1,1,0.62,0.5606,0.88,0.0,4,60,32,320,36,380
14378,2012-08-27,3,1,8,6,0,1,1,1,0.62,0.5606,0.88,0.0,4,60,141,1410,145,1470
14379,2012-08-27,3,1,8,7,0,1,1,1,0.66,0.6061,0.83,0.0,15,225,418,4180,433,4405
14380,2012-08-27,3,1,8,8,0,1,1,1,0.66,0.6061,0.83,0.0896,29,435,670,6700,699,7135
14381,2012-08-27,3,1,8,9,0,1,1,1,0.66,0.6061,0.83,0.1045,40,600,302,3020,342,3620
14382,2012-08-27,3,1,8,10,0,1,1,1,0.72,0.697,0.74,0.1343,63,945,143,1430,206,2375
14383,2012-08-27,3,1,8,11,0,1,1,1,0.74,0.697,0.66,0.194,47,705,182,1820,229,2525
14384,2012-08-27,3,1,8,12,0,1,1,1,0.76,0.7121,0.62,0.0,69,1035,214,2140,283,3175
14385,2012-08-27,3,1,8,13,0,1,1,1,0.76,0.7121,0.57,0.1642,77,1155,211,2110,288,3265
14386,2012-08-27,3,1,8,14,0,1,1,1,0.8,0.7424,0.49,0.0896,66,990,180,1800,246,2790
14387,2012-08-27,3,1,8,15,0,1,1,1,0.8,0.7576,0.55,0.2985,77,1155,205,2050,282,3205
14388,2012-08-27,3,1,8,16,0,1,1,1,0.8,0.7576,0.55,0.2537,77,1155,367,3670,444,4825
14389,2012-08-27,3,1,8,17,0,1,1,1,0.8,0.7273,0.46,0.2239,101,1515,744,7440,845,8955
14390,2012-08-27,3,1,8,18,0,1,1,1,0.78,0.7121,0.52,0.2537,83,1245,751,7510,834,8755
14391,2012-08-27,3,1,8,19,0,1,1,1,0.74,0.697,0.7,0.2239,74,1110,499,4990,573,6100
14392,2012-08-27,3,1,8,20,0,1,1,1,0.74,0.697,0.7,0.194,50,750,366,3660,416,4410
14393,2012-08-27,3,1,8,21,0,1,1,1,0.72,0.697,0.74,0.194,39,585,239,2390,278,2975
14394,2012-08-27,3,1,8,22,0,1,1,1,0.7,0.6667,0.84,0.194,30,450,131,1310,161,1760
14395,2012-08-27,3,1,8,23,0,1,1,1,0.7,0.6667,0.84,0.1642,35,525,79,790,114,1315
14396,2012-08-28,3,1,8,0,0,2,1,1,0.7,0.6667,0.84,0.2537,9,135,29,290,38,425
14397,2012-08-28,3,1,8,1,0,2,1,1,0.68,0.6364,0.89,0.194,4,60,17,170,21,230
14398,2012-08-28,3,1,8,2,0,2,1,1,0.68,0.6364,0.83,0.2537,2,30,13,130,15,160
14399,2012-08-28,3,1,8,3,0,2,1,1,0.66,0.5909,0.89,0.1343,0,0,4,40,4,40
14400,2012-08-28,3,1,8,4,0,2,1,1,0.66,0.6061,0.83,0.1343,2,30,6,60,8,90
14401,2012-08-28,3,1,8,5,0,2,1,2,0.66,0.6061,0.83,0.0896,3,45,39,390,42,435
14402,2012-08-28,3,1,8,6,0,2,1,2,0.66,0.5909,0.89,0.1045,3,45,144,1440,147,1485
14403,2012-08-28,3,1,8,7,0,2,1,2,0.66,0.6061,0.83,0.1045,14,210,255,2550,269,2760
14404,2012-08-28,3,1,8,8,0,2,1,2,0.66,0.6212,0.85,0.1045,25,375,668,6680,693,7055
14405,2012-08-28,3,1,8,9,0,2,1,2,0.7,0.6667,0.79,0.1642,44,660,351,3510,395,4170
14406,2012-08-28,3,1,8,10,0,2,1,1,0.74,0.6818,0.62,0.2537,39,585,165,1650,204,2235
14407,2012-08-28,3,1,8,11,0,2,1,1,0.78,0.7273,0.55,0.2537,47,705,171,1710,218,2415
14408,2012-08-28,3,1,8,12,0,2,1,1,0.8,0.7424,0.49,0.2836,56,840,241,2410,297,3250
14409,2012-08-28,3,1,8,13,0,2,1,1,0.82,0.7424,0.43,0.2985,56,840,232,2320,288,3160
14410,2012-08-28,3,1,8,14,0,2,1,1,0.84,0.7424,0.38,0.3284,72,1080,179,1790,251,2870
14411,2012-08-28,3,1,8,15,0,2,1,1,0.82,0.7273,0.34,0.2985,59,885,258,2580,317,3465
14412,2012-08-28,3,1,8,16,0,2,1,1,0.82,0.7121,0.33,0.3284,84,1260,396,3960,480,5220
14413,2012-08-28,3,1,8,17,0,2,1,1,0.8,0.697,0.35,0.3881,90,1350,774,7740,864,9090
14414,2012-08-28,3,1,8,18,0,2,1,1,0.78,0.697,0.4,0.2537,82,1230,736,7360,818,8590
14415,2012-08-28,3,1,8,19,0,2,1,1,0.74,0.6667,0.45,0.1642,82,1230,515,5150,597,6380
14416,2012-08-28,3,1,8,20,0,2,1,1,0.72,0.6667,0.48,0.1045,87,1305,348,3480,435,4785
14417,2012-08-28,3,1,8,21,0,2,1,1,0.72,0.6667,0.48,0.0896,38,570,276,2760,314,3330
14418,2012-08-28,3,1,8,22,0,2,1,1,0.7,0.6515,0.54,0.0,20,300,196,1960,216,2260
14419,2012-08-28,3,1,8,23,0,2,1,1,0.68,0.6364,0.57,0.0,17,255,92,920,109,1175
14420,2012-08-29,3,1,8,0,0,3,1,1,0.66,0.6212,0.69,0.0,8,120,39,390,47,510
14421,2012-08-29,3,1,8,1,0,3,1,1,0.64,0.6061,0.69,0.1343,2,30,12,120,14,150
14422,2012-08-29,3,1,8,2,0,3,1,1,0.62,0.5909,0.73,0.1343,2,30,4,40,6,70
14423,2012-08-29,3,1,8,3,0,3,1,1,0.62,0.5909,0.73,0.1045,0,0,9,90,9,90
14424,2012-08-29,3,1,8,4,0,3,1,1,0.6,0.5909,0.73,0.2239,2,30,8,80,10,110
14425,2012-08-29,3,1,8,5,0,3,1,1,0.6,0.5909,0.73,0.194,3,45,37,370,40,415
14426,2012-08-29,3,1,8,6,0,3,1,1,0.6,0.5909,0.73,0.194,6,90,175,1750,181,1840
14427,2012-08-29,3,1,8,7,0,3,1,1,0.64,0.6061,0.65,0.0896,23,345,531,5310,554,5655
14428,2012-08-29,3,1,8,8,0,3,1,1,0.66,0.6212,0.61,0.1642,28,420,780,7800,808,8220
14429,2012-08-29,3,1,8,9,0,3,1,1,0.7,0.6515,0.51,0.194,40,600,308,3080,348,3680
14430,2012-08-29,3,1,8,10,0,3,1,1,0.72,0.6667,0.48,0.1642,34,510,144,1440,178,1950
14431,2012-08-29,3,1,8,11,0,3,1,1,0.72,0.6515,0.45,0.0,67,1005,186,1860,253,2865
14432,2012-08-29,3,1,8,12,0,3,1,1,0.76,0.6818,0.4,0.0,79,1185,281,2810,360,3995
14433,2012-08-29,3,1,8,13,0,3,1,1,0.74,0.6667,0.42,0.0,68,1020,232,2320,300,3340
14434,2012-08-29,3,1,8,14,0,3,1,1,0.76,0.6818,0.4,0.0896,87,1305,214,2140,301,3445
14435,2012-08-29,3,1,8,15,0,3,1,1,0.76,0.6818,0.4,0.194,96,1440,242,2420,338,3860
14436,2012-08-29,3,1,8,16,0,3,1,1,0.76,0.6667,0.37,0.1343,104,1560,389,3890,493,5450
14437,2012-08-29,3,1,8,17,0,3,1,1,0.78,0.6818,0.35,0.2239,108,1620,762,7620,870,9240
14438,2012-08-29,3,1,8,18,0,3,1,1,0.74,0.6667,0.42,0.1642,119,1785,693,6930,812,8715
14439,2012-08-29,3,1,8,19,0,3,1,1,0.7,0.6515,0.54,0.194,120,1800,523,5230,643,7030
14440,2012-08-29,3,1,8,20,0,3,1,1,0.68,0.6364,0.57,0.0,49,735,378,3780,427,4515
14441,2012-08-29,3,1,8,21,0,3,1,1,0.66,0.6212,0.54,0.1045,48,720,265,2650,313,3370
14442,2012-08-29,3,1,8,22,0,3,1,1,0.66,0.6212,0.54,0.0,50,750,185,1850,235,2600
14443,2012-08-29,3,1,8,23,0,3,1,1,0.66,0.6212,0.57,0.0,34,510,123,1230,157,1740
14444,2012-08-30,3,1,8,0,0,4,1,1,0.64,0.6061,0.69,0.0,14,210,51,510,65,720
14445,2012-08-30,3,1,8,1,0,4,1,1,0.64,0.6061,0.65,0.0,6,90,17,170,23,260
14446,2012-08-30,3,1,8,2,0,4,1,1,0.62,0.5909,0.73,0.0,3,45,14,140,17,185
14447,2012-08-30,3,1,8,3,0,4,1,1,0.62,0.5909,0.73,0.0,0,0,5,50,5,50
14448,2012-08-30,3,1,8,4,0,4,1,1,0.62,0.5909,0.73,0.0,4,60,4,40,8,100
14449,2012-08-30,3,1,8,5,0,4,1,1,0.62,0.5909,0.73,0.0,2,30,33,330,35,360
14450,2012-08-30,3,1,8,6,0,4,1,1,0.6,0.5606,0.83,0.1642,8,120,155,1550,163,1670
14451,2012-08-30,3,1,8,7,0,4,1,1,0.64,0.6061,0.73,0.0,31,465,501,5010,532,5475
14452,2012-08-30,3,1,8,8,0,4,1,1,0.66,0.6212,0.65,0.0,53,795,701,7010,754,7805
14453,2012-08-30,3,1,8,9,0,4,1,1,0.7,0.6515,0.58,0.0,57,855,339,3390,396,4245
14454,2012-08-30,3,1,8,10,0,4,1,1,0.72,0.6667,0.54,0.0,73,1095,161,1610,234,2705
14455,2012-08-30,3,1,8,11,0,4,1,1,0.76,0.6818,0.4,0.0896,85,1275,191,1910,276,3185
14456,2012-08-30,3,1,8,12,0,4,1,1,0.76,0.6818,0.45,0.1343,73,1095,221,2210,294,3305
14457,2012-08-30,3,1,8,13,0,4,1,1,0.76,0.6818,0.48,0.1045,76,1140,214,2140,290,3280
14458,2012-08-30,3,1,8,14,0,4,1,1,0.76,0.6818,0.48,0.1343,74,1110,199,1990,273,3100
14459,2012-08-30,3,1,8,15,0,4,1,1,0.8,0.7273,0.46,0.1642,99,1485,239,2390,338,3875
14460,2012-08-30,3,1,8,16,0,4,1,1,0.8,0.7273,0.43,0.1642,77,1155,405,4050,482,5205
14461,2012-08-30,3,1,8,17,0,4,1,1,0.82,0.7273,0.34,0.2239,93,1395,751,7510,844,8905
14462,2012-08-30,3,1,8,18,0,4,1,1,0.8,0.7121,0.38,0.1343,109,1635,744,7440,853,9075
14463,2012-08-30,3,1,8,19,0,4,1,1,0.76,0.6818,0.48,0.1343,78,1170,532,5320,610,6490
14464,2012-08-30,3,1,8,20,0,4,1,1,0.74,0.6818,0.58,0.1642,68,1020,403,4030,471,5050
14465,2012-08-30,3,1,8,21,0,4,1,1,0.72,0.6818,0.66,0.1343,32,480,275,2750,307,3230
14466,2012-08-30,3,1,8,22,0,4,1,1,0.7,0.6515,0.7,0.0,38,570,253,2530,291,3100
14467,2012-08-30,3,1,8,23,0,4,1,1,0.7,0.6667,0.74,0.1045,19,285,133,1330,152,1615
14468,2012-08-31,3,1,8,0,0,5,1,1,0.68,0.6364,0.83,0.1642,13,195,69,690,82,885
14469,2012-08-31,3,1,8,1,0,5,1,1,0.68,0.6364,0.83,0.1642,8,120,24,240,32,360
14470,2012-08-31,3,1,8,2,0,5,1,1,0.66,0.5909,0.89,0.1343,9,135,11,110,20,245
14471,2012-08-31,3,1,8,3,0,5,1,1,0.66,0.5909,0.89,0.1045,3,45,2,20,5,65
14472,2012-08-31,3,1,8,4,0,5,1,1,0.64,0.5758,0.89,0.1343,0,0,7,70,7,70
14473,2012-08-31,3,1,8,5,0,5,1,1,0.64,0.5758,0.89,0.1642,2,30,27,270,29,300
14474,2012-08-31,3,1,8,6,0,5,1,2,0.64,0.5758,0.89,0.1642,7,105,101,1010,108,1115
14475,2012-08-31,3,1,8,7,0,5,1,2,0.64,0.5758,0.89,0.0896,21,315,400,4000,421,4315
14476,2012-08-31,3,1,8,8,0,5,1,2,0.7,0.6667,0.74,0.0,36,540,654,6540,690,7080
14477,2012-08-31,3,1,8,9,0,5,1,1,0.74,0.697,0.7,0.0,61,915,337,3370,398,4285
14478,2012-08-31,3,1,8,10,0,5,1,1,0.76,0.7121,0.62,0.0896,59,885,197,1970,256,2855
14479,2012-08-31,3,1,8,11,0,5,1,1,0.86,0.7424,0.28,0.2985,88,1320,221,2210,309,3530
14480,2012-08-31,3,1,8,12,0,5,1,1,0.86,0.7424,0.26,0.2537,120,1800,290,2900,410,4700
14481,2012-08-31,3,1,8,13,0,5,1,1,0.88,0.7576,0.27,0.3284,97,1455,271,2710,368,4165
14482,2012-08-31,3,1,8,14,0,5,1,1,0.9,0.7727,0.25,0.2239,112,1680,324,3240,436,4920
14483,2012-08-31,3,1,8,15,0,5,1,1,0.9,0.7879,0.27,0.2985,109,1635,417,4170,526,5805
14484,2012-08-31,3,1,8,16,0,5,1,1,0.9,0.7879,0.27,0.2537,111,1665,417,4170,528,5835
14485,2012-08-31,3,1,8,17,0,5,1,1,0.88,0.7727,0.32,0.1642,129,1935,488,4880,617,6815
14486,2012-08-31,3,1,8,18,0,5,1,1,0.86,0.7576,0.36,0.2537,87,1305,459,4590,546,5895
14487,2012-08-31,3,1,8,19,0,5,1,1,0.8,0.7424,0.49,0.1343,91,1365,361,3610,452,4975
14488,2012-08-31,3,1,8,20,0,5,1,1,0.8,0.7424,0.49,0.1343,102,1530,254,2540,356,4070
14489,2012-08-31,3,1,8,21,0,5,1,1,0.76,0.7121,0.58,0.194,71,1065,232,2320,303,3385
14490,2012-08-31,3,1,8,22,0,5,1,1,0.76,0.7121,0.58,0.194,65,975,212,2120,277,3095
14491,2012-08-31,3,1,8,23,0,5,1,1,0.74,0.6818,0.62,0.1045,32,480,142,1420,174,1900
14492,2012-09-01,3,1,9,0,0,6,0,1,0.74,0.6818,0.62,0.1045,22,330,146,1460,168,1790
14493,2012-09-01,3,1,9,1,0,6,0,1,0.72,0.697,0.74,0.1343,11,165,68,680,79,845
14494,2012-09-01,3,1,9,2,0,6,0,1,0.7,0.6515,0.7,0.1642,8,120,61,610,69,730
14495,2012-09-01,3,1,9,3,0,6,0,1,0.7,0.6515,0.7,0.1045,6,90,29,290,35,380
14496,2012-09-01,3,1,9,4,0,6,0,1,0.7,0.6515,0.7,0.0,3,45,9,90,12,135
14497,2012-09-01,3,1,9,5,0,6,0,1,0.68,0.6364,0.79,0.0,2,30,20,200,22,230
14498,2012-09-01,3,1,9,6,0,6,0,1,0.68,0.6364,0.79,0.0,13,195,23,230,36,425
14499,2012-09-01,3,1,9,7,0,6,0,2,0.74,0.6818,0.58,0.1343,8,120,58,580,66,700
14500,2012-09-01,3,1,9,8,0,6,0,2,0.76,0.7121,0.58,0.2537,28,420,134,1340,162,1760
14501,2012-09-01,3,1,9,9,0,6,0,2,0.76,0.7121,0.58,0.194,62,930,175,1750,237,2680
14502,2012-09-01,3,1,9,10,0,6,0,2,0.78,0.7273,0.55,0.194,128,1920,289,2890,417,4810
14503,2012-09-01,3,1,9,11,0,6,0,2,0.8,0.7576,0.55,0.2239,219,3285,273,2730,492,6015
14504,2012-09-01,3,1,9,12,0,6,0,2,0.8,0.7576,0.55,0.1642,187,2805,284,2840,471,5645
14505,2012-09-01,3,1,9,13,0,6,0,2,0.82,0.7727,0.52,0.0896,237,3555,267,2670,504,6225
14506,2012-09-01,3,1,9,14,0,6,0,2,0.86,0.7879,0.44,0.1642,240,3600,274,2740,514,6340
14507,2012-09-01,3,1,9,15,0,6,0,2,0.86,0.7879,0.44,0.2836,257,3855,306,3060,563,6915
14508,2012-09-01,3,1,9,16,0,6,0,2,0.84,0.7879,0.49,0.1642,209,3135,253,2530,462,5665
14509,2012-09-01,3,1,9,17,0,6,0,2,0.82,0.7727,0.52,0.0,205,3075,258,2580,463,5655
14510,2012-09-01,3,1,9,18,0,6,0,2,0.82,0.7727,0.52,0.0,184,2760,258,2580,442,5340
14511,2012-09-01,3,1,9,19,0,6,0,3,0.78,0.7424,0.62,0.0,157,2355,235,2350,392,4705
14512,2012-09-01,3,1,9,20,0,6,0,3,0.76,0.7273,0.67,0.2537,67,1005,140,1400,207,2405
14513,2012-09-01,3,1,9,21,0,6,0,3,0.64,0.5758,0.89,0.0,21,315,83,830,104,1145
14514,2012-09-01,3,1,9,22,0,6,0,2,0.66,0.5909,0.89,0.0,21,315,57,570,78,885
14515,2012-09-01,3,1,9,23,0,6,0,1,0.66,0.5909,0.89,0.0896,57,855,88,880,145,1735
14516,2012-09-02,3,1,9,0,0,0,0,2,0.66,0.5909,0.89,0.0896,27,405,72,720,99,1125
14517,2012-09-02,3,1,9,1,0,0,0,1,0.66,0.5909,0.89,0.0,15,225,58,580,73,805
14518,2012-09-02,3,1,9,2,0,0,0,1,0.66,0.5909,0.89,0.0,28,420,56,560,84,980
14519,2012-09-02,3,1,9,3,0,0,0,1,0.66,0.5909,0.89,0.0896,9,135,33,330,42,465
14520,2012-09-02,3,1,9,4,0,0,0,1,0.66,0.5909,0.89,0.0,7,105,15,150,22,255
14521,2012-09-02,3,1,9,5,0,0,0,1,0.66,0.5909,0.89,0.0,2,30,10,100,12,130
14522,2012-09-02,3,1,9,6,0,0,0,2,0.66,0.5909,0.89,0.0,2,30,13,130,15,160
14523,2012-09-02,3,1,9,7,0,0,0,1,0.66,0.5909,0.94,0.0896,13,195,29,290,42,485
14524,2012-09-02,3,1,9,8,0,0,0,1,0.68,0.6364,0.89,0.0896,30,450,99,990,129,1440
14525,2012-09-02,3,1,9,9,0,0,0,2,0.7,0.6667,0.84,0.0,88,1320,144,1440,232,2760
14526,2012-09-02,3,1,9,10,0,0,0,2,0.72,0.697,0.79,0.0,158,2370,230,2300,388,4670
14527,2012-09-02,3,1,9,11,0,0,0,2,0.74,0.697,0.7,0.0,226,3390,263,2630,489,6020
14528,2012-09-02,3,1,9,12,0,0,0,3,0.74,0.697,0.7,0.0,248,3720,297,2970,545,6690
14529,2012-09-02,3,1,9,13,0,0,0,3,0.72,0.697,0.74,0.0896,263,3945,230,2300,493,6245
14530,2012-09-02,3,1,9,14,0,0,0,3,0.72,0.697,0.79,0.0896,249,3735,208,2080,457,5815
14531,2012-09-02,3,1,9,15,0,0,0,3,0.74,0.7121,0.74,0.1343,179,2685,176,1760,355,4445
14532,2012-09-02,3,1,9,16,0,0,0,1,0.74,0.697,0.7,0.0,222,3330,252,2520,474,5850
14533,2012-09-02,3,1,9,17,0,0,0,1,0.76,0.7273,0.66,0.0896,219,3285,284,2840,503,6125
14534,2012-09-02,3,1,9,18,0,0,0,1,0.74,0.7121,0.74,0.0,227,3405,273,2730,500,6135
14535,2012-09-02,3,1,9,19,0,0,0,2,0.7,0.6667,0.84,0.2239,140,2100,152,1520,292,3620
14536,2012-09-02,3,1,9,20,0,0,0,2,0.7,0.6667,0.84,0.1642,63,945,41,410,104,1355
14537,2012-09-02,3,1,9,21,0,0,0,1,0.7,0.6515,0.7,0.1642,79,1185,92,920,171,2105
14538,2012-09-02,3,1,9,22,0,0,0,3,0.68,0.6364,0.83,0.1343,66,990,100,1000,166,1990
14539,2012-09-02,3,1,9,23,0,0,0,3,0.66,0.5909,0.89,0.0896,53,795,70,700,123,1495
14540,2012-09-03,3,1,9,0,1,1,0,2,0.66,0.5909,0.94,0.0,42,630,62,620,104,1250
14541,2012-09-03,3,1,9,1,1,1,0,2,0.68,0.6364,0.89,0.1642,18,270,37,370,55,640
14542,2012-09-03,3,1,9,2,1,1,0,1,0.66,0.5909,0.89,0.1045,10,150,30,300,40,450
14543,2012-09-03,3,1,9,3,1,1,0,1,0.66,0.5909,0.89,0.1343,6,90,22,220,28,310
14544,2012-09-03,3,1,9,4,1,1,0,1,0.66,0.5909,0.89,0.0896,6,90,5,50,11,140
14545,2012-09-03,3,1,9,5,1,1,0,1,0.66,0.5909,0.89,0.0,1,15,3,30,4,45
14546,2012-09-03,3,1,9,6,1,1,0,1,0.66,0.5909,0.94,0.0,3,45,12,120,15,165
14547,2012-09-03,3,1,9,7,1,1,0,1,0.68,0.6364,0.85,0.0,6,90,37,370,43,460
14548,2012-09-03,3,1,9,8,1,1,0,2,0.7,0.6667,0.84,0.1045,36,540,91,910,127,1450
14549,2012-09-03,3,1,9,9,1,1,0,2,0.7,0.6667,0.84,0.1343,71,1065,158,1580,229,2645
14550,2012-09-03,3,1,9,10,1,1,0,2,0.74,0.7121,0.74,0.2239,135,2025,224,2240,359,4265
14551,2012-09-03,3,1,9,11,1,1,0,2,0.74,0.697,0.7,0.2836,187,2805,272,2720,459,5525
14552,2012-09-03,3,1,9,12,1,1,0,2,0.76,0.7121,0.62,0.2985,191,2865,352,3520,543,6385
14553,2012-09-03,3,1,9,13,1,1,0,2,0.76,0.7273,0.66,0.2537,209,3135,357,3570,566,6705
14554,2012-09-03,3,1,9,14,1,1,0,1,0.74,0.697,0.7,0.2985,163,2445,349,3490,512,5935
14555,2012-09-03,3,1,9,15,1,1,0,1,0.74,0.697,0.7,0.2239,168,2520,281,2810,449,5330
14556,2012-09-03,3,1,9,16,1,1,0,1,0.74,0.697,0.7,0.2239,165,2475,335,3350,500,5825
14557,2012-09-03,3,1,9,17,1,1,0,1,0.74,0.697,0.7,0.1343,181,2715,317,3170,498,5885
14558,2012-09-03,3,1,9,18,1,1,0,1,0.74,0.697,0.66,0.1642,145,2175,337,3370,482,5545
14559,2012-09-03,3,1,9,19,1,1,0,1,0.72,0.697,0.74,0.194,73,1095,301,3010,374,4105
14560,2012-09-03,3,1,9,20,1,1,0,1,0.72,0.6818,0.76,0.1045,78,1170,183,1830,261,3000
14561,2012-09-03,3,1,9,21,1,1,0,1,0.72,0.6818,0.76,0.1045,42,630,142,1420,184,2050
14562,2012-09-03,3,1,9,22,1,1,0,2,0.7,0.6667,0.84,0.1343,17,255,104,1040,121,1295
14563,2012-09-03,3,1,9,23,1,1,0,2,0.7,0.6667,0.84,0.2537,12,180,58,580,70,760
14564,2012-09-04,3,1,9,0,0,2,1,2,0.7,0.6667,0.84,0.2537,10,150,19,190,29,340
14565,2012-09-04,3,1,9,1,0,2,1,1,0.68,0.6364,0.82,0.1343,15,225,9,90,24,315
14566,2012-09-04,3,1,9,2,0,2,1,1,0.68,0.6364,0.82,0.1343,1,15,4,40,5,55
14567,2012-09-04,3,1,9,3,0,2,1,2,0.66,0.5909,0.89,0.0896,1,15,9,90,10,105
14568,2012-09-04,3,1,9,4,0,2,1,2,0.66,0.5909,0.89,0.0,0,0,8,80,8,80
14569,2012-09-04,3,1,9,5,0,2,1,2,0.66,0.5909,0.89,0.0,1,15,37,370,38,385
14570,2012-09-04,3,1,9,6,0,2,1,2,0.68,0.6364,0.89,0.1045,7,105,165,1650,172,1755
14571,2012-09-04,3,1,9,7,0,2,1,2,0.68,0.6364,0.89,0.1045,13,195,480,4800,493,4995
14572,2012-09-04,3,1,9,8,0,2,1,1,0.7,0.6667,0.84,0.1642,15,225,617,6170,632,6395
14573,2012-09-04,3,1,9,9,0,2,1,2,0.72,0.697,0.79,0.2239,30,450,293,2930,323,3380
14574,2012-09-04,3,1,9,10,0,2,1,2,0.72,0.697,0.74,0.2537,42,630,130,1300,172,1930
14575,2012-09-04,3,1,9,11,0,2,1,2,0.74,0.697,0.7,0.2836,39,585,159,1590,198,2175
14576,2012-09-04,3,1,9,12,0,2,1,1,0.76,0.7273,0.7,0.2836,54,810,233,2330,287,3140
14577,2012-09-04,3,1,9,13,0,2,1,1,0.8,0.7576,0.55,0.4478,72,1080,203,2030,275,3110
14578,2012-09-04,3,1,9,14,0,2,1,1,0.8,0.7576,0.55,0.4179,72,1080,202,2020,274,3100
14579,2012-09-04,3,1,9,15,0,2,1,1,0.8,0.7727,0.59,0.4627,68,1020,224,2240,292,3260
14580,2012-09-04,3,1,9,16,0,2,1,1,0.76,0.7273,0.7,0.4179,61,915,397,3970,458,4885
14581,2012-09-04,3,1,9,17,0,2,1,1,0.76,0.7273,0.7,0.3582,110,1650,746,7460,856,9110
14582,2012-09-04,3,1,9,18,0,2,1,1,0.76,0.7424,0.75,0.2239,94,1410,745,7450,839,8860
14583,2012-09-04,3,1,9,19,0,2,1,1,0.76,0.7273,0.7,0.2239,50,750,502,5020,552,5770
14584,2012-09-04,3,1,9,20,0,2,1,1,0.74,0.697,0.7,0.2537,47,705,338,3380,385,4085
14585,2012-09-04,3,1,9,21,0,2,1,1,0.74,0.7121,0.74,0.2537,28,420,240,2400,268,2820
14586,2012-09-04,3,1,9,22,0,2,1,1,0.74,0.697,0.7,0.2836,25,375,154,1540,179,1915
14587,2012-09-04,3,1,9,23,0,2,1,1,0.72,0.697,0.74,0.2985,12,180,83,830,95,1010
14588,2012-09-05,3,1,9,0,0,3,1,1,0.72,0.697,0.74,0.2537,10,150,27,270,37,420
14589,2012-09-05,3,1,9,1,0,3,1,1,0.7,0.6667,0.84,0.194,2,30,11,110,13,140
14590,2012-09-05,3,1,9,2,0,3,1,1,0.7,0.6667,0.84,0.194,0,0,9,90,9,90
14591,2012-09-05,3,1,9,3,0,3,1,1,0.7,0.6667,0.79,0.2836,0,0,4,40,4,40
14592,2012-09-05,3,1,9,4,0,3,1,1,0.7,0.6667,0.79,0.2836,2,30,3,30,5,60
14593,2012-09-05,3,1,9,5,0,3,1,2,0.7,0.6667,0.79,0.2985,1,15,39,390,40,405
14594,2012-09-05,3,1,9,6,0,3,1,1,0.7,0.6667,0.79,0.2836,7,105,203,2030,210,2135
14595,2012-09-05,3,1,9,7,0,3,1,2,0.7,0.6667,0.79,0.2537,11,165,489,4890,500,5055
14596,2012-09-05,3,1,9,8,0,3,1,1,0.72,0.697,0.74,0.194,33,495,692,6920,725,7415
14597,2012-09-05,3,1,9,9,0,3,1,1,0.74,0.697,0.7,0.2537,27,405,263,2630,290,3035
14598,2012-09-05,3,1,9,10,0,3,1,2,0.76,0.7273,0.7,0.1642,54,810,181,1810,235,2620
14599,2012-09-05,3,1,9,11,0,3,1,2,0.78,0.7424,0.62,0.1642,61,915,156,1560,217,2475
14600,2012-09-05,3,1,9,12,0,3,1,1,0.78,0.7727,0.7,0.1045,49,735,217,2170,266,2905
14601,2012-09-05,3,1,9,13,0,3,1,1,0.8,0.7879,0.63,0.1642,50,750,184,1840,234,2590
14602,2012-09-05,3,1,9,14,0,3,1,1,0.82,0.7879,0.56,0.1045,34,510,177,1770,211,2280
14603,2012-09-05,3,1,9,15,0,3,1,1,0.78,0.7727,0.7,0.194,41,615,204,2040,245,2655
14604,2012-09-05,3,1,9,16,0,3,1,1,0.76,0.7273,0.7,0.2537,86,1290,344,3440,430,4730
14605,2012-09-05,3,1,9,17,0,3,1,1,0.76,0.7273,0.66,0.2537,83,1245,780,7800,863,9045
14606,2012-09-05,3,1,9,18,0,3,1,1,0.76,0.7424,0.75,0.194,82,1230,757,7570,839,8800
14607,2012-09-05,3,1,9,19,0,3,1,1,0.74,0.697,0.7,0.1642,64,960,598,5980,662,6940
14608,2012-09-05,3,1,9,20,0,3,1,1,0.72,0.7121,0.84,0.1642,55,825,357,3570,412,4395
14609,2012-09-05,3,1,9,21,0,3,1,1,0.72,0.697,0.79,0.0,18,270,278,2780,296,3050
14610,2012-09-05,3,1,9,22,0,3,1,1,0.72,0.697,0.79,0.0,38,570,181,1810,219,2380
14611,2012-09-05,3,1,9,23,0,3,1,1,0.7,0.6667,0.84,0.0896,24,360,126,1260,150,1620
14612,2012-09-06,3,1,9,0,0,4,1,2,0.7,0.6667,0.84,0.0896,30,450,35,350,65,800
14613,2012-09-06,3,1,9,1,0,4,1,2,0.7,0.6667,0.84,0.0,2,30,16,160,18,190
14614,2012-09-06,3,1,9,2,0,4,1,1,0.72,0.697,0.79,0.0,1,15,7,70,8,85
14615,2012-09-06,3,1,9,3,0,4,1,1,0.7,0.6667,0.84,0.1045,0,0,9,90,9,90
14616,2012-09-06,3,1,9,4,0,4,1,2,0.7,0.6667,0.84,0.0896,0,0,8,80,8,80
14617,2012-09-06,3,1,9,5,0,4,1,2,0.7,0.6667,0.84,0.194,3,45,35,350,38,395
14618,2012-09-06,3,1,9,6,0,4,1,2,0.7,0.6667,0.84,0.0896,11,165,189,1890,200,2055
14619,2012-09-06,3,1,9,7,0,4,1,2,0.7,0.6667,0.84,0.1045,21,315,461,4610,482,4925
14620,2012-09-06,3,1,9,8,0,4,1,3,0.7,0.6667,0.79,0.0,24,360,622,6220,646,6580
14621,2012-09-06,3,1,9,9,0,4,1,3,0.66,0.5909,0.94,0.1343,8,120,115,1150,123,1270
14622,2012-09-06,3,1,9,10,0,4,1,3,0.66,0.5909,0.94,0.1343,9,135,40,400,49,535
14623,2012-09-06,3,1,9,11,0,4,1,3,0.7,0.6667,0.84,0.1642,10,150,52,520,62,670
14624,2012-09-06,3,1,9,12,0,4,1,2,0.72,0.697,0.79,0.2239,11,165,126,1260,137,1425
14625,2012-09-06,3,1,9,13,0,4,1,2,0.72,0.697,0.79,0.1045,39,585,152,1520,191,2105
14626,2012-09-06,3,1,9,14,0,4,1,1,0.74,0.7121,0.74,0.0896,38,570,178,1780,216,2350
14627,2012-09-06,3,1,9,15,0,4,1,1,0.74,0.697,0.66,0.194,42,630,228,2280,270,2910
14628,2012-09-06,3,1,9,16,0,4,1,1,0.74,0.697,0.7,0.2239,42,630,374,3740,416,4370
14629,2012-09-06,3,1,9,17,0,4,1,1,0.74,0.697,0.7,0.2537,67,1005,741,7410,808,8415
14630,2012-09-06,3,1,9,18,0,4,1,1,0.72,0.6818,0.7,0.2537,74,1110,761,7610,835,8720
14631,2012-09-06,3,1,9,19,0,4,1,1,0.68,0.6364,0.74,0.2537,54,810,504,5040,558,5850
14632,2012-09-06,3,1,9,20,0,4,1,1,0.66,0.6061,0.78,0.2239,50,750,356,3560,406,4310
14633,2012-09-06,3,1,9,21,0,4,1,1,0.64,0.5758,0.89,0.1642,32,480,240,2400,272,2880
14634,2012-09-06,3,1,9,22,0,4,1,1,0.64,0.5758,0.89,0.1642,24,360,193,1930,217,2290
14635,2012-09-06,3,1,9,23,0,4,1,1,0.64,0.5758,0.89,0.1642,19,285,150,1500,169,1785
14636,2012-09-07,3,1,9,0,0,5,1,1,0.64,0.5758,0.89,0.1343,17,255,79,790,96,1045
14637,2012-09-07,3,1,9,1,0,5,1,1,0.62,0.5606,0.88,0.1045,10,150,19,190,29,340
14638,2012-09-07,3,1,9,2,0,5,1,1,0.62,0.5758,0.83,0.0896,1,15,10,100,11,115
14639,2012-09-07,3,1,9,3,0,5,1,1,0.62,0.5758,0.83,0.0896,0,0,9,90,9,90
14640,2012-09-07,3,1,9,4,0,5,1,1,0.62,0.5606,0.88,0.0,1,15,7,70,8,85
14641,2012-09-07,3,1,9,5,0,5,1,1,0.62,0.5606,0.88,0.0,1,15,39,390,40,405
14642,2012-09-07,3,1,9,6,0,5,1,1,0.62,0.5606,0.88,0.1045,5,75,135,1350,140,1425
14643,2012-09-07,3,1,9,7,0,5,1,1,0.64,0.5758,0.89,0.1045,21,315,465,4650,486,4965
14644,2012-09-07,3,1,9,8,0,5,1,1,0.66,0.6061,0.83,0.1045,29,435,690,6900,719,7335
14645,2012-09-07,3,1,9,9,0,5,1,1,0.7,0.6667,0.79,0.1343,33,495,311,3110,344,3605
14646,2012-09-07,3,1,9,10,0,5,1,1,0.72,0.697,0.74,0.1343,53,795,171,1710,224,2505
14647,2012-09-07,3,1,9,11,0,5,1,1,0.76,0.7121,0.62,0.1343,81,1215,215,2150,296,3365
14648,2012-09-07,3,1,9,12,0,5,1,1,0.78,0.7424,0.59,0.1642,76,1140,247,2470,323,3610
14649,2012-09-07,3,1,9,13,0,5,1,1,0.8,0.7727,0.59,0.2537,71,1065,283,2830,354,3895
14650,2012-09-07,3,1,9,14,0,5,1,1,0.8,0.7727,0.59,0.2537,66,990,187,1870,253,2860
14651,2012-09-07,3,1,9,15,0,5,1,1,0.8,0.7576,0.55,0.2537,66,990,265,2650,331,3640
14652,2012-09-07,3,1,9,16,0,5,1,1,0.8,0.7576,0.55,0.2836,75,1125,395,3950,470,5075
14653,2012-09-07,3,1,9,17,0,5,1,1,0.78,0.7424,0.59,0.3284,88,1320,684,6840,772,8160
14654,2012-09-07,3,1,9,18,0,5,1,1,0.76,0.7121,0.62,0.2985,95,1425,697,6970,792,8395
14655,2012-09-07,3,1,9,19,0,5,1,1,0.74,0.6818,0.62,0.2836,70,1050,498,4980,568,6030
14656,2012-09-07,3,1,9,20,0,5,1,1,0.72,0.6818,0.66,0.2239,51,765,340,3400,391,4165
14657,2012-09-07,3,1,9,21,0,5,1,1,0.7,0.6667,0.74,0.1642,55,825,246,2460,301,3285
14658,2012-09-07,3,1,9,22,0,5,1,1,0.7,0.6667,0.74,0.2239,52,780,247,2470,299,3250
14659,2012-09-07,3,1,9,23,0,5,1,1,0.66,0.5909,0.89,0.2537,28,420,220,2200,248,2620
14660,2012-09-08,3,1,9,0,0,6,0,1,0.66,0.5909,0.89,0.2537,20,300,130,1300,150,1600
14661,2012-09-08,3,1,9,1,0,6,0,2,0.66,0.5909,0.89,0.2836,10,150,107,1070,117,1220
14662,2012-09-08,3,1,9,2,0,6,0,1,0.66,0.5909,0.89,0.3284,9,135,68,680,77,815
14663,2012-09-08,3,1,9,3,0,6,0,2,0.66,0.5909,0.89,0.2239,3,45,40,400,43,445
14664,2012-09-08,3,1,9,4,0,6,0,2,0.66,0.5909,0.94,0.2239,3,45,8,80,11,125
14665,2012-09-08,3,1,9,5,0,6,0,2,0.66,0.5909,0.94,0.2537,2,30,13,130,15,160
14666,2012-09-08,3,1,9,6,0,6,0,2,0.66,0.5909,0.89,0.2836,8,120,26,260,34,380
14667,2012-09-08,3,1,9,7,0,6,0,1,0.66,0.5909,0.89,0.2836,11,165,71,710,82,875
14668,2012-09-08,3,1,9,8,0,6,0,1,0.7,0.6667,0.79,0.3284,33,495,197,1970,230,2465
14669,2012-09-08,3,1,9,9,0,6,0,1,0.7,0.6667,0.74,0.3881,87,1305,261,2610,348,3915
14670,2012-09-08,3,1,9,10,0,6,0,1,0.74,0.697,0.7,0.3881,100,1500,322,3220,422,4720
14671,2012-09-08,3,1,9,11,0,6,0,1,0.76,0.7121,0.62,0.4478,173,2595,405,4050,578,6645
14672,2012-09-08,3,1,9,12,0,6,0,1,0.8,0.7576,0.55,0.4925,220,3300,474,4740,694,8040
14673,2012-09-08,3,1,9,13,0,6,0,1,0.82,0.7727,0.52,0.5224,233,3495,435,4350,668,7845
14674,2012-09-08,3,1,9,14,0,6,0,1,0.82,0.7727,0.52,0.4478,260,3900,366,3660,626,7560
14675,2012-09-08,3,1,9,15,0,6,0,3,0.56,0.5303,0.88,0.2537,175,2625,337,3370,512,5995
14676,2012-09-08,3,1,9,16,0,6,0,3,0.56,0.5303,0.88,0.194,19,285,95,950,114,1235
14677,2012-09-08,3,1,9,17,0,6,0,3,0.58,0.5455,0.83,0.194,52,780,119,1190,171,1970
14678,2012-09-08,3,1,9,18,0,6,0,3,0.58,0.5455,0.83,0.1343,27,405,140,1400,167,1805
14679,2012-09-08,3,1,9,19,0,6,0,3,0.58,0.5455,0.88,0.1045,28,420,187,1870,215,2290
14680,2012-09-08,3,1,9,20,0,6,0,2,0.58,0.5455,0.88,0.0896,28,420,166,1660,194,2080
14681,2012-09-08,3,1,9,21,0,6,0,2,0.6,0.5606,0.83,0.1642,26,390,155,1550,181,1940
14682,2012-09-08,3,1,9,22,0,6,0,2,0.58,0.5455,0.78,0.2985,18,270,176,1760,194,2030
14683,2012-09-08,3,1,9,23,0,6,0,2,0.58,0.5455,0.73,0.1642,12,180,121,1210,133,1390
14684,2012-09-09,3,1,9,0,0,0,0,2,0.56,0.5303,0.73,0.194,18,270,106,1060,124,1330
14685,2012-09-09,3,1,9,1,0,0,0,1,0.56,0.5303,0.73,0.2239,20,300,104,1040,124,1340
14686,2012-09-09,3,1,9,2,0,0,0,1,0.54,0.5152,0.77,0.2836,15,225,81,810,96,1035
14687,2012-09-09,3,1,9,3,0,0,0,1,0.54,0.5152,0.73,0.2239,14,210,32,320,46,530
14688,2012-09-09,3,1,9,4,0,0,0,1,0.52,0.5,0.77,0.2537,12,180,16,160,28,340
14689,2012-09-09,3,1,9,5,0,0,0,1,0.52,0.5,0.77,0.194,16,240,39,390,55,630
14690,2012-09-09,3,1,9,6,0,0,0,1,0.52,0.5,0.77,0.194,11,165,24,240,35,405
14691,2012-09-09,3,1,9,7,0,0,0,1,0.54,0.5152,0.73,0.1642,20,300,50,500,70,800
14692,2012-09-09,3,1,9,8,0,0,0,1,0.58,0.5455,0.68,0.2239,27,405,143,1430,170,1835
14693,2012-09-09,3,1,9,9,0,0,0,1,0.62,0.6061,0.61,0.2537,85,1275,214,2140,299,3415
14694,2012-09-09,3,1,9,10,0,0,0,1,0.64,0.6212,0.57,0.2985,172,2580,323,3230,495,5810
14695,2012-09-09,3,1,9,11,0,0,0,1,0.66,0.6212,0.47,0.2537,194,2910,391,3910,585,6820
14696,2012-09-09,3,1,9,12,0,0,0,1,0.66,0.6212,0.47,0.0,247,3705,510,5100,757,8805
14697,2012-09-09,3,1,9,13,0,0,0,1,0.68,0.6364,0.39,0.0,238,3570,491,4910,729,8480
14698,2012-09-09,3,1,9,14,0,0,0,1,0.72,0.6515,0.3,0.2836,232,3480,415,4150,647,7630
14699,2012-09-09,3,1,9,15,0,0,0,1,0.72,0.6515,0.32,0.2537,284,4260,412,4120,696,8380
14700,2012-09-09,3,1,9,16,0,0,0,1,0.68,0.6364,0.36,0.2836,228,3420,473,4730,701,8150
14701,2012-09-09,3,1,9,17,0,0,0,1,0.7,0.6364,0.37,0.2537,213,3195,458,4580,671,7775
14702,2012-09-09,3,1,9,18,0,0,0,1,0.66,0.6212,0.36,0.2537,156,2340,404,4040,560,6380
14703,2012-09-09,3,1,9,19,0,0,0,1,0.66,0.6212,0.36,0.2537,134,2010,362,3620,496,5630
14704,2012-09-09,3,1,9,20,0,0,0,1,0.62,0.6212,0.41,0.2836,91,1365,265,2650,356,4015
14705,2012-09-09,3,1,9,21,0,0,0,1,0.6,0.6212,0.46,0.2239,57,855,149,1490,206,2345
14706,2012-09-09,3,1,9,22,0,0,0,1,0.58,0.5455,0.49,0.2537,64,960,125,1250,189,2210
14707,2012-09-09,3,1,9,23,0,0,0,1,0.56,0.5303,0.52,0.2836,22,330,70,700,92,1030
14708,2012-09-10,3,1,9,0,0,1,1,1,0.56,0.5303,0.52,0.2836,6,90,35,350,41,440
14709,2012-09-10,3,1,9,1,0,1,1,1,0.54,0.5152,0.6,0.194,7,105,11,110,18,215
14710,2012-09-10,3,1,9,2,0,1,1,1,0.54,0.5152,0.6,0.3582,11,165,6,60,17,225
14711,2012-09-10,3,1,9,3,0,1,1,1,0.52,0.5,0.68,0.2836,5,75,7,70,12,145
14712,2012-09-10,3,1,9,4,0,1,1,1,0.52,0.5,0.68,0.2836,1,15,4,40,5,55
14713,2012-09-10,3,1,9,5,0,1,1,1,0.5,0.4848,0.72,0.2537,4,60,36,360,40,420
14714,2012-09-10,3,1,9,6,0,1,1,1,0.5,0.4848,0.72,0.1343,8,120,172,1720,180,1840
14715,2012-09-10,3,1,9,7,0,1,1,1,0.52,0.5,0.68,0.2239,20,300,427,4270,447,4570
14716,2012-09-10,3,1,9,8,0,1,1,1,0.56,0.5303,0.6,0.2836,33,495,697,6970,730,7465
14717,2012-09-10,3,1,9,9,0,1,1,1,0.6,0.6212,0.53,0.2985,40,600,321,3210,361,3810
14718,2012-09-10,3,1,9,10,0,1,1,1,0.62,0.6212,0.5,0.2836,42,630,168,1680,210,2310
14719,2012-09-10,3,1,9,11,0,1,1,1,0.62,0.6212,0.43,0.2985,69,1035,167,1670,236,2705
14720,2012-09-10,3,1,9,12,0,1,1,1,0.64,0.6212,0.44,0.3881,76,1140,256,2560,332,3700
14721,2012-09-10,3,1,9,13,0,1,1,1,0.64,0.6212,0.38,0.2239,72,1080,251,2510,323,3590
14722,2012-09-10,3,1,9,14,0,1,1,1,0.66,0.6212,0.36,0.2836,107,1605,233,2330,340,3935
14723,2012-09-10,3,1,9,15,0,1,1,1,0.66,0.6212,0.31,0.3881,115,1725,231,2310,346,4035
14724,2012-09-10,3,1,9,16,0,1,1,1,0.66,0.6212,0.34,0.3284,108,1620,380,3800,488,5420
14725,2012-09-10,3,1,9,17,0,1,1,1,0.66,0.6212,0.34,0.3284,127,1905,744,7440,871,9345
14726,2012-09-10,3,1,9,18,0,1,1,1,0.62,0.6212,0.35,0.2985,111,1665,857,8570,968,10235
14727,2012-09-10,3,1,9,19,0,1,1,1,0.62,0.6212,0.38,0.2985,71,1065,562,5620,633,6685
14728,2012-09-10,3,1,9,20,0,1,1,1,0.6,0.6212,0.4,0.194,34,510,356,3560,390,4070
14729,2012-09-10,3,1,9,21,0,1,1,1,0.56,0.5303,0.49,0.1642,29,435,256,2560,285,2995
14730,2012-09-10,3,1,9,22,0,1,1,1,0.54,0.5152,0.52,0.1343,15,225,144,1440,159,1665
14731,2012-09-10,3,1,9,23,0,1,1,1,0.54,0.5152,0.52,0.0,7,105,86,860,93,965
14732,2012-09-11,3,1,9,0,0,2,1,1,0.52,0.5,0.59,0.1045,5,75,27,270,32,345
14733,2012-09-11,3,1,9,1,0,2,1,1,0.5,0.4848,0.63,0.0,0,0,10,100,10,100
14734,2012-09-11,3,1,9,2,0,2,1,1,0.48,0.4697,0.77,0.1642,1,15,5,50,6,65
14735,2012-09-11,3,1,9,3,0,2,1,1,0.48,0.4697,0.67,0.1343,1,15,7,70,8,85
14736,2012-09-11,3,1,9,4,0,2,1,1,0.48,0.4697,0.72,0.1045,1,15,8,80,9,95
14737,2012-09-11,3,1,9,5,0,2,1,1,0.46,0.4545,0.72,0.0896,3,45,41,410,44,455
14738,2012-09-11,3,1,9,6,0,2,1,1,0.46,0.4545,0.77,0.1045,11,165,200,2000,211,2165
14739,2012-09-11,3,1,9,7,0,2,1,1,0.5,0.4848,0.72,0.1045,24,360,572,5720,596,6080
14740,2012-09-11,3,1,9,8,0,2,1,1,0.54,0.5152,0.68,0.0896,48,720,702,7020,750,7740
14741,2012-09-11,3,1,9,9,0,2,1,1,0.6,0.6212,0.49,0.0,35,525,323,3230,358,3755
14742,2012-09-11,3,1,9,10,0,2,1,1,0.62,0.6212,0.38,0.0,54,810,142,1420,196,2230
14743,2012-09-11,3,1,9,11,0,2,1,1,0.64,0.6212,0.33,0.0896,60,900,187,1870,247,2770
14744,2012-09-11,3,1,9,12,0,2,1,1,0.64,0.6212,0.33,0.0,62,930,254,2540,316,3470
14745,2012-09-11,3,1,9,13,0,2,1,1,0.66,0.6212,0.29,0.0896,72,1080,256,2560,328,3640
14746,2012-09-11,3,1,9,14,0,2,1,1,0.68,0.6212,0.3,0.0896,74,1110,181,1810,255,2920
14747,2012-09-11,3,1,9,15,0,2,1,1,0.7,0.6364,0.28,0.1045,73,1095,253,2530,326,3625
14748,2012-09-11,3,1,9,16,0,2,1,1,0.7,0.6364,0.28,0.1343,99,1485,437,4370,536,5855
14749,2012-09-11,3,1,9,17,0,2,1,1,0.7,0.6364,0.28,0.0,168,2520,802,8020,970,10540
14750,2012-09-11,3,1,9,18,0,2,1,1,0.64,0.6212,0.36,0.1642,110,1650,767,7670,877,9320
14751,2012-09-11,3,1,9,19,0,2,1,1,0.62,0.6212,0.41,0.194,56,840,540,5400,596,6240
14752,2012-09-11,3,1,9,20,0,2,1,1,0.58,0.5455,0.56,0.1343,40,600,421,4210,461,4810
14753,2012-09-11,3,1,9,21,0,2,1,1,0.56,0.5303,0.6,0.1045,28,420,282,2820,310,3240
14754,2012-09-11,3,1,9,22,0,2,1,1,0.56,0.5303,0.64,0.1045,27,405,189,1890,216,2295
14755,2012-09-11,3,1,9,23,0,2,1,1,0.54,0.5152,0.68,0.1045,18,270,91,910,109,1180
14756,2012-09-12,3,1,9,0,0,3,1,1,0.52,0.5,0.72,0.1045,8,120,41,410,49,530
14757,2012-09-12,3,1,9,1,0,3,1,1,0.52,0.5,0.72,0.1045,2,30,19,190,21,220
14758,2012-09-12,3,1,9,2,0,3,1,1,0.52,0.5,0.72,0.0896,2,30,9,90,11,120
14759,2012-09-12,3,1,9,3,0,3,1,1,0.5,0.4848,0.77,0.0896,0,0,7,70,7,70
14760,2012-09-12,3,1,9,4,0,3,1,1,0.5,0.4848,0.72,0.0896,0,0,5,50,5,50
14761,2012-09-12,3,1,9,5,0,3,1,1,0.5,0.4848,0.72,0.0896,4,60,44,440,48,500
14762,2012-09-12,3,1,9,6,0,3,1,1,0.5,0.4848,0.72,0.0896,6,90,199,1990,205,2080
14763,2012-09-12,3,1,9,7,0,3,1,1,0.52,0.5,0.72,0.0,24,360,533,5330,557,5690
14764,2012-09-12,3,1,9,8,0,3,1,1,0.56,0.5303,0.64,0.1045,43,645,727,7270,770,7915
14765,2012-09-12,3,1,9,9,0,3,1,1,0.6,0.6061,0.64,0.1343,50,750,278,2780,328,3530
14766,2012-09-12,3,1,9,10,0,3,1,1,0.62,0.6061,0.61,0.1343,57,855,148,1480,205,2335
14767,2012-09-12,3,1,9,11,0,3,1,1,0.66,0.6212,0.5,0.194,51,765,181,1810,232,2575
14768,2012-09-12,3,1,9,12,0,3,1,1,0.68,0.6364,0.36,0.1343,88,1320,264,2640,352,3960
14769,2012-09-12,3,1,9,13,0,3,1,1,0.7,0.6364,0.34,0.1343,85,1275,238,2380,323,3655
14770,2012-09-12,3,1,9,14,0,3,1,1,0.7,0.6364,0.37,0.1642,78,1170,200,2000,278,3170
14771,2012-09-12,3,1,9,15,0,3,1,1,0.72,0.6515,0.37,0.1343,75,1125,243,2430,318,3555
14772,2012-09-12,3,1,9,16,0,3,1,1,0.72,0.6515,0.37,0.1642,90,1350,419,4190,509,5540
14773,2012-09-12,3,1,9,17,0,3,1,1,0.7,0.6364,0.41,0.2985,114,1710,811,8110,925,9820
14774,2012-09-12,3,1,9,18,0,3,1,1,0.66,0.6212,0.44,0.2537,91,1365,886,8860,977,10225
14775,2012-09-12,3,1,9,19,0,3,1,1,0.64,0.6212,0.5,0.194,78,1170,557,5570,635,6740
14776,2012-09-12,3,1,9,20,0,3,1,1,0.62,0.6212,0.57,0.1343,38,570,432,4320,470,4890
14777,2012-09-12,3,1,9,21,0,3,1,1,0.6,0.6061,0.6,0.1343,27,405,279,2790,306,3195
14778,2012-09-12,3,1,9,22,0,3,1,1,0.56,0.5303,0.64,0.0896,23,345,189,1890,212,2235
14779,2012-09-12,3,1,9,23,0,3,1,1,0.56,0.5303,0.68,0.1045,16,240,111,1110,127,1350
14780,2012-09-13,3,1,9,0,0,4,1,1,0.56,0.5303,0.73,0.0896,11,165,46,460,57,625
14781,2012-09-13,3,1,9,1,0,4,1,1,0.54,0.5152,0.77,0.0896,6,90,22,220,28,310
14782,2012-09-13,3,1,9,2,0,4,1,1,0.54,0.5152,0.77,0.0,0,0,9,90,9,90
14783,2012-09-13,3,1,9,3,0,4,1,1,0.52,0.5,0.83,0.0,2,30,9,90,11,120
14784,2012-09-13,3,1,9,4,0,4,1,1,0.52,0.5,0.83,0.0,0,0,6,60,6,60
14785,2012-09-13,3,1,9,5,0,4,1,1,0.52,0.5,0.83,0.0,3,45,54,540,57,585
14786,2012-09-13,3,1,9,6,0,4,1,1,0.5,0.4848,0.82,0.0,9,135,186,1860,195,1995
14787,2012-09-13,3,1,9,7,0,4,1,1,0.54,0.5152,0.77,0.0,22,330,549,5490,571,5820
14788,2012-09-13,3,1,9,8,0,4,1,1,0.56,0.5303,0.73,0.0,33,495,725,7250,758,7745
14789,2012-09-13,3,1,9,9,0,4,1,1,0.6,0.6061,0.64,0.0896,46,690,292,2920,338,3610
14790,2012-09-13,3,1,9,10,0,4,1,1,0.64,0.6212,0.61,0.0896,63,945,149,1490,212,2435
14791,2012-09-13,3,1,9,11,0,4,1,1,0.66,0.6212,0.5,0.1642,71,1065,183,1830,254,2895
14792,2012-09-13,3,1,9,12,0,4,1,1,0.68,0.6364,0.44,0.1045,57,855,240,2400,297,3255
14793,2012-09-13,3,1,9,13,0,4,1,1,0.7,0.6364,0.42,0.0,60,900,223,2230,283,3130
14794,2012-09-13,3,1,9,14,0,4,1,1,0.72,0.6515,0.39,0.1343,60,900,214,2140,274,3040
14795,2012-09-13,3,1,9,15,0,4,1,1,0.72,0.6515,0.42,0.1045,99,1485,253,2530,352,4015
14796,2012-09-13,3,1,9,16,0,4,1,1,0.72,0.6515,0.39,0.0896,85,1275,406,4060,491,5335
14797,2012-09-13,3,1,9,17,0,4,1,1,0.72,0.6515,0.42,0.194,97,1455,787,7870,884,9325
14798,2012-09-13,3,1,9,18,0,4,1,1,0.68,0.6364,0.57,0.2537,108,1620,744,7440,852,9060
14799,2012-09-13,3,1,9,19,0,4,1,1,0.64,0.6061,0.65,0.1343,80,1200,594,5940,674,7140
14800,2012-09-13,3,1,9,20,0,4,1,1,0.62,0.6061,0.69,0.1045,55,825,408,4080,463,4905
14801,2012-09-13,3,1,9,21,0,4,1,1,0.62,0.6061,0.65,0.1045,26,390,291,2910,317,3300
14802,2012-09-13,3,1,9,22,0,4,1,1,0.6,0.5909,0.69,0.1343,28,420,223,2230,251,2650
14803,2012-09-13,3,1,9,23,0,4,1,1,0.58,0.5455,0.73,0.1045,33,495,137,1370,170,1865
14804,2012-09-14,3,1,9,0,0,5,1,1,0.56,0.5303,0.73,0.0896,24,360,63,630,87,990
14805,2012-09-14,3,1,9,1,0,5,1,1,0.56,0.5303,0.73,0.0896,6,90,35,350,41,440
14806,2012-09-14,3,1,9,2,0,5,1,1,0.56,0.5303,0.73,0.0,7,105,23,230,30,335
14807,2012-09-14,3,1,9,3,0,5,1,1,0.54,0.5152,0.77,0.0,5,75,9,90,14,165
14808,2012-09-14,3,1,9,4,0,5,1,1,0.54,0.5152,0.77,0.0,1,15,11,110,12,125
14809,2012-09-14,3,1,9,5,0,5,1,1,0.54,0.5152,0.83,0.0,1,15,40,400,41,415
14810,2012-09-14,3,1,9,6,0,5,1,1,0.54,0.5152,0.88,0.0,8,120,144,1440,152,1560
14811,2012-09-14,3,1,9,7,0,5,1,2,0.56,0.5303,0.88,0.0,17,255,437,4370,454,4625
14812,2012-09-14,3,1,9,8,0,5,1,2,0.6,0.5758,0.78,0.1642,51,765,715,7150,766,7915
14813,2012-09-14,3,1,9,9,0,5,1,2,0.62,0.5909,0.78,0.1642,46,690,301,3010,347,3700
14814,2012-09-14,3,1,9,10,0,5,1,2,0.68,0.6364,0.65,0.0,75,1125,171,1710,246,2835
14815,2012-09-14,3,1,9,11,0,5,1,2,0.68,0.6364,0.61,0.1045,84,1260,196,1960,280,3220
14816,2012-09-14,3,1,9,12,0,5,1,2,0.7,0.6515,0.54,0.194,119,1785,290,2900,409,4685
14817,2012-09-14,3,1,9,13,0,5,1,2,0.7,0.6515,0.54,0.194,107,1605,301,3010,408,4615
14818,2012-09-14,3,1,9,14,0,5,1,2,0.72,0.6515,0.45,0.1642,113,1695,258,2580,371,4275
14819,2012-09-14,3,1,9,15,0,5,1,2,0.72,0.6667,0.48,0.1343,94,1410,273,2730,367,4140
14820,2012-09-14,3,1,9,16,0,5,1,2,0.72,0.6667,0.51,0.0,109,1635,454,4540,563,6175
14821,2012-09-14,3,1,9,17,0,5,1,1,0.72,0.6667,0.51,0.194,137,2055,757,7570,894,9625
14822,2012-09-14,3,1,9,18,0,5,1,1,0.72,0.6515,0.45,0.2239,116,1740,692,6920,808,8660
14823,2012-09-14,3,1,9,19,0,5,1,1,0.68,0.6364,0.57,0.1642,83,1245,496,4960,579,6205
14824,2012-09-14,3,1,9,20,0,5,1,1,0.66,0.6212,0.61,0.1045,67,1005,337,3370,404,4375
14825,2012-09-14,3,1,9,21,0,5,1,1,0.64,0.6061,0.73,0.2239,42,630,270,2700,312,3330
14826,2012-09-14,3,1,9,22,0,5,1,1,0.62,0.5758,0.83,0.194,40,600,189,1890,229,2490
14827,2012-09-14,3,1,9,23,0,5,1,1,0.62,0.5909,0.78,0.0896,27,405,168,1680,195,2085
14828,2012-09-15,3,1,9,0,0,6,0,1,0.6,0.5606,0.83,0.1045,38,570,169,1690,207,2260
14829,2012-09-15,3,1,9,1,0,6,0,1,0.6,0.5909,0.73,0.0,8,120,101,1010,109,1130
14830,2012-09-15,3,1,9,2,0,6,0,1,0.58,0.5455,0.78,0.1045,18,270,75,750,93,1020
14831,2012-09-15,3,1,9,3,0,6,0,1,0.6,0.5909,0.73,0.2537,6,90,31,310,37,400
14832,2012-09-15,3,1,9,4,0,6,0,2,0.6,0.5909,0.69,0.3582,3,45,3,30,6,75
14833,2012-09-15,3,1,9,5,0,6,0,1,0.58,0.5455,0.6,0.5224,1,15,15,150,16,165
14834,2012-09-15,3,1,9,6,0,6,0,1,0.54,0.5152,0.49,0.4179,6,90,27,270,33,360
14835,2012-09-15,3,1,9,7,0,6,0,1,0.54,0.5152,0.52,0.2836,10,150,63,630,73,780
14836,2012-09-15,3,1,9,8,0,6,0,1,0.56,0.5303,0.49,0.4179,43,645,169,1690,212,2335
14837,2012-09-15,3,1,9,9,0,6,0,1,0.6,0.6212,0.43,0.4179,79,1185,263,2630,342,3815
14838,2012-09-15,3,1,9,10,0,6,0,1,0.62,0.6212,0.41,0.3881,119,1785,323,3230,442,5015
14839,2012-09-15,3,1,9,11,0,6,0,1,0.64,0.6212,0.38,0.3881,228,3420,399,3990,627,7410
14840,2012-09-15,3,1,9,12,0,6,0,1,0.66,0.6212,0.36,0.3582,287,4305,419,4190,706,8495
14841,2012-09-15,3,1,9,13,0,6,0,1,0.68,0.6364,0.36,0.194,327,4905,377,3770,704,8675
14842,2012-09-15,3,1,9,14,0,6,0,1,0.68,0.6364,0.34,0.3284,325,4875,390,3900,715,8775
14843,2012-09-15,3,1,9,15,0,6,0,2,0.68,0.6364,0.34,0.2836,312,4680,342,3420,654,8100
14844,2012-09-15,3,1,9,16,0,6,0,2,0.66,0.6212,0.36,0.2239,350,5250,433,4330,783,9580
14845,2012-09-15,3,1,9,17,0,6,0,2,0.66,0.6212,0.36,0.2537,295,4425,434,4340,729,8765
14846,2012-09-15,3,1,9,18,0,6,0,2,0.64,0.6212,0.36,0.2836,232,3480,382,3820,614,7300
14847,2012-09-15,3,1,9,19,0,6,0,1,0.62,0.6212,0.41,0.1642,169,2535,309,3090,478,5625
14848,2012-09-15,3,1,9,20,0,6,0,1,0.6,0.6212,0.43,0.0896,89,1335,241,2410,330,3745
14849,2012-09-15,3,1,9,21,0,6,0,1,0.56,0.5303,0.52,0.1045,86,1290,210,2100,296,3390
14850,2012-09-15,3,1,9,22,0,6,0,1,0.56,0.5303,0.52,0.0,82,1230,197,1970,279,3200
14851,2012-09-15,3,1,9,23,0,6,0,1,0.54,0.5152,0.6,0.0,47,705,182,1820,229,2525
14852,2012-09-16,3,1,9,0,0,0,0,1,0.54,0.5152,0.64,0.0,28,420,123,1230,151,1650
14853,2012-09-16,3,1,9,1,0,0,0,1,0.54,0.5152,0.64,0.0,35,525,82,820,117,1345
14854,2012-09-16,3,1,9,2,0,0,0,1,0.52,0.5,0.63,0.0,27,405,62,620,89,1025
14855,2012-09-16,3,1,9,3,0,0,0,1,0.5,0.4848,0.68,0.0,10,150,38,380,48,530
14856,2012-09-16,3,1,9,4,0,0,0,1,0.5,0.4848,0.72,0.0,2,30,6,60,8,90
14857,2012-09-16,3,1,9,5,0,0,0,1,0.5,0.4848,0.72,0.0,3,45,10,100,13,145
14858,2012-09-16,3,1,9,6,0,0,0,1,0.5,0.4848,0.72,0.0,9,135,26,260,35,395
14859,2012-09-16,3,1,9,7,0,0,0,1,0.5,0.4848,0.77,0.1045,28,420,43,430,71,850
14860,2012-09-16,3,1,9,8,0,0,0,1,0.54,0.5152,0.64,0.1642,34,510,94,940,128,1450
14861,2012-09-16,3,1,9,9,0,0,0,1,0.58,0.5455,0.6,0.1343,70,1050,226,2260,296,3310
14862,2012-09-16,3,1,9,10,0,0,0,1,0.62,0.6212,0.5,0.1045,160,2400,330,3300,490,5700
14863,2012-09-16,3,1,9,11,0,0,0,1,0.64,0.6212,0.47,0.1642,183,2745,376,3760,559,6505
14864,2012-09-16,3,1,9,12,0,0,0,1,0.66,0.6212,0.44,0.1642,188,2820,468,4680,656,7500
14865,2012-09-16,3,1,9,13,0,0,0,1,0.64,0.6212,0.41,0.1642,240,3600,454,4540,694,8140
14866,2012-09-16,3,1,9,14,0,0,0,1,0.66,0.6212,0.39,0.1343,225,3375,410,4100,635,7475
14867,2012-09-16,3,1,9,15,0,0,0,1,0.64,0.6212,0.41,0.1642,215,3225,342,3420,557,6645
14868,2012-09-16,3,1,9,16,0,0,0,1,0.64,0.6212,0.44,0.1642,194,2910,402,4020,596,6930
14869,2012-09-16,3,1,9,17,0,0,0,1,0.66,0.6212,0.41,0.0,177,2655,393,3930,570,6585
14870,2012-09-16,3,1,9,18,0,0,0,1,0.62,0.6212,0.5,0.1642,120,1800,361,3610,481,5410
14871,2012-09-16,3,1,9,19,0,0,0,1,0.62,0.6212,0.5,0.1343,91,1365,312,3120,403,4485
14872,2012-09-16,3,1,9,20,0,0,0,1,0.6,0.6212,0.53,0.1045,57,855,267,2670,324,3525
14873,2012-09-16,3,1,9,21,0,0,0,1,0.6,0.6212,0.56,0.1045,43,645,148,1480,191,2125
14874,2012-09-16,3,1,9,22,0,0,0,1,0.56,0.5303,0.68,0.0896,18,270,109,1090,127,1360
14875,2012-09-16,3,1,9,23,0,0,0,1,0.54,0.5152,0.68,0.1045,9,135,85,850,94,985
14876,2012-09-17,3,1,9,0,0,1,1,1,0.54,0.5152,0.68,0.1642,14,210,31,310,45,520
14877,2012-09-17,3,1,9,1,0,1,1,1,0.52,0.5,0.72,0.0896,9,135,12,120,21,255
14878,2012-09-17,3,1,9,2,0,1,1,1,0.52,0.5,0.72,0.0,5,75,8,80,13,155
14879,2012-09-17,3,1,9,3,0,1,1,1,0.5,0.4848,0.77,0.0896,0,0,7,70,7,70
14880,2012-09-17,3,1,9,4,0,1,1,1,0.5,0.4848,0.77,0.0,2,30,9,90,11,120
14881,2012-09-17,3,1,9,5,0,1,1,1,0.48,0.4697,0.82,0.0896,1,15,44,440,45,455
14882,2012-09-17,3,1,9,6,0,1,1,1,0.48,0.4697,0.82,0.0,7,105,157,1570,164,1675
14883,2012-09-17,3,1,9,7,0,1,1,1,0.52,0.5,0.77,0.0,18,270,474,4740,492,5010
14884,2012-09-17,3,1,9,8,0,1,1,1,0.54,0.5152,0.77,0.0896,36,540,647,6470,683,7010
14885,2012-09-17,3,1,9,9,0,1,1,1,0.58,0.5455,0.68,0.1343,34,510,265,2650,299,3160
14886,2012-09-17,3,1,9,10,0,1,1,2,0.62,0.6061,0.65,0.194,73,1095,129,1290,202,2385
14887,2012-09-17,3,1,9,11,0,1,1,2,0.62,0.6061,0.69,0.2239,61,915,191,1910,252,2825
14888,2012-09-17,3,1,9,12,0,1,1,2,0.62,0.6061,0.69,0.194,62,930,233,2330,295,3260
14889,2012-09-17,3,1,9,13,0,1,1,1,0.64,0.6061,0.65,0.2537,112,1680,231,2310,343,3990
14890,2012-09-17,3,1,9,14,0,1,1,2,0.64,0.6061,0.65,0.2537,129,1935,203,2030,332,3965
14891,2012-09-17,3,1,9,15,0,1,1,2,0.64,0.6061,0.65,0.2537,82,1230,256,2560,338,3790
14892,2012-09-17,3,1,9,16,0,1,1,2,0.64,0.6061,0.69,0.2537,74,1110,379,3790,453,4900
14893,2012-09-17,3,1,9,17,0,1,1,2,0.64,0.6061,0.65,0.2239,102,1530,740,7400,842,8930
14894,2012-09-17,3,1,9,18,0,1,1,2,0.62,0.5909,0.73,0.1642,66,990,708,7080,774,8070
14895,2012-09-17,3,1,9,19,0,1,1,2,0.62,0.5909,0.73,0.1045,51,765,435,4350,486,5115
14896,2012-09-17,3,1,9,20,0,1,1,2,0.62,0.5909,0.73,0.1343,32,480,308,3080,340,3560
14897,2012-09-17,3,1,9,21,0,1,1,3,0.62,0.5758,0.83,0.2239,28,420,205,2050,233,2470
14898,2012-09-17,3,1,9,22,0,1,1,3,0.62,0.5758,0.83,0.2537,20,300,109,1090,129,1390
14899,2012-09-17,3,1,9,23,0,1,1,3,0.6,0.5152,0.94,0.2537,4,60,66,660,70,720
14900,2012-09-18,3,1,9,0,0,2,1,3,0.6,0.5152,0.94,0.2537,2,30,11,110,13,140
14901,2012-09-18,3,1,9,1,0,2,1,3,0.6,0.5152,0.94,0.194,0,0,5,50,5,50
14902,2012-09-18,3,1,9,2,0,2,1,3,0.6,0.5152,0.94,0.194,0,0,4,40,4,40
14903,2012-09-18,3,1,9,3,0,2,1,2,0.62,0.5455,0.94,0.2836,0,0,6,60,6,60
14904,2012-09-18,3,1,9,4,0,2,1,2,0.62,0.5455,0.94,0.3582,2,30,5,50,7,80
14905,2012-09-18,3,1,9,5,0,2,1,2,0.64,0.5758,0.89,0.3284,3,45,45,450,48,495
14906,2012-09-18,3,1,9,6,0,2,1,2,0.64,0.5758,0.89,0.3284,4,60,163,1630,167,1690
14907,2012-09-18,3,1,9,7,0,2,1,2,0.64,0.5758,0.89,0.4478,13,195,343,3430,356,3625
14908,2012-09-18,3,1,9,8,0,2,1,2,0.66,0.6061,0.83,0.5522,32,480,640,6400,672,6880
14909,2012-09-18,3,1,9,9,0,2,1,2,0.66,0.6061,0.83,0.5821,27,405,266,2660,293,3065
14910,2012-09-18,3,1,9,10,0,2,1,3,0.68,0.6364,0.79,0.6418,30,450,130,1300,160,1750
14911,2012-09-18,3,1,9,11,0,2,1,2,0.68,0.6364,0.79,0.6418,36,540,115,1150,151,1690
14912,2012-09-18,3,1,9,12,0,2,1,3,0.68,0.6364,0.83,0.4478,16,240,72,720,88,960
14913,2012-09-18,3,1,9,13,0,2,1,2,0.7,0.6667,0.74,0.5821,17,255,97,970,114,1225
14914,2012-09-18,3,1,9,14,0,2,1,3,0.6,0.5152,0.94,0.4627,27,405,116,1160,143,1565
14915,2012-09-18,3,1,9,15,0,2,1,3,0.6,0.5455,0.88,0.2537,1,15,35,350,36,365
14916,2012-09-18,3,1,9,16,0,2,1,3,0.6,0.5455,0.88,0.2985,19,285,122,1220,141,1505
14917,2012-09-18,3,1,9,17,0,2,1,3,0.6,0.5455,0.88,0.194,36,540,302,3020,338,3560
14918,2012-09-18,3,1,9,18,0,2,1,2,0.6,0.5455,0.88,0.1642,19,285,262,2620,281,2905
14919,2012-09-18,3,1,9,19,0,2,1,2,0.6,0.5455,0.88,0.2985,22,330,302,3020,324,3350
14920,2012-09-18,3,1,9,20,0,2,1,2,0.6,0.5455,0.88,0.194,19,285,271,2710,290,2995
14921,2012-09-18,3,1,9,21,0,2,1,2,0.6,0.5455,0.88,0.194,21,315,186,1860,207,2175
14922,2012-09-18,3,1,9,22,0,2,1,3,0.58,0.5455,0.83,0.4627,14,210,137,1370,151,1580
14923,2012-09-18,3,1,9,23,0,2,1,2,0.56,0.5303,0.83,0.2239,11,165,67,670,78,835
14924,2012-09-19,3,1,9,0,0,3,1,2,0.56,0.5303,0.68,0.2836,3,45,23,230,26,275
14925,2012-09-19,3,1,9,1,0,3,1,2,0.54,0.5152,0.68,0.2537,0,0,12,120,12,120
14926,2012-09-19,3,1,9,2,0,3,1,2,0.54,0.5152,0.64,0.3284,0,0,3,30,3,30
14927,2012-09-19,3,1,9,3,0,3,1,2,0.52,0.5,0.63,0.2537,1,15,4,40,5,55
14928,2012-09-19,3,1,9,4,0,3,1,2,0.52,0.5,0.68,0.3582,0,0,10,100,10,100
14929,2012-09-19,3,1,9,5,0,3,1,2,0.52,0.5,0.68,0.2836,2,30,54,540,56,570
14930,2012-09-19,3,1,9,6,0,3,1,1,0.52,0.5,0.63,0.2537,6,90,166,1660,172,1750
14931,2012-09-19,3,1,9,7,0,3,1,1,0.52,0.5,0.63,0.2239,16,240,529,5290,545,5530
14932,2012-09-19,3,1,9,8,0,3,1,1,0.52,0.5,0.59,0.2239,39,585,758,7580,797,8165
14933,2012-09-19,3,1,9,9,0,3,1,1,0.54,0.5152,0.6,0.2537,26,390,336,3360,362,3750
14934,2012-09-19,3,1,9,10,0,3,1,1,0.56,0.5303,0.52,0.194,23,345,169,1690,192,2035
14935,2012-09-19,3,1,9,11,0,3,1,1,0.6,0.6212,0.43,0.2537,44,660,203,2030,247,2690
14936,2012-09-19,3,1,9,12,0,3,1,1,0.6,0.6212,0.43,0.2537,53,795,260,2600,313,3395
14937,2012-09-19,3,1,9,13,0,3,1,1,0.6,0.6212,0.4,0.2537,55,825,234,2340,289,3165
14938,2012-09-19,3,1,9,14,0,3,1,1,0.62,0.6212,0.38,0.2537,59,885,227,2270,286,3155
14939,2012-09-19,3,1,9,15,0,3,1,1,0.62,0.6212,0.35,0.0,57,855,254,2540,311,3395
14940,2012-09-19,3,1,9,16,0,3,1,1,0.62,0.6212,0.35,0.0,69,1035,397,3970,466,5005
14941,2012-09-19,3,1,9,17,0,3,1,1,0.6,0.6212,0.38,0.2239,74,1110,812,8120,886,9230
14942,2012-09-19,3,1,9,18,0,3,1,1,0.58,0.5455,0.4,0.2836,85,1275,807,8070,892,9345
14943,2012-09-19,3,1,9,19,0,3,1,1,0.56,0.5303,0.43,0.2239,72,1080,539,5390,611,6470
14944,2012-09-19,3,1,9,20,0,3,1,1,0.52,0.5,0.48,0.1642,31,465,378,3780,409,4245
14945,2012-09-19,3,1,9,21,0,3,1,1,0.5,0.4848,0.59,0.1642,25,375,324,3240,349,3615
14946,2012-09-19,3,1,9,22,0,3,1,1,0.5,0.4848,0.63,0.0896,31,465,198,1980,229,2445
14947,2012-09-19,3,1,9,23,0,3,1,1,0.48,0.4697,0.67,0.0896,17,255,106,1060,123,1315
14948,2012-09-20,3,1,9,0,0,4,1,1,0.5,0.4848,0.63,0.0,12,180,46,460,58,640
14949,2012-09-20,3,1,9,1,0,4,1,1,0.46,0.4545,0.72,0.1045,4,60,14,140,18,200
14950,2012-09-20,3,1,9,2,0,4,1,1,0.46,0.4545,0.72,0.0896,2,30,9,90,11,120
14951,2012-09-20,3,1,9,3,0,4,1,1,0.44,0.4394,0.77,0.0,0,0,6,60,6,60
14952,2012-09-20,3,1,9,4,0,4,1,1,0.44,0.4394,0.77,0.1045,0,0,6,60,6,60
14953,2012-09-20,3,1,9,5,0,4,1,1,0.44,0.4394,0.77,0.1045,4,60,52,520,56,580
14954,2012-09-20,3,1,9,6,0,4,1,1,0.44,0.4394,0.77,0.0,9,135,161,1610,170,1745
14955,2012-09-20,3,1,9,7,0,4,1,1,0.46,0.4545,0.82,0.1045,20,300,514,5140,534,5440
14956,2012-09-20,3,1,9,8,0,4,1,1,0.5,0.4848,0.68,0.0896,44,660,746,7460,790,8120
14957,2012-09-20,3,1,9,9,0,4,1,1,0.56,0.5303,0.6,0.0896,25,375,330,3300,355,3675
14958,2012-09-20,3,1,9,10,0,4,1,1,0.58,0.5455,0.53,0.0896,33,495,157,1570,190,2065
14959,2012-09-20,3,1,9,11,0,4,1,1,0.62,0.6212,0.43,0.0,37,555,206,2060,243,2615
14960,2012-09-20,3,1,9,12,0,4,1,1,0.62,0.6212,0.43,0.1343,57,855,233,2330,290,3185
14961,2012-09-20,3,1,9,13,0,4,1,1,0.64,0.6212,0.44,0.1343,68,1020,268,2680,336,3700
14962,2012-09-20,3,1,9,14,0,4,1,1,0.64,0.6212,0.47,0.194,76,1140,222,2220,298,3360
14963,2012-09-20,3,1,9,15,0,4,1,1,0.66,0.6212,0.47,0.194,60,900,231,2310,291,3210
14964,2012-09-20,3,1,9,16,0,4,1,1,0.64,0.6212,0.47,0.1642,72,1080,385,3850,457,4930
14965,2012-09-20,3,1,9,17,0,4,1,1,0.64,0.6212,0.5,0.2239,91,1365,885,8850,976,10215
14966,2012-09-20,3,1,9,18,0,4,1,1,0.6,0.6212,0.56,0.2537,119,1785,781,7810,900,9595
14967,2012-09-20,3,1,9,19,0,4,1,1,0.58,0.5455,0.6,0.2239,69,1035,534,5340,603,6375
14968,2012-09-20,3,1,9,20,0,4,1,1,0.56,0.5303,0.64,0.1343,57,855,360,3600,417,4455
14969,2012-09-20,3,1,9,21,0,4,1,1,0.56,0.5303,0.64,0.194,28,420,246,2460,274,2880
14970,2012-09-20,3,1,9,22,0,4,1,1,0.54,0.5152,0.73,0.1045,35,525,252,2520,287,3045
14971,2012-09-20,3,1,9,23,0,4,1,1,0.54,0.5152,0.68,0.1045,17,255,137,1370,154,1625
14972,2012-09-21,3,1,9,0,0,5,1,1,0.54,0.5152,0.68,0.0,13,195,53,530,66,725
14973,2012-09-21,3,1,9,1,0,5,1,1,0.52,0.5,0.72,0.0,11,165,38,380,49,545
14974,2012-09-21,3,1,9,2,0,5,1,1,0.52,0.5,0.72,0.0,6,90,8,80,14,170
14975,2012-09-21,3,1,9,3,0,5,1,1,0.5,0.4848,0.77,0.0896,1,15,11,110,12,125
14976,2012-09-21,3,1,9,4,0,5,1,1,0.5,0.4848,0.77,0.0,1,15,9,90,10,105
14977,2012-09-21,3,1,9,5,0,5,1,1,0.5,0.4848,0.82,0.0,2,30,47,470,49,500
14978,2012-09-21,3,1,9,6,0,5,1,1,0.5,0.4848,0.77,0.0896,19,285,146,1460,165,1745
14979,2012-09-21,3,1,9,7,0,5,1,1,0.52,0.5,0.77,0.0,35,525,468,4680,503,5205
14980,2012-09-21,3,1,9,8,0,5,1,1,0.54,0.5152,0.73,0.1343,31,465,726,7260,757,7725
14981,2012-09-21,3,1,9,9,0,5,1,1,0.58,0.5455,0.68,0.1343,35,525,348,3480,383,4005
14982,2012-09-21,3,1,9,10,0,5,1,1,0.62,0.6061,0.61,0.2239,44,660,181,1810,225,2470
14983,2012-09-21,3,1,9,11,0,5,1,1,0.66,0.6212,0.57,0.2239,79,1185,242,2420,321,3605
14984,2012-09-21,3,1,9,12,0,5,1,1,0.68,0.6364,0.57,0.1642,84,1260,305,3050,389,4310
14985,2012-09-21,3,1,9,13,0,5,1,1,0.7,0.6515,0.54,0.1642,105,1575,316,3160,421,4735
14986,2012-09-21,3,1,9,14,0,5,1,1,0.7,0.6515,0.54,0.2985,113,1695,299,2990,412,4685
14987,2012-09-21,3,1,9,15,0,5,1,1,0.7,0.6515,0.54,0.2239,90,1350,333,3330,423,4680
14988,2012-09-21,3,1,9,16,0,5,1,1,0.7,0.6515,0.54,0.194,103,1545,464,4640,567,6185
14989,2012-09-21,3,1,9,17,0,5,1,1,0.68,0.6364,0.57,0.2836,107,1605,739,7390,846,8995
14990,2012-09-21,3,1,9,18,0,5,1,1,0.66,0.6212,0.61,0.2537,106,1590,699,6990,805,8580
14991,2012-09-21,3,1,9,19,0,5,1,1,0.64,0.6061,0.65,0.2537,95,1425,493,4930,588,6355
14992,2012-09-21,3,1,9,20,0,5,1,1,0.62,0.6061,0.69,0.194,54,810,315,3150,369,3960
14993,2012-09-21,3,1,9,21,0,5,1,1,0.6,0.5909,0.73,0.2537,46,690,266,2660,312,3350
14994,2012-09-21,3,1,9,22,0,5,1,1,0.6,0.5909,0.73,0.194,47,705,248,2480,295,3185
14995,2012-09-21,3,1,9,23,0,5,1,1,0.6,0.5909,0.73,0.3284,23,345,163,1630,186,1975
14996,2012-09-22,3,1,9,0,0,6,0,1,0.6,0.5909,0.73,0.2836,32,480,140,1400,172,1880
14997,2012-09-22,3,1,9,1,0,6,0,1,0.58,0.5455,0.83,0.2985,18,270,106,1060,124,1330
14998,2012-09-22,3,1,9,2,0,6,0,1,0.56,0.5303,0.88,0.2537,10,150,73,730,83,880
14999,2012-09-22,3,1,9,3,0,6,0,1,0.56,0.5303,0.83,0.2836,6,90,39,390,45,480
15000,2012-09-22,3,1,9,4,0,6,0,1,0.56,0.5303,0.83,0.2836,5,75,10,100,15,175
15001,2012-09-22,3,1,9,5,0,6,0,1,0.56,0.5303,0.83,0.3284,2,30,15,150,17,180
15002,2012-09-22,3,1,9,6,0,6,0,1,0.56,0.5303,0.83,0.2985,6,90,35,350,41,440
15003,2012-09-22,3,1,9,7,0,6,0,1,0.58,0.5455,0.78,0.2537,7,105,70,700,77,805
15004,2012-09-22,3,1,9,8,0,6,0,1,0.6,0.5909,0.73,0.2985,21,315,197,1970,218,2285
15005,2012-09-22,3,1,9,9,0,6,0,1,0.64,0.6061,0.69,0.2537,88,1320,289,2890,377,4210
15006,2012-09-22,3,1,9,10,0,6,0,1,0.66,0.6212,0.65,0.3284,124,1860,350,3500,474,5360
15007,2012-09-22,3,1,9,11,0,6,0,1,0.7,0.6515,0.58,0.2836,189,2835,437,4370,626,7205
15008,2012-09-22,3,1,9,12,0,6,0,1,0.72,0.6667,0.54,0.2985,228,3420,460,4600,688,8020
15009,2012-09-22,3,1,9,13,0,6,0,1,0.74,0.6667,0.51,0.3582,273,4095,434,4340,707,8435
15010,2012-09-22,3,1,9,14,0,6,0,1,0.76,0.6818,0.48,0.2836,250,3750,404,4040,654,7790
15011,2012-09-22,3,1,9,15,0,6,0,1,0.74,0.6667,0.48,0.3881,307,4605,443,4430,750,9035
15012,2012-09-22,3,1,9,16,0,6,0,1,0.74,0.6667,0.51,0.3284,253,3795,427,4270,680,8065
15013,2012-09-22,3,1,9,17,0,6,0,1,0.74,0.6667,0.51,0.3284,195,2925,451,4510,646,7435
15014,2012-09-22,3,1,9,18,0,6,0,1,0.72,0.6667,0.54,0.2836,171,2565,427,4270,598,6835
15015,2012-09-22,3,1,9,19,0,6,0,1,0.7,0.6515,0.58,0.194,99,1485,308,3080,407,4565
15016,2012-09-22,3,1,9,20,0,6,0,1,0.7,0.6515,0.54,0.2537,76,1140,249,2490,325,3630
15017,2012-09-22,3,1,9,21,0,6,0,1,0.64,0.6212,0.57,0.2537,59,885,202,2020,261,2905
15018,2012-09-22,3,1,9,22,0,6,0,1,0.62,0.6212,0.57,0.194,59,885,180,1800,239,2685
15019,2012-09-22,3,1,9,23,0,6,0,1,0.62,0.6212,0.5,0.194,34,510,137,1370,171,1880
15020,2012-09-23,4,1,9,0,0,0,0,1,0.62,0.6212,0.38,0.2537,34,510,146,1460,180,1970
15021,2012-09-23,4,1,9,1,0,0,0,1,0.54,0.5152,0.52,0.3582,23,345,119,1190,142,1535
15022,2012-09-23,4,1,9,2,0,0,0,1,0.52,0.5,0.48,0.2537,18,270,77,770,95,1040
15023,2012-09-23,4,1,9,3,0,0,0,1,0.48,0.4697,0.55,0.2985,13,195,41,410,54,605
15024,2012-09-23,4,1,9,4,0,0,0,1,0.46,0.4545,0.55,0.2239,1,15,9,90,10,105
15025,2012-09-23,4,1,9,5,0,0,0,1,0.46,0.4545,0.59,0.2537,1,15,5,50,6,65
15026,2012-09-23,4,1,9,6,0,0,0,1,0.44,0.4394,0.62,0.2537,5,75,11,110,16,185
15027,2012-09-23,4,1,9,7,0,0,0,1,0.46,0.4545,0.59,0.2239,9,135,48,480,57,615
15028,2012-09-23,4,1,9,8,0,0,0,1,0.48,0.4697,0.55,0.3582,38,570,137,1370,175,1940
15029,2012-09-23,4,1,9,9,0,0,0,1,0.5,0.4848,0.51,0.3284,71,1065,205,2050,276,3115
15030,2012-09-23,4,1,9,10,0,0,0,1,0.54,0.5152,0.45,0.2537,138,2070,351,3510,489,5580
15031,2012-09-23,4,1,9,11,0,0,0,1,0.56,0.5303,0.46,0.2537,186,2790,384,3840,570,6630
15032,2012-09-23,4,1,9,12,0,0,0,1,0.56,0.5303,0.43,0.1045,250,3750,526,5260,776,9010
15033,2012-09-23,4,1,9,13,0,0,0,1,0.6,0.6212,0.38,0.1642,257,3855,445,4450,702,8305
15034,2012-09-23,4,1,9,14,0,0,0,1,0.6,0.6212,0.38,0.194,266,3990,400,4000,666,7990
15035,2012-09-23,4,1,9,15,0,0,0,1,0.6,0.6212,0.33,0.2239,265,3975,375,3750,640,7725
15036,2012-09-23,4,1,9,16,0,0,0,1,0.6,0.6212,0.33,0.3284,254,3810,437,4370,691,8180
15037,2012-09-23,4,1,9,17,0,0,0,1,0.56,0.5303,0.35,0.2985,227,3405,496,4960,723,8365
15038,2012-09-23,4,1,9,18,0,0,0,1,0.54,0.5152,0.37,0.194,135,2025,405,4050,540,6075
15039,2012-09-23,4,1,9,19,0,0,0,1,0.52,0.5,0.42,0.1642,82,1230,331,3310,413,4540
15040,2012-09-23,4,1,9,20,0,0,0,1,0.52,0.5,0.42,0.1642,60,900,192,1920,252,2820
15041,2012-09-23,4,1,9,21,0,0,0,2,0.52,0.5,0.48,0.1045,51,765,145,1450,196,2215
15042,2012-09-23,4,1,9,22,0,0,0,1,0.52,0.5,0.48,0.0,40,600,98,980,138,1580
15043,2012-09-23,4,1,9,23,0,0,0,2,0.5,0.4848,0.59,0.1045,30,450,70,700,100,1150
15044,2012-09-24,4,1,9,0,0,1,1,1,0.46,0.4545,0.63,0.194,10,150,54,540,64,690
15045,2012-09-24,4,1,9,1,0,1,1,1,0.46,0.4545,0.67,0.1343,6,90,12,120,18,210
15046,2012-09-24,4,1,9,2,0,1,1,2,0.46,0.4545,0.63,0.1343,0,0,8,80,8,80
15047,2012-09-24,4,1,9,3,0,1,1,1,0.46,0.4545,0.63,0.1642,0,0,5,50,5,50
15048,2012-09-24,4,1,9,4,0,1,1,1,0.44,0.4394,0.67,0.1045,0,0,8,80,8,80
15049,2012-09-24,4,1,9,5,0,1,1,1,0.46,0.4545,0.63,0.0,2,30,35,350,37,380
15050,2012-09-24,4,1,9,6,0,1,1,1,0.46,0.4545,0.59,0.0,6,90,162,1620,168,1710
15051,2012-09-24,4,1,9,7,0,1,1,1,0.46,0.4545,0.67,0.1343,17,255,513,5130,530,5385
15052,2012-09-24,4,1,9,8,0,1,1,1,0.5,0.4848,0.55,0.194,31,465,719,7190,750,7655
15053,2012-09-24,4,1,9,9,0,1,1,1,0.52,0.5,0.52,0.194,42,630,286,2860,328,3490
15054,2012-09-24,4,1,9,10,0,1,1,1,0.54,0.5152,0.49,0.2239,52,780,146,1460,198,2240
15055,2012-09-24,4,1,9,11,0,1,1,1,0.56,0.5303,0.37,0.194,71,1065,167,1670,238,2735
15056,2012-09-24,4,1,9,12,0,1,1,1,0.56,0.5303,0.35,0.2985,77,1155,265,2650,342,3805
15057,2012-09-24,4,1,9,13,0,1,1,1,0.6,0.6212,0.31,0.2985,80,1200,248,2480,328,3680
15058,2012-09-24,4,1,9,14,0,1,1,1,0.6,0.6061,0.28,0.0,77,1155,226,2260,303,3415
15059,2012-09-24,4,1,9,15,0,1,1,1,0.6,0.6212,0.31,0.0,84,1260,216,2160,300,3420
15060,2012-09-24,4,1,9,16,0,1,1,1,0.58,0.5455,0.3,0.2537,99,1485,417,4170,516,5655
15061,2012-09-24,4,1,9,17,0,1,1,1,0.58,0.5455,0.3,0.0,89,1335,809,8090,898,9425
15062,2012-09-24,4,1,9,18,0,1,1,1,0.54,0.5152,0.37,0.1642,95,1425,758,7580,853,9005
15063,2012-09-24,4,1,9,19,0,1,1,1,0.52,0.5,0.39,0.1343,56,840,534,5340,590,6180
15064,2012-09-24,4,1,9,20,0,1,1,1,0.52,0.5,0.52,0.1045,52,780,380,3800,432,4580
15065,2012-09-24,4,1,9,21,0,1,1,1,0.5,0.4848,0.51,0.1343,26,390,230,2300,256,2690
15066,2012-09-24,4,1,9,22,0,1,1,1,0.5,0.4848,0.51,0.2239,18,270,154,1540,172,1810
15067,2012-09-24,4,1,9,23,0,1,1,1,0.46,0.4545,0.63,0.1343,11,165,83,830,94,995
15068,2012-09-25,4,1,9,0,0,2,1,1,0.46,0.4545,0.67,0.1642,8,120,56,560,64,680
15069,2012-09-25,4,1,9,1,0,2,1,1,0.44,0.4394,0.72,0.1343,2,30,11,110,13,140
15070,2012-09-25,4,1,9,2,0,2,1,1,0.42,0.4242,0.77,0.1343,5,75,9,90,14,165
15071,2012-09-25,4,1,9,3,0,2,1,1,0.42,0.4242,0.71,0.0896,2,30,3,30,5,60
15072,2012-09-25,4,1,9,4,0,2,1,1,0.42,0.4242,0.71,0.1343,2,30,7,70,9,100
15073,2012-09-25,4,1,9,5,0,2,1,1,0.42,0.4242,0.77,0.0896,1,15,46,460,47,475
15074,2012-09-25,4,1,9,6,0,2,1,1,0.44,0.4394,0.77,0.2239,5,75,189,1890,194,1965
15075,2012-09-25,4,1,9,7,0,2,1,1,0.44,0.4394,0.77,0.194,17,255,539,5390,556,5645
15076,2012-09-25,4,1,9,8,0,2,1,1,0.48,0.4697,0.67,0.194,41,615,764,7640,805,8255
15077,2012-09-25,4,1,9,9,0,2,1,1,0.54,0.5152,0.56,0.2537,28,420,381,3810,409,4230
15078,2012-09-25,4,1,9,10,0,2,1,1,0.56,0.5303,0.52,0.2985,45,675,125,1250,170,1925
15079,2012-09-25,4,1,9,11,0,2,1,1,0.6,0.6212,0.46,0.2985,63,945,155,1550,218,2495
15080,2012-09-25,4,1,9,12,0,2,1,1,0.62,0.6212,0.43,0.2836,69,1035,233,2330,302,3365
15081,2012-09-25,4,1,9,13,0,2,1,1,0.64,0.6212,0.47,0.2537,48,720,257,2570,305,3290
15082,2012-09-25,4,1,9,14,0,2,1,1,0.66,0.6212,0.39,0.3284,80,1200,213,2130,293,3330
15083,2012-09-25,4,1,9,15,0,2,1,1,0.66,0.6212,0.36,0.3284,56,840,247,2470,303,3310
15084,2012-09-25,4,1,9,16,0,2,1,1,0.66,0.6212,0.39,0.2985,59,885,436,4360,495,5245
15085,2012-09-25,4,1,9,17,0,2,1,1,0.66,0.6212,0.39,0.2836,107,1605,860,8600,967,10205
15086,2012-09-25,4,1,9,18,0,2,1,1,0.64,0.6212,0.41,0.2239,64,960,758,7580,822,8540
15087,2012-09-25,4,1,9,19,0,2,1,1,0.62,0.6212,0.5,0.2537,49,735,490,4900,539,5635
15088,2012-09-25,4,1,9,20,0,2,1,1,0.6,0.6212,0.56,0.2985,37,555,388,3880,425,4435
15089,2012-09-25,4,1,9,21,0,2,1,1,0.6,0.6212,0.56,0.2985,34,510,263,2630,297,3140
15090,2012-09-25,4,1,9,22,0,2,1,1,0.6,0.6212,0.56,0.2836,14,210,174,1740,188,1950
15091,2012-09-25,4,1,9,23,0,2,1,1,0.6,0.6212,0.56,0.3284,9,135,89,890,98,1025
15092,2012-09-26,4,1,9,0,0,3,1,1,0.58,0.5455,0.64,0.2985,6,90,34,340,40,430
15093,2012-09-26,4,1,9,1,0,3,1,1,0.58,0.5455,0.64,0.3284,10,150,19,190,29,340
15094,2012-09-26,4,1,9,2,0,3,1,2,0.58,0.5455,0.64,0.2836,2,30,15,150,17,180
15095,2012-09-26,4,1,9,3,0,3,1,2,0.58,0.5455,0.64,0.2836,4,60,6,60,10,120
15096,2012-09-26,4,1,9,4,0,3,1,1,0.56,0.5303,0.73,0.2537,2,30,12,120,14,150
15097,2012-09-26,4,1,9,5,0,3,1,1,0.56,0.5303,0.73,0.2239,1,15,35,350,36,365
15098,2012-09-26,4,1,9,6,0,3,1,1,0.54,0.5152,0.73,0.194,3,45,179,1790,182,1835
15099,2012-09-26,4,1,9,7,0,3,1,1,0.54,0.5152,0.77,0.1343,9,135,523,5230,532,5365
15100,2012-09-26,4,1,9,8,0,3,1,1,0.56,0.5303,0.73,0.2985,30,450,808,8080,838,8530
15101,2012-09-26,4,1,9,9,0,3,1,1,0.6,0.6061,0.64,0.194,27,405,307,3070,334,3475
15102,2012-09-26,4,1,9,10,0,3,1,1,0.6,0.5909,0.73,0.2836,29,435,156,1560,185,1995
15103,2012-09-26,4,1,9,11,0,3,1,1,0.64,0.6212,0.61,0.2537,46,690,181,1810,227,2500
15104,2012-09-26,4,1,9,12,0,3,1,1,0.68,0.6364,0.61,0.2239,56,840,260,2600,316,3440
15105,2012-09-26,4,1,9,13,0,3,1,1,0.7,0.6515,0.58,0.2239,67,1005,273,2730,340,3735
15106,2012-09-26,4,1,9,14,0,3,1,1,0.74,0.6667,0.48,0.2836,60,900,217,2170,277,3070
15107,2012-09-26,4,1,9,15,0,3,1,1,0.74,0.6667,0.48,0.2985,69,1035,231,2310,300,3345
15108,2012-09-26,4,1,9,16,0,3,1,1,0.74,0.6667,0.45,0.2836,71,1065,397,3970,468,5035
15109,2012-09-26,4,1,9,17,0,3,1,1,0.74,0.6667,0.48,0.2985,77,1155,876,8760,953,9915
15110,2012-09-26,4,1,9,18,0,3,1,1,0.74,0.6667,0.48,0.2239,69,1035,815,8150,884,9185
15111,2012-09-26,4,1,9,19,0,3,1,1,0.7,0.6515,0.54,0.1642,38,570,589,5890,627,6460
15112,2012-09-26,4,1,9,20,0,3,1,1,0.66,0.6212,0.69,0.194,45,675,389,3890,434,4565
15113,2012-09-26,4,1,9,21,0,3,1,1,0.66,0.6212,0.65,0.194,32,480,328,3280,360,3760
15114,2012-09-26,4,1,9,22,0,3,1,3,0.62,0.6061,0.69,0.194,21,315,194,1940,215,2255
15115,2012-09-26,4,1,9,23,0,3,1,2,0.6,0.5758,0.78,0.2537,13,195,102,1020,115,1215
15116,2012-09-27,4,1,9,0,0,4,1,1,0.6,0.5758,0.78,0.0896,5,75,60,600,65,675
15117,2012-09-27,4,1,9,1,0,4,1,1,0.6,0.5758,0.78,0.0896,5,75,16,160,21,235
15118,2012-09-27,4,1,9,2,0,4,1,1,0.6,0.5758,0.78,0.0896,3,45,13,130,16,175
15119,2012-09-27,4,1,9,3,0,4,1,1,0.6,0.5758,0.78,0.0,0,0,7,70,7,70
15120,2012-09-27,4,1,9,4,0,4,1,1,0.56,0.5303,0.94,0.1343,2,30,6,60,8,90
15121,2012-09-27,4,1,9,5,0,4,1,1,0.58,0.5455,0.83,0.0,2,30,64,640,66,670
15122,2012-09-27,4,1,9,6,0,4,1,1,0.56,0.5303,0.88,0.0896,5,75,164,1640,169,1715
15123,2012-09-27,4,1,9,7,0,4,1,1,0.6,0.5758,0.78,0.0,12,180,546,5460,558,5640
15124,2012-09-27,4,1,9,8,0,4,1,1,0.62,0.6061,0.71,0.0896,20,300,774,7740,794,8040
15125,2012-09-27,4,1,9,9,0,4,1,1,0.66,0.6212,0.65,0.0,30,450,305,3050,335,3500
15126,2012-09-27,4,1,9,10,0,4,1,2,0.7,0.6515,0.51,0.2836,40,600,168,1680,208,2280
15127,2012-09-27,4,1,9,11,0,4,1,2,0.72,0.6667,0.51,0.1642,67,1005,227,2270,294,3275
15128,2012-09-27,4,1,9,12,0,4,1,2,0.74,0.6667,0.48,0.1343,63,945,272,2720,335,3665
15129,2012-09-27,4,1,9,13,0,4,1,2,0.74,0.6667,0.48,0.0,61,915,265,2650,326,3565
15130,2012-09-27,4,1,9,14,0,4,1,2,0.76,0.6818,0.45,0.0896,44,660,214,2140,258,2800
15131,2012-09-27,4,1,9,15,0,4,1,2,0.76,0.6818,0.45,0.0,41,615,255,2550,296,3165
15132,2012-09-27,4,1,9,16,0,4,1,2,0.72,0.6667,0.58,0.3284,73,1095,399,3990,472,5085
15133,2012-09-27,4,1,9,17,0,4,1,2,0.66,0.6212,0.69,0.2985,87,1305,818,8180,905,9485
15134,2012-09-27,4,1,9,18,0,4,1,2,0.66,0.6212,0.69,0.2239,77,1155,822,8220,899,9375
15135,2012-09-27,4,1,9,19,0,4,1,1,0.66,0.6212,0.65,0.1343,48,720,511,5110,559,5830
15136,2012-09-27,4,1,9,20,0,4,1,2,0.64,0.6061,0.69,0.2239,45,675,412,4120,457,4795
15137,2012-09-27,4,1,9,21,0,4,1,3,0.62,0.5758,0.83,0.2985,18,270,235,2350,253,2620
15138,2012-09-27,4,1,9,22,0,4,1,3,0.62,0.5758,0.83,0.2985,2,30,45,450,47,480
15139,2012-09-27,4,1,9,23,0,4,1,3,0.62,0.5758,0.83,0.1642,1,15,44,440,45,455
15140,2012-09-28,4,1,9,0,0,5,1,3,0.6,0.5455,0.88,0.1642,2,30,15,150,17,180
15141,2012-09-28,4,1,9,1,0,5,1,3,0.6,0.5455,0.88,0.0,0,0,13,130,13,130
15142,2012-09-28,4,1,9,2,0,5,1,3,0.6,0.5455,0.88,0.2985,1,15,9,90,10,105
15143,2012-09-28,4,1,9,3,0,5,1,2,0.6,0.5606,0.83,0.1343,0,0,7,70,7,70
15144,2012-09-28,4,1,9,4,0,5,1,3,0.56,0.5303,0.88,0.1045,2,30,10,100,12,130
15145,2012-09-28,4,1,9,5,0,5,1,1,0.56,0.5303,0.88,0.0,1,15,37,370,38,385
15146,2012-09-28,4,1,9,6,0,5,1,2,0.56,0.5303,0.94,0.0896,2,30,136,1360,138,1390
15147,2012-09-28,4,1,9,7,0,5,1,2,0.56,0.5303,0.94,0.0,10,150,384,3840,394,3990
15148,2012-09-28,4,1,9,8,0,5,1,1,0.6,0.5606,0.83,0.0896,31,465,674,6740,705,7205
15149,2012-09-28,4,1,9,9,0,5,1,2,0.62,0.5758,0.83,0.1045,27,405,399,3990,426,4395
15150,2012-09-28,4,1,9,10,0,5,1,2,0.64,0.5909,0.78,0.1343,51,765,194,1940,245,2705
15151,2012-09-28,4,1,9,11,0,5,1,2,0.66,0.6212,0.69,0.0,109,1635,252,2520,361,4155
15152,2012-09-28,4,1,9,12,0,5,1,2,0.7,0.6515,0.54,0.2537,94,1410,286,2860,380,4270
15153,2012-09-28,4,1,9,13,0,5,1,2,0.7,0.6515,0.51,0.2537,106,1590,304,3040,410,4630
15154,2012-09-28,4,1,9,14,0,5,1,2,0.7,0.6515,0.54,0.2537,105,1575,294,2940,399,4515
15155,2012-09-28,4,1,9,15,0,5,1,2,0.68,0.6364,0.54,0.2836,104,1560,288,2880,392,4440
15156,2012-09-28,4,1,9,16,0,5,1,2,0.66,0.6212,0.5,0.2239,83,1245,419,4190,502,5435
15157,2012-09-28,4,1,9,17,0,5,1,2,0.66,0.6212,0.54,0.2985,101,1515,707,7070,808,8585
15158,2012-09-28,4,1,9,18,0,5,1,2,0.64,0.6212,0.5,0.2239,58,870,609,6090,667,6960
15159,2012-09-28,4,1,9,19,0,5,1,3,0.62,0.6212,0.5,0.2537,38,570,470,4700,508,5270
15160,2012-09-28,4,1,9,20,0,5,1,3,0.6,0.6212,0.53,0.1642,32,480,304,3040,336,3520
15161,2012-09-28,4,1,9,21,0,5,1,3,0.6,0.6212,0.53,0.194,32,480,205,2050,237,2530
15162,2012-09-28,4,1,9,22,0,5,1,2,0.58,0.5455,0.53,0.2239,30,450,190,1900,220,2350
15163,2012-09-28,4,1,9,23,0,5,1,2,0.56,0.5303,0.56,0.194,26,390,164,1640,190,2030
15164,2012-09-29,4,1,9,0,0,6,0,1,0.54,0.5152,0.6,0.2239,15,225,134,1340,149,1565
15165,2012-09-29,4,1,9,1,0,6,0,1,0.54,0.5152,0.6,0.2239,12,180,89,890,101,1070
15166,2012-09-29,4,1,9,2,0,6,0,2,0.54,0.5152,0.56,0.2239,12,180,80,800,92,980
15167,2012-09-29,4,1,9,3,0,6,0,2,0.52,0.5,0.59,0.194,4,60,25,250,29,310
15168,2012-09-29,4,1,9,4,0,6,0,1,0.52,0.5,0.59,0.2537,6,90,8,80,14,170
15169,2012-09-29,4,1,9,5,0,6,0,1,0.5,0.4848,0.63,0.194,2,30,13,130,15,160
15170,2012-09-29,4,1,9,6,0,6,0,1,0.5,0.4848,0.63,0.2537,4,60,33,330,37,390
15171,2012-09-29,4,1,9,7,0,6,0,1,0.48,0.4697,0.67,0.2836,12,180,61,610,73,790
15172,2012-09-29,4,1,9,8,0,6,0,1,0.5,0.4848,0.68,0.2836,37,555,174,1740,211,2295
15173,2012-09-29,4,1,9,9,0,6,0,1,0.5,0.4848,0.63,0.194,69,1035,263,2630,332,3665
15174,2012-09-29,4,1,9,10,0,6,0,1,0.54,0.5152,0.56,0.2537,134,2010,338,3380,472,5390
15175,2012-09-29,4,1,9,11,0,6,0,1,0.56,0.5303,0.52,0.2836,217,3255,446,4460,663,7715
15176,2012-09-29,4,1,9,12,0,6,0,1,0.62,0.6212,0.41,0.2985,191,2865,491,4910,682,7775
15177,2012-09-29,4,1,9,13,0,6,0,1,0.62,0.6212,0.41,0.2985,233,3495,453,4530,686,8025
15178,2012-09-29,4,1,9,14,0,6,0,1,0.6,0.6212,0.4,0.2537,302,4530,448,4480,750,9010
15179,2012-09-29,4,1,9,15,0,6,0,1,0.6,0.6212,0.43,0.2537,271,4065,456,4560,727,8625
15180,2012-09-29,4,1,9,16,0,6,0,1,0.62,0.6212,0.41,0.2537,275,4125,447,4470,722,8595
15181,2012-09-29,4,1,9,17,0,6,0,1,0.6,0.6212,0.38,0.3582,256,3840,456,4560,712,8400
15182,2012-09-29,4,1,9,18,0,6,0,1,0.56,0.5303,0.46,0.194,174,2610,420,4200,594,6810
15183,2012-09-29,4,1,9,19,0,6,0,1,0.52,0.5,0.55,0.1642,119,1785,351,3510,470,5295
15184,2012-09-29,4,1,9,20,0,6,0,1,0.52,0.5,0.55,0.194,88,1320,227,2270,315,3590
15185,2012-09-29,4,1,9,21,0,6,0,1,0.52,0.5,0.55,0.1343,73,1095,219,2190,292,3285
15186,2012-09-29,4,1,9,22,0,6,0,1,0.5,0.4848,0.63,0.1045,48,720,173,1730,221,2450
15187,2012-09-29,4,1,9,23,0,6,0,1,0.5,0.4848,0.59,0.0896,35,525,161,1610,196,2135
15188,2012-09-30,4,1,9,0,0,0,0,1,0.5,0.4848,0.59,0.0,35,525,112,1120,147,1645
15189,2012-09-30,4,1,9,1,0,0,0,1,0.5,0.4848,0.59,0.0,31,465,85,850,116,1315
15190,2012-09-30,4,1,9,2,0,0,0,1,0.48,0.4697,0.63,0.0,21,315,71,710,92,1025
15191,2012-09-30,4,1,9,3,0,0,0,1,0.46,0.4545,0.67,0.0896,17,255,41,410,58,665
15192,2012-09-30,4,1,9,4,0,0,0,1,0.46,0.4545,0.67,0.0896,1,15,6,60,7,75
15193,2012-09-30,4,1,9,5,0,0,0,1,0.44,0.4394,0.72,0.0,1,15,9,90,10,105
15194,2012-09-30,4,1,9,6,0,0,0,1,0.44,0.4394,0.72,0.0896,2,30,20,200,22,230
15195,2012-09-30,4,1,9,7,0,0,0,1,0.44,0.4394,0.77,0.0,14,210,43,430,57,640
15196,2012-09-30,4,1,9,8,0,0,0,1,0.48,0.4697,0.67,0.1045,18,270,126,1260,144,1530
15197,2012-09-30,4,1,9,9,0,0,0,1,0.52,0.5,0.63,0.1045,74,1110,211,2110,285,3220
15198,2012-09-30,4,1,9,10,0,0,0,1,0.58,0.5455,0.46,0.1642,160,2400,319,3190,479,5590
15199,2012-09-30,4,1,9,11,0,0,0,1,0.6,0.6212,0.43,0.2239,222,3330,369,3690,591,7020
15200,2012-09-30,4,1,9,12,0,0,0,1,0.62,0.6212,0.41,0.2985,206,3090,474,4740,680,7830
15201,2012-09-30,4,1,9,13,0,0,0,1,0.62,0.6212,0.41,0.2537,180,2700,414,4140,594,6840
15202,2012-09-30,4,1,9,14,0,0,0,1,0.62,0.6212,0.41,0.2537,208,3120,404,4040,612,7160
15203,2012-09-30,4,1,9,15,0,0,0,1,0.64,0.6212,0.36,0.2537,230,3450,419,4190,649,7640
15204,2012-09-30,4,1,9,16,0,0,0,1,0.64,0.6212,0.36,0.2239,202,3030,446,4460,648,7490
15205,2012-09-30,4,1,9,17,0,0,0,1,0.62,0.6212,0.35,0.2836,195,2925,380,3800,575,6725
15206,2012-09-30,4,1,9,18,0,0,0,1,0.52,0.5,0.59,0.4478,91,1365,310,3100,401,4465
15207,2012-09-30,4,1,9,19,0,0,0,3,0.5,0.4848,0.72,0.1343,34,510,223,2230,257,2740
15208,2012-09-30,4,1,9,20,0,0,0,3,0.5,0.4848,0.72,0.1343,31,465,163,1630,194,2095
15209,2012-09-30,4,1,9,21,0,0,0,1,0.5,0.4848,0.68,0.0,19,285,104,1040,123,1325
15210,2012-09-30,4,1,9,22,0,0,0,1,0.48,0.4697,0.72,0.0,15,225,76,760,91,985
15211,2012-09-30,4,1,9,23,0,0,0,1,0.48,0.4697,0.72,0.0896,8,120,49,490,57,610
15212,2012-10-01,4,1,10,0,0,1,1,1,0.46,0.4545,0.72,0.1045,6,90,39,390,45,480
15213,2012-10-01,4,1,10,1,0,1,1,1,0.44,0.4394,0.77,0.0896,5,75,13,130,18,205
15214,2012-10-01,4,1,10,2,0,1,1,1,0.46,0.4545,0.72,0.0,6,90,6,60,12,150
15215,2012-10-01,4,1,10,3,0,1,1,1,0.44,0.4394,0.77,0.0,1,15,6,60,7,75
15216,2012-10-01,4,1,10,4,0,1,1,1,0.42,0.4242,0.82,0.1045,0,0,10,100,10,100
15217,2012-10-01,4,1,10,5,0,1,1,1,0.44,0.4394,0.77,0.0,2,30,34,340,36,370
15218,2012-10-01,4,1,10,6,0,1,1,1,0.44,0.4394,0.77,0.1045,8,120,147,1470,155,1590
15219,2012-10-01,4,1,10,7,0,1,1,1,0.44,0.4394,0.77,0.1642,13,195,470,4700,483,4895
15220,2012-10-01,4,1,10,8,0,1,1,2,0.46,0.4545,0.77,0.1045,40,600,744,7440,784,8040
15221,2012-10-01,4,1,10,9,0,1,1,2,0.52,0.5,0.63,0.0,26,390,314,3140,340,3530
15222,2012-10-01,4,1,10,10,0,1,1,1,0.54,0.5152,0.56,0.0,44,660,135,1350,179,2010
15223,2012-10-01,4,1,10,11,0,1,1,1,0.58,0.5455,0.46,0.0,76,1140,196,1960,272,3100
15224,2012-10-01,4,1,10,12,0,1,1,2,0.6,0.6212,0.43,0.1642,61,915,262,2620,323,3535
15225,2012-10-01,4,1,10,13,0,1,1,2,0.6,0.6212,0.43,0.1642,80,1200,225,2250,305,3450
15226,2012-10-01,4,1,10,14,0,1,1,2,0.6,0.6212,0.43,0.1045,51,765,193,1930,244,2695
15227,2012-10-01,4,1,10,15,0,1,1,2,0.62,0.6212,0.43,0.1343,95,1425,234,2340,329,3765
15228,2012-10-01,4,1,10,16,0,1,1,2,0.62,0.6212,0.46,0.2537,51,765,408,4080,459,4845
15229,2012-10-01,4,1,10,17,0,1,1,3,0.56,0.5303,0.6,0.2537,65,975,791,7910,856,8885
15230,2012-10-01,4,1,10,18,0,1,1,3,0.56,0.5303,0.64,0.1045,42,630,571,5710,613,6340
15231,2012-10-01,4,1,10,19,0,1,1,2,0.54,0.5152,0.68,0.1045,33,495,483,4830,516,5325
15232,2012-10-01,4,1,10,20,0,1,1,3,0.54,0.5152,0.68,0.0,11,165,251,2510,262,2675
15233,2012-10-01,4,1,10,21,0,1,1,2,0.54,0.5152,0.73,0.1343,13,195,205,2050,218,2245
15234,2012-10-01,4,1,10,22,0,1,1,3,0.54,0.5152,0.77,0.0896,17,255,190,1900,207,2155
15235,2012-10-01,4,1,10,23,0,1,1,3,0.54,0.5152,0.77,0.0,17,255,88,880,105,1135
15236,2012-10-02,4,1,10,0,0,2,1,2,0.56,0.5303,0.73,0.0,1,15,30,300,31,315
15237,2012-10-02,4,1,10,1,0,2,1,2,0.54,0.5152,0.77,0.1045,0,0,11,110,11,110
15238,2012-10-02,4,1,10,2,0,2,1,2,0.54,0.5152,0.77,0.1045,0,0,2,20,2,20
15239,2012-10-02,4,1,10,3,0,2,1,2,0.54,0.5152,0.88,0.194,1,15,4,40,5,55
15240,2012-10-02,4,1,10,4,0,2,1,2,0.56,0.5303,0.83,0.0896,2,30,8,80,10,110
15241,2012-10-02,4,1,10,5,0,2,1,2,0.56,0.5303,0.83,0.1343,1,15,42,420,43,435
15242,2012-10-02,4,1,10,6,0,2,1,3,0.58,0.5455,0.83,0.1045,3,45,176,1760,179,1805
15243,2012-10-02,4,1,10,7,0,2,1,3,0.58,0.5455,0.83,0.1045,4,60,256,2560,260,2620
15244,2012-10-02,4,1,10,8,0,2,1,3,0.6,0.5455,0.88,0.0,6,90,128,1280,134,1370
15245,2012-10-02,4,1,10,9,0,2,1,3,0.58,0.5455,0.88,0.1343,3,45,83,830,86,875
15246,2012-10-02,4,1,10,10,0,2,1,3,0.58,0.5455,0.88,0.1343,3,45,42,420,45,465
15247,2012-10-02,4,1,10,11,0,2,1,3,0.58,0.5455,0.94,0.1343,7,105,92,920,99,1025
15248,2012-10-02,4,1,10,12,0,2,1,2,0.6,0.5455,0.88,0.194,6,90,98,980,104,1070
15249,2012-10-02,4,1,10,13,0,2,1,2,0.6,0.5455,0.88,0.1343,6,90,148,1480,154,1570
15250,2012-10-02,4,1,10,14,0,2,1,3,0.6,0.5455,0.88,0.1343,16,240,147,1470,163,1710
15251,2012-10-02,4,1,10,15,0,2,1,3,0.62,0.5758,0.83,0.1343,14,210,195,1950,209,2160
15252,2012-10-02,4,1,10,16,0,2,1,3,0.62,0.5606,0.88,0.1343,46,690,328,3280,374,3970
15253,2012-10-02,4,1,10,17,0,2,1,3,0.62,0.5606,0.88,0.1045,38,570,677,6770,715,7340
15254,2012-10-02,4,1,10,18,0,2,1,3,0.62,0.5455,0.94,0.0896,48,720,639,6390,687,7110
15255,2012-10-02,4,1,10,19,0,2,1,3,0.62,0.5455,0.94,0.0,27,405,368,3680,395,4085
15256,2012-10-02,4,1,10,20,0,2,1,3,0.62,0.5455,0.94,0.1343,20,300,286,2860,306,3160
15257,2012-10-02,4,1,10,21,0,2,1,3,0.62,0.5455,0.94,0.1045,24,360,265,2650,289,3010
15258,2012-10-02,4,1,10,22,0,2,1,2,0.62,0.5455,0.94,0.1045,28,420,212,2120,240,2540
15259,2012-10-02,4,1,10,23,0,2,1,2,0.62,0.5455,0.94,0.0,11,165,87,870,98,1035
15260,2012-10-03,4,1,10,0,0,3,1,3,0.62,0.5455,0.94,0.0,5,75,47,470,52,545
15261,2012-10-03,4,1,10,1,0,3,1,2,0.62,0.5455,0.94,0.0,3,45,16,160,19,205
15262,2012-10-03,4,1,10,2,0,3,1,2,0.62,0.5455,0.94,0.0,2,30,7,70,9,100
15263,2012-10-03,4,1,10,3,0,3,1,2,0.6,0.5152,0.94,0.0,0,0,7,70,7,70
15264,2012-10-03,4,1,10,4,0,3,1,2,0.6,0.5,1.0,0.0,2,30,9,90,11,120
15265,2012-10-03,4,1,10,5,0,3,1,2,0.62,0.5455,0.94,0.1045,2,30,32,320,34,350
15266,2012-10-03,4,1,10,6,0,3,1,2,0.6,0.5152,0.94,0.1343,4,60,173,1730,177,1790
15267,2012-10-03,4,1,10,7,0,3,1,2,0.6,0.5152,0.94,0.194,11,165,504,5040,515,5205
15268,2012-10-03,4,1,10,8,0,3,1,2,0.62,0.5606,0.88,0.1045,28,420,781,7810,809,8230
15269,2012-10-03,4,1,10,9,0,3,1,2,0.62,0.5758,0.83,0.194,30,450,332,3320,362,3770
15270,2012-10-03,4,1,10,10,0,3,1,1,0.66,0.6061,0.78,0.1642,29,435,146,1460,175,1895
15271,2012-10-03,4,1,10,11,0,3,1,1,0.66,0.6061,0.78,0.1642,52,780,178,1780,230,2560
15272,2012-10-03,4,1,10,12,0,3,1,2,0.7,0.6515,0.7,0.1045,69,1035,289,2890,358,3925
15273,2012-10-03,4,1,10,13,0,3,1,2,0.7,0.6667,0.74,0.1045,55,825,224,2240,279,3065
15274,2012-10-03,4,1,10,14,0,3,1,2,0.72,0.6818,0.7,0.1642,56,840,195,1950,251,2790
15275,2012-10-03,4,1,10,15,0,3,1,2,0.72,0.6818,0.62,0.1642,59,885,260,2600,319,3485
15276,2012-10-03,4,1,10,16,0,3,1,2,0.72,0.6667,0.58,0.0,42,630,436,4360,478,4990
15277,2012-10-03,4,1,10,17,0,3,1,1,0.7,0.6515,0.65,0.0,84,1260,833,8330,917,9590
15278,2012-10-03,4,1,10,18,0,3,1,1,0.7,0.6515,0.65,0.0,54,810,756,7560,810,8370
15279,2012-10-03,4,1,10,19,0,3,1,1,0.7,0.6515,0.65,0.0,49,735,544,5440,593,6175
15280,2012-10-03,4,1,10,20,0,3,1,1,0.7,0.6515,0.65,0.0,48,720,449,4490,497,5210
15281,2012-10-03,4,1,10,21,0,3,1,2,0.66,0.6212,0.74,0.0,14,210,195,1950,209,2160
15282,2012-10-03,4,1,10,22,0,3,1,1,0.66,0.6212,0.74,0.0,9,135,232,2320,241,2455
15283,2012-10-03,4,1,10,23,0,3,1,2,0.66,0.6061,0.78,0.0,21,315,199,1990,220,2305
15284,2012-10-04,4,1,10,0,0,4,1,3,0.64,0.5758,0.89,0.0,11,165,65,650,76,815
15285,2012-10-04,4,1,10,1,0,4,1,2,0.62,0.5455,0.94,0.0,2,30,23,230,25,260
15286,2012-10-04,4,1,10,2,0,4,1,1,0.64,0.5758,0.89,0.0,3,45,10,100,13,145
15287,2012-10-04,4,1,10,3,0,4,1,2,0.62,0.5606,0.88,0.0,5,75,6,60,11,135
15288,2012-10-04,4,1,10,4,0,4,1,2,0.64,0.5758,0.89,0.0,0,0,10,100,10,100
15289,2012-10-04,4,1,10,5,0,4,1,3,0.64,0.5758,0.89,0.1045,2,30,37,370,39,400
15290,2012-10-04,4,1,10,6,0,4,1,3,0.62,0.5455,0.94,0.0896,1,15,132,1320,133,1335
15291,2012-10-04,4,1,10,7,0,4,1,2,0.64,0.5758,0.89,0.0896,12,180,379,3790,391,3970
15292,2012-10-04,4,1,10,8,0,4,1,1,0.64,0.5758,0.89,0.0,27,405,711,7110,738,7515
15293,2012-10-04,4,1,10,9,0,4,1,2,0.64,0.5758,0.89,0.194,40,600,319,3190,359,3790
15294,2012-10-04,4,1,10,10,0,4,1,2,0.66,0.6061,0.83,0.1343,27,405,150,1500,177,1905
15295,2012-10-04,4,1,10,11,0,4,1,2,0.7,0.6515,0.7,0.1045,38,570,176,1760,214,2330
15296,2012-10-04,4,1,10,12,0,4,1,2,0.72,0.6667,0.54,0.194,57,855,231,2310,288,3165
15297,2012-10-04,4,1,10,13,0,4,1,2,0.72,0.6667,0.58,0.3284,63,945,231,2310,294,3255
15298,2012-10-04,4,1,10,14,0,4,1,1,0.7,0.6515,0.61,0.2537,56,840,211,2110,267,2950
15299,2012-10-04,4,1,10,15,0,4,1,1,0.72,0.6667,0.54,0.2836,77,1155,248,2480,325,3635
15300,2012-10-04,4,1,10,16,0,4,1,1,0.7,0.6515,0.54,0.2836,86,1290,411,4110,497,5400
15301,2012-10-04,4,1,10,17,0,4,1,1,0.7,0.6515,0.51,0.2239,112,1680,789,7890,901,9570
15302,2012-10-04,4,1,10,18,0,4,1,1,0.66,0.6212,0.57,0.1045,75,1125,812,8120,887,9245
15303,2012-10-04,4,1,10,19,0,4,1,1,0.66,0.6212,0.57,0.1045,67,1005,467,4670,534,5675
15304,2012-10-04,4,1,10,20,0,4,1,1,0.64,0.6061,0.65,0.1045,50,750,391,3910,441,4660
15305,2012-10-04,4,1,10,21,0,4,1,1,0.62,0.6061,0.69,0.0,33,495,288,2880,321,3375
15306,2012-10-04,4,1,10,22,0,4,1,1,0.64,0.6212,0.47,0.1343,29,435,203,2030,232,2465
15307,2012-10-04,4,1,10,23,0,4,1,1,0.6,0.6212,0.56,0.0896,18,270,137,1370,155,1640
15308,2012-10-05,4,1,10,0,0,5,1,1,0.56,0.5303,0.73,0.0,16,240,86,860,102,1100
15309,2012-10-05,4,1,10,1,0,5,1,1,0.54,0.5152,0.68,0.1045,3,45,43,430,46,475
15310,2012-10-05,4,1,10,2,0,5,1,1,0.54,0.5152,0.73,0.0896,1,15,10,100,11,115
15311,2012-10-05,4,1,10,3,0,5,1,1,0.54,0.5152,0.73,0.0,5,75,11,110,16,185
15312,2012-10-05,4,1,10,4,0,5,1,1,0.54,0.5152,0.77,0.0,0,0,11,110,11,110
15313,2012-10-05,4,1,10,5,0,5,1,1,0.52,0.5,0.77,0.0,0,0,41,410,41,410
15314,2012-10-05,4,1,10,6,0,5,1,1,0.52,0.5,0.83,0.0,4,60,133,1330,137,1390
15315,2012-10-05,4,1,10,7,0,5,1,1,0.52,0.5,0.83,0.1045,11,165,417,4170,428,4335
15316,2012-10-05,4,1,10,8,0,5,1,1,0.58,0.5455,0.64,0.0,36,540,749,7490,785,8030
15317,2012-10-05,4,1,10,9,0,5,1,1,0.6,0.6061,0.6,0.0896,58,870,326,3260,384,4130
15318,2012-10-05,4,1,10,10,0,5,1,1,0.66,0.6212,0.54,0.0,68,1020,192,1920,260,2940
15319,2012-10-05,4,1,10,11,0,5,1,1,0.7,0.6515,0.48,0.194,90,1350,214,2140,304,3490
15320,2012-10-05,4,1,10,12,0,5,1,1,0.72,0.6515,0.42,0.1642,161,2415,307,3070,468,5485
15321,2012-10-05,4,1,10,13,0,5,1,1,0.7,0.6515,0.48,0.0,117,1755,307,3070,424,4825
15322,2012-10-05,4,1,10,14,0,5,1,1,0.74,0.6515,0.37,0.2239,113,1695,287,2870,400,4565
15323,2012-10-05,4,1,10,15,0,5,1,1,0.72,0.6515,0.39,0.2537,150,2250,320,3200,470,5450
15324,2012-10-05,4,1,10,16,0,5,1,1,0.72,0.6515,0.37,0.0,153,2295,481,4810,634,7105
15325,2012-10-05,4,1,10,17,0,5,1,1,0.7,0.6364,0.42,0.1642,158,2370,742,7420,900,9790
15326,2012-10-05,4,1,10,18,0,5,1,1,0.64,0.6212,0.57,0.1343,106,1590,655,6550,761,8140
15327,2012-10-05,4,1,10,19,0,5,1,1,0.62,0.5909,0.73,0.1642,67,1005,433,4330,500,5335
15328,2012-10-05,4,1,10,20,0,5,1,1,0.6,0.5758,0.78,0.1343,66,990,306,3060,372,4050
15329,2012-10-05,4,1,10,21,0,5,1,1,0.6,0.5909,0.69,0.2239,47,705,220,2200,267,2905
15330,2012-10-05,4,1,10,22,0,5,1,1,0.6,0.5909,0.73,0.2836,63,945,201,2010,264,2955
15331,2012-10-05,4,1,10,23,0,5,1,1,0.58,0.5455,0.78,0.2239,23,345,148,1480,171,1825
15332,2012-10-06,4,1,10,0,0,6,0,1,0.56,0.5303,0.83,0.1642,37,555,154,1540,191,2095
15333,2012-10-06,4,1,10,1,0,6,0,1,0.56,0.5303,0.83,0.2537,25,375,116,1160,141,1535
15334,2012-10-06,4,1,10,2,0,6,0,1,0.56,0.5303,0.78,0.194,13,195,62,620,75,815
15335,2012-10-06,4,1,10,3,0,6,0,1,0.54,0.5152,0.77,0.2239,2,30,54,540,56,570
15336,2012-10-06,4,1,10,4,0,6,0,1,0.54,0.5152,0.83,0.2537,4,60,7,70,11,130
15337,2012-10-06,4,1,10,5,0,6,0,1,0.54,0.5152,0.83,0.194,2,30,8,80,10,110
15338,2012-10-06,4,1,10,6,0,6,0,1,0.54,0.5152,0.88,0.2537,2,30,28,280,30,310
15339,2012-10-06,4,1,10,7,0,6,0,1,0.54,0.5152,0.83,0.2985,13,195,71,710,84,905
15340,2012-10-06,4,1,10,8,0,6,0,1,0.56,0.5303,0.83,0.194,22,330,184,1840,206,2170
15341,2012-10-06,4,1,10,9,0,6,0,1,0.6,0.5909,0.73,0.194,130,1950,265,2650,395,4600
15342,2012-10-06,4,1,10,10,0,6,0,1,0.62,0.6061,0.69,0.2836,198,2970,341,3410,539,6380
15343,2012-10-06,4,1,10,11,0,6,0,1,0.64,0.6061,0.65,0.2537,258,3870,389,3890,647,7760
15344,2012-10-06,4,1,10,12,0,6,0,1,0.7,0.6515,0.54,0.1045,362,5430,381,3810,743,9240
15345,2012-10-06,4,1,10,13,0,6,0,2,0.64,0.6212,0.57,0.5224,310,4650,400,4000,710,8650
15346,2012-10-06,4,1,10,14,0,6,0,2,0.6,0.6212,0.56,0.4179,269,4035,307,3070,576,7105
15347,2012-10-06,4,1,10,15,0,6,0,1,0.6,0.6212,0.46,0.4179,279,4185,341,3410,620,7595
15348,2012-10-06,4,1,10,16,0,6,0,1,0.6,0.6212,0.43,0.5224,317,4755,342,3420,659,8175
15349,2012-10-06,4,1,10,17,0,6,0,1,0.54,0.5152,0.49,0.3881,268,4020,342,3420,610,7440
15350,2012-10-06,4,1,10,18,0,6,0,1,0.52,0.5,0.48,0.4179,183,2745,312,3120,495,5865
15351,2012-10-06,4,1,10,19,0,6,0,1,0.48,0.4697,0.55,0.2239,102,1530,239,2390,341,3920
15352,2012-10-06,4,1,10,20,0,6,0,1,0.48,0.4697,0.55,0.2537,75,1125,172,1720,247,2845
15353,2012-10-06,4,1,10,21,0,6,0,1,0.46,0.4545,0.59,0.1343,78,1170,137,1370,215,2540
15354,2012-10-06,4,1,10,22,0,6,0,1,0.44,0.4394,0.62,0.1343,45,675,140,1400,185,2075
15355,2012-10-06,4,1,10,23,0,6,0,1,0.44,0.4394,0.62,0.1343,37,555,142,1420,179,1975
15356,2012-10-07,4,1,10,0,0,0,0,1,0.44,0.4394,0.62,0.1642,28,420,99,990,127,1410
15357,2012-10-07,4,1,10,1,0,0,0,1,0.44,0.4394,0.54,0.2239,29,435,80,800,109,1235
15358,2012-10-07,4,1,10,2,0,0,0,1,0.42,0.4242,0.62,0.1343,10,150,64,640,74,790
15359,2012-10-07,4,1,10,3,0,0,0,2,0.44,0.4394,0.62,0.1343,5,75,17,170,22,245
15360,2012-10-07,4,1,10,4,0,0,0,2,0.44,0.4394,0.54,0.2537,5,75,6,60,11,135
15361,2012-10-07,4,1,10,5,0,0,0,2,0.44,0.4394,0.54,0.1343,2,30,8,80,10,110
15362,2012-10-07,4,1,10,6,0,0,0,2,0.44,0.4394,0.54,0.194,4,60,19,190,23,250
15363,2012-10-07,4,1,10,7,0,0,0,3,0.42,0.4242,0.58,0.1642,6,90,29,290,35,380
15364,2012-10-07,4,1,10,8,0,0,0,3,0.42,0.4242,0.67,0.1343,11,165,51,510,62,675
15365,2012-10-07,4,1,10,9,0,0,0,3,0.4,0.4091,0.71,0.1343,16,240,70,700,86,940
15366,2012-10-07,4,1,10,10,0,0,0,2,0.42,0.4242,0.67,0.194,41,615,144,1440,185,2055
15367,2012-10-07,4,1,10,11,0,0,0,2,0.42,0.4242,0.71,0.1045,76,1140,260,2600,336,3740
15368,2012-10-07,4,1,10,12,0,0,0,2,0.42,0.4242,0.71,0.0,100,1500,292,2920,392,4420
15369,2012-10-07,4,1,10,13,0,0,0,2,0.44,0.4394,0.72,0.0896,80,1200,240,2400,320,3600
15370,2012-10-07,4,1,10,14,0,0,0,2,0.44,0.4394,0.67,0.0,71,1065,243,2430,314,3495
15371,2012-10-07,4,1,10,15,0,0,0,3,0.42,0.4242,0.77,0.1343,74,1110,232,2320,306,3430
15372,2012-10-07,4,1,10,16,0,0,0,3,0.4,0.4091,0.82,0.1642,87,1305,246,2460,333,3765
15373,2012-10-07,4,1,10,17,0,0,0,3,0.4,0.4091,0.82,0.2239,35,525,122,1220,157,1745
15374,2012-10-07,4,1,10,18,0,0,0,3,0.4,0.4091,0.82,0.194,24,360,82,820,106,1180
15375,2012-10-07,4,1,10,19,0,0,0,2,0.4,0.4091,0.82,0.1045,17,255,97,970,114,1225
15376,2012-10-07,4,1,10,20,0,0,0,1,0.4,0.4091,0.82,0.1343,19,285,97,970,116,1255
15377,2012-10-07,4,1,10,21,0,0,0,1,0.38,0.3939,0.87,0.1045,22,330,91,910,113,1240
15378,2012-10-07,4,1,10,22,0,0,0,1,0.38,0.3939,0.87,0.1343,7,105,72,720,79,825
15379,2012-10-07,4,1,10,23,0,0,0,1,0.36,0.3485,0.93,0.1343,12,180,68,680,80,860
15380,2012-10-08,4,1,10,0,1,1,0,1,0.38,0.3939,0.76,0.2836,7,105,44,440,51,545
15381,2012-10-08,4,1,10,1,1,1,0,1,0.34,0.3333,0.87,0.1642,2,30,35,350,37,380
15382,2012-10-08,4,1,10,2,1,1,0,1,0.34,0.3333,0.81,0.194,3,45,12,120,15,165
15383,2012-10-08,4,1,10,3,1,1,0,1,0.34,0.3485,0.81,0.1045,2,30,8,80,10,110
15384,2012-10-08,4,1,10,4,1,1,0,1,0.32,0.3333,0.87,0.1343,1,15,6,60,7,75
15385,2012-10-08,4,1,10,5,1,1,0,1,0.34,0.3182,0.76,0.2239,2,30,17,170,19,200
15386,2012-10-08,4,1,10,6,1,1,0,1,0.34,0.3485,0.76,0.1045,5,75,54,540,59,615
15387,2012-10-08,4,1,10,7,1,1,0,2,0.34,0.3333,0.76,0.1642,3,45,151,1510,154,1555
15388,2012-10-08,4,1,10,8,1,1,0,2,0.36,0.3485,0.71,0.2239,23,345,374,3740,397,4085
15389,2012-10-08,4,1,10,9,1,1,0,2,0.38,0.3939,0.66,0.1642,59,885,273,2730,332,3615
15390,2012-10-08,4,1,10,10,1,1,0,2,0.38,0.3939,0.68,0.1343,69,1035,229,2290,298,3325
15391,2012-10-08,4,1,10,11,1,1,0,2,0.4,0.4091,0.62,0.0896,72,1080,236,2360,308,3440
15392,2012-10-08,4,1,10,12,1,1,0,2,0.42,0.4242,0.63,0.1642,74,1110,267,2670,341,3780
15393,2012-10-08,4,1,10,13,1,1,0,2,0.42,0.4242,0.62,0.194,82,1230,323,3230,405,4460
15394,2012-10-08,4,1,10,14,1,1,0,2,0.42,0.4242,0.58,0.1045,121,1815,299,2990,420,4805
15395,2012-10-08,4,1,10,15,1,1,0,3,0.42,0.4242,0.58,0.194,76,1140,294,2940,370,4080
15396,2012-10-08,4,1,10,16,1,1,0,3,0.42,0.4242,0.58,0.194,61,915,316,3160,377,4075
15397,2012-10-08,4,1,10,17,1,1,0,2,0.42,0.4242,0.66,0.2537,81,1215,416,4160,497,5375
15398,2012-10-08,4,1,10,18,1,1,0,2,0.42,0.4242,0.66,0.2836,41,615,415,4150,456,4765
15399,2012-10-08,4,1,10,19,1,1,0,2,0.4,0.4091,0.71,0.2537,38,570,333,3330,371,3900
15400,2012-10-08,4,1,10,20,1,1,0,3,0.4,0.4091,0.71,0.2239,20,300,207,2070,227,2370
15401,2012-10-08,4,1,10,21,1,1,0,2,0.4,0.4091,0.76,0.2239,17,255,134,1340,151,1595
15402,2012-10-08,4,1,10,22,1,1,0,3,0.4,0.4091,0.76,0.2537,6,90,101,1010,107,1100
15403,2012-10-08,4,1,10,23,1,1,0,2,0.4,0.4091,0.71,0.2239,9,135,60,600,69,735
15404,2012-10-09,4,1,10,0,0,2,1,2,0.38,0.3939,0.82,0.2239,9,135,22,220,31,355
15405,2012-10-09,4,1,10,1,0,2,1,3,0.36,0.3485,0.87,0.2239,0,0,13,130,13,130
15406,2012-10-09,4,1,10,2,0,2,1,3,0.36,0.3333,0.87,0.2537,2,30,5,50,7,80
15407,2012-10-09,4,1,10,3,0,2,1,3,0.36,0.3333,0.87,0.2836,0,0,3,30,3,30
15408,2012-10-09,4,1,10,4,0,2,1,3,0.36,0.3485,0.87,0.1642,1,15,6,60,7,75
15409,2012-10-09,4,1,10,5,0,2,1,2,0.38,0.3939,0.82,0.194,0,0,19,190,19,190
15410,2012-10-09,4,1,10,6,0,2,1,2,0.38,0.3939,0.82,0.2537,2,30,141,1410,143,1440
15411,2012-10-09,4,1,10,7,0,2,1,1,0.38,0.3939,0.83,0.2537,5,75,357,3570,362,3645
15412,2012-10-09,4,1,10,8,0,2,1,2,0.42,0.4242,0.8,0.194,15,225,698,6980,713,7205
15413,2012-10-09,4,1,10,9,0,2,1,2,0.42,0.4242,0.77,0.2239,37,555,345,3450,382,4005
15414,2012-10-09,4,1,10,10,0,2,1,2,0.44,0.4394,0.75,0.2239,33,495,131,1310,164,1805
15415,2012-10-09,4,1,10,11,0,2,1,2,0.48,0.4697,0.69,0.194,37,555,156,1560,193,2115
15416,2012-10-09,4,1,10,12,0,2,1,2,0.48,0.4697,0.69,0.194,43,645,217,2170,260,2815
15417,2012-10-09,4,1,10,13,0,2,1,2,0.5,0.4848,0.67,0.1343,54,810,184,1840,238,2650
15418,2012-10-09,4,1,10,14,0,2,1,2,0.54,0.5152,0.64,0.194,43,645,201,2010,244,2655
15419,2012-10-09,4,1,10,15,0,2,1,2,0.52,0.5,0.63,0.1642,59,885,195,1950,254,2835
15420,2012-10-09,4,1,10,16,0,2,1,2,0.5,0.4848,0.72,0.1642,70,1050,354,3540,424,4590
15421,2012-10-09,4,1,10,17,0,2,1,2,0.52,0.5,0.68,0.1642,73,1095,733,7330,806,8425
15422,2012-10-09,4,1,10,18,0,2,1,2,0.5,0.4848,0.72,0.2239,26,390,758,7580,784,7970
15423,2012-10-09,4,1,10,19,0,2,1,2,0.5,0.4848,0.72,0.1642,31,465,483,4830,514,5295
15424,2012-10-09,4,1,10,20,0,2,1,2,0.5,0.4848,0.72,0.1642,30,450,330,3300,360,3750
15425,2012-10-09,4,1,10,21,0,2,1,2,0.48,0.4697,0.77,0.1343,16,240,209,2090,225,2330
15426,2012-10-09,4,1,10,22,0,2,1,2,0.48,0.4697,0.77,0.0896,7,105,155,1550,162,1655
15427,2012-10-09,4,1,10,23,0,2,1,2,0.48,0.4697,0.77,0.0896,8,120,76,760,84,880
15428,2012-10-10,4,1,10,0,0,3,1,2,0.46,0.4545,0.88,0.0896,0,0,33,330,33,330
15429,2012-10-10,4,1,10,1,0,3,1,2,0.46,0.4545,0.88,0.0,2,30,6,60,8,90
15430,2012-10-10,4,1,10,2,0,3,1,2,0.46,0.4545,0.88,0.0,2,30,6,60,8,90
15431,2012-10-10,4,1,10,3,0,3,1,2,0.46,0.4545,0.88,0.0,0,0,6,60,6,60
15432,2012-10-10,4,1,10,4,0,3,1,2,0.46,0.4545,0.88,0.1045,0,0,6,60,6,60
15433,2012-10-10,4,1,10,5,0,3,1,2,0.46,0.4545,0.88,0.0896,2,30,38,380,40,410
15434,2012-10-10,4,1,10,6,0,3,1,2,0.46,0.4545,0.88,0.0896,3,45,172,1720,175,1765
15435,2012-10-10,4,1,10,7,0,3,1,1,0.46,0.4545,0.82,0.1045,9,135,498,4980,507,5115
15436,2012-10-10,4,1,10,8,0,3,1,1,0.5,0.4848,0.77,0.1642,33,495,806,8060,839,8555
15437,2012-10-10,4,1,10,9,0,3,1,1,0.54,0.5152,0.6,0.2836,35,525,331,3310,366,3835
15438,2012-10-10,4,1,10,10,0,3,1,1,0.56,0.5303,0.52,0.2985,27,405,190,1900,217,2305
15439,2012-10-10,4,1,10,11,0,3,1,1,0.54,0.5152,0.52,0.194,53,795,238,2380,291,3175
15440,2012-10-10,4,1,10,12,0,3,1,1,0.54,0.5152,0.56,0.2239,78,1170,312,3120,390,4290
15441,2012-10-10,4,1,10,13,0,3,1,1,0.56,0.5303,0.49,0.0,60,900,237,2370,297,3270
15442,2012-10-10,4,1,10,14,0,3,1,1,0.6,0.6212,0.4,0.1642,63,945,208,2080,271,3025
15443,2012-10-10,4,1,10,15,0,3,1,1,0.6,0.6212,0.4,0.1642,58,870,261,2610,319,3480
15444,2012-10-10,4,1,10,16,0,3,1,1,0.6,0.6212,0.4,0.2239,92,1380,474,4740,566,6120
15445,2012-10-10,4,1,10,17,0,3,1,1,0.58,0.5455,0.43,0.2239,91,1365,857,8570,948,9935
15446,2012-10-10,4,1,10,18,0,3,1,2,0.56,0.5303,0.49,0.1642,57,855,787,7870,844,8725
15447,2012-10-10,4,1,10,19,0,3,1,2,0.56,0.5303,0.46,0.5821,32,480,534,5340,566,5820
15448,2012-10-10,4,1,10,20,0,3,1,1,0.52,0.5,0.48,0.4925,21,315,371,3710,392,4025
15449,2012-10-10,4,1,10,21,0,3,1,1,0.5,0.4848,0.51,0.3582,18,270,251,2510,269,2780
15450,2012-10-10,4,1,10,22,0,3,1,1,0.46,0.4545,0.55,0.2985,27,405,170,1700,197,2105
15451,2012-10-10,4,1,10,23,0,3,1,1,0.44,0.4394,0.58,0.194,17,255,119,1190,136,1445
15452,2012-10-11,4,1,10,0,0,4,1,1,0.44,0.4394,0.51,0.1343,1,15,41,410,42,425
15453,2012-10-11,4,1,10,1,0,4,1,1,0.44,0.4394,0.47,0.194,1,15,10,100,11,115
15454,2012-10-11,4,1,10,2,0,4,1,1,0.42,0.4242,0.5,0.1343,4,60,7,70,11,130
15455,2012-10-11,4,1,10,3,0,4,1,1,0.42,0.4242,0.47,0.2985,0,0,3,30,3,30
15456,2012-10-11,4,1,10,4,0,4,1,1,0.4,0.4091,0.5,0.2537,0,0,10,100,10,100
15457,2012-10-11,4,1,10,5,0,4,1,1,0.36,0.3485,0.5,0.1642,0,0,42,420,42,420
15458,2012-10-11,4,1,10,6,0,4,1,1,0.36,0.3485,0.5,0.1642,1,15,158,1580,159,1595
15459,2012-10-11,4,1,10,7,0,4,1,1,0.36,0.3333,0.5,0.2537,11,165,467,4670,478,4835
15460,2012-10-11,4,1,10,8,0,4,1,1,0.38,0.3939,0.46,0.3881,25,375,773,7730,798,8105
15461,2012-10-11,4,1,10,9,0,4,1,1,0.4,0.4091,0.43,0.3881,27,405,328,3280,355,3685
15462,2012-10-11,4,1,10,10,0,4,1,1,0.44,0.4394,0.41,0.3582,39,585,165,1650,204,2235
15463,2012-10-11,4,1,10,11,0,4,1,1,0.46,0.4545,0.36,0.0,76,1140,175,1750,251,2890
15464,2012-10-11,4,1,10,12,0,4,1,1,0.46,0.4545,0.36,0.0,47,705,279,2790,326,3495
15465,2012-10-11,4,1,10,13,0,4,1,1,0.5,0.4848,0.31,0.1045,48,720,243,2430,291,3150
15466,2012-10-11,4,1,10,14,0,4,1,1,0.52,0.5,0.32,0.0896,78,1170,270,2700,348,3870
15467,2012-10-11,4,1,10,15,0,4,1,1,0.52,0.5,0.34,0.1642,102,1530,358,3580,460,5110
15468,2012-10-11,4,1,10,16,0,4,1,1,0.5,0.4848,0.36,0.1343,68,1020,413,4130,481,5150
15469,2012-10-11,4,1,10,17,0,4,1,1,0.5,0.4848,0.39,0.2836,90,1350,737,7370,827,8720
15470,2012-10-11,4,1,10,18,0,4,1,1,0.46,0.4545,0.44,0.1642,64,960,628,6280,692,7240
15471,2012-10-11,4,1,10,19,0,4,1,1,0.44,0.4394,0.51,0.1343,81,1215,662,6620,743,7835
15472,2012-10-11,4,1,10,20,0,4,1,1,0.42,0.4242,0.62,0.1642,27,405,388,3880,415,4285
15473,2012-10-11,4,1,10,21,0,4,1,1,0.42,0.4242,0.62,0.1343,24,360,236,2360,260,2720
15474,2012-10-11,4,1,10,22,0,4,1,1,0.4,0.4091,0.66,0.1642,10,150,167,1670,177,1820
15475,2012-10-11,4,1,10,23,0,4,1,1,0.42,0.4242,0.58,0.0896,10,150,176,1760,186,1910
15476,2012-10-12,4,1,10,0,0,5,1,1,0.4,0.4091,0.66,0.1045,8,120,60,600,68,720
15477,2012-10-12,4,1,10,1,0,5,1,1,0.4,0.4091,0.66,0.0896,8,120,29,290,37,410
15478,2012-10-12,4,1,10,2,0,5,1,1,0.4,0.4091,0.66,0.0896,0,0,16,160,16,160
15479,2012-10-12,4,1,10,3,0,5,1,1,0.36,0.3636,0.76,0.0896,0,0,6,60,6,60
15480,2012-10-12,4,1,10,4,0,5,1,1,0.36,0.3636,0.76,0.1045,0,0,8,80,8,80
15481,2012-10-12,4,1,10,5,0,5,1,1,0.36,0.3636,0.81,0.0896,2,30,33,330,35,360
15482,2012-10-12,4,1,10,6,0,5,1,1,0.34,0.3485,0.81,0.0896,3,45,140,1400,143,1445
15483,2012-10-12,4,1,10,7,0,5,1,1,0.36,0.3636,0.81,0.0896,8,120,384,3840,392,3960
15484,2012-10-12,4,1,10,8,0,5,1,1,0.42,0.4242,0.71,0.0896,34,510,711,7110,745,7620
15485,2012-10-12,4,1,10,9,0,5,1,1,0.5,0.4848,0.39,0.2985,26,390,374,3740,400,4130
15486,2012-10-12,4,1,10,10,0,5,1,1,0.52,0.5,0.36,0.2985,75,1125,200,2000,275,3125
15487,2012-10-12,4,1,10,11,0,5,1,1,0.54,0.5152,0.37,0.3582,61,915,252,2520,313,3435
15488,2012-10-12,4,1,10,12,0,5,1,1,0.54,0.5152,0.39,0.4627,75,1125,312,3120,387,4245
15489,2012-10-12,4,1,10,13,0,5,1,1,0.56,0.5303,0.37,0.3881,81,1215,300,3000,381,4215
15490,2012-10-12,4,1,10,14,0,5,1,1,0.56,0.5303,0.37,0.4627,109,1635,262,2620,371,4255
15491,2012-10-12,4,1,10,15,0,5,1,1,0.52,0.5,0.42,0.4478,138,2070,317,3170,455,5240
15492,2012-10-12,4,1,10,16,0,5,1,1,0.46,0.4545,0.41,0.3582,108,1620,412,4120,520,5740
15493,2012-10-12,4,1,10,17,0,5,1,1,0.46,0.4545,0.38,0.3881,131,1965,706,7060,837,9025
15494,2012-10-12,4,1,10,18,0,5,1,1,0.44,0.4394,0.38,0.2985,76,1140,566,5660,642,6800
15495,2012-10-12,4,1,10,19,0,5,1,1,0.42,0.4242,0.41,0.2239,40,600,453,4530,493,5130
15496,2012-10-12,4,1,10,20,0,5,1,1,0.42,0.4242,0.47,0.1343,28,420,280,2800,308,3220
15497,2012-10-12,4,1,10,21,0,5,1,1,0.4,0.4091,0.54,0.194,21,315,169,1690,190,2005
15498,2012-10-12,4,1,10,22,0,5,1,1,0.4,0.4091,0.47,0.2985,17,255,143,1430,160,1685
15499,2012-10-12,4,1,10,23,0,5,1,1,0.36,0.3485,0.57,0.194,11,165,89,890,100,1055
15500,2012-10-13,4,1,10,0,0,6,0,1,0.36,0.3636,0.57,0.0896,31,465,218,2180,249,2645
15501,2012-10-13,4,1,10,1,0,6,0,1,0.34,0.3333,0.53,0.1343,23,345,123,1230,146,1575
15502,2012-10-13,4,1,10,2,0,6,0,1,0.34,0.3333,0.53,0.194,7,105,60,600,67,705
15503,2012-10-13,4,1,10,3,0,6,0,1,0.32,0.303,0.66,0.2239,2,30,13,130,15,160
15504,2012-10-13,4,1,10,4,0,6,0,1,0.3,0.303,0.65,0.1642,2,30,9,90,11,120
15505,2012-10-13,4,1,10,5,0,6,0,1,0.3,0.2879,0.61,0.194,0,0,11,110,11,110
15506,2012-10-13,4,1,10,6,0,6,0,1,0.3,0.2879,0.61,0.194,5,75,23,230,28,305
15507,2012-10-13,4,1,10,7,0,6,0,1,0.3,0.303,0.61,0.1642,10,150,60,600,70,750
15508,2012-10-13,4,1,10,8,0,6,0,1,0.34,0.3485,0.53,0.1045,23,345,151,1510,174,1855
15509,2012-10-13,4,1,10,9,0,6,0,1,0.36,0.3636,0.5,0.0896,46,690,220,2200,266,2890
15510,2012-10-13,4,1,10,10,0,6,0,1,0.4,0.4091,0.43,0.0,82,1230,265,2650,347,3880
15511,2012-10-13,4,1,10,11,0,6,0,1,0.42,0.4242,0.35,0.1343,192,2880,335,3350,527,6230
15512,2012-10-13,4,1,10,12,0,6,0,1,0.44,0.4394,0.35,0.0,202,3030,371,3710,573,6740
15513,2012-10-13,4,1,10,13,0,6,0,1,0.46,0.4545,0.36,0.194,235,3525,435,4350,670,7875
15514,2012-10-13,4,1,10,14,0,6,0,1,0.48,0.4697,0.33,0.194,243,3645,354,3540,597,7185
15515,2012-10-13,4,1,10,15,0,6,0,1,0.5,0.4848,0.36,0.194,251,3765,364,3640,615,7405
15516,2012-10-13,4,1,10,16,0,6,0,1,0.5,0.4848,0.31,0.194,294,4410,343,3430,637,7840
15517,2012-10-13,4,1,10,17,0,6,0,1,0.46,0.4545,0.38,0.1642,193,2895,335,3350,528,6245
15518,2012-10-13,4,1,10,18,0,6,0,1,0.46,0.4545,0.44,0.1343,174,2610,299,2990,473,5600
15519,2012-10-13,4,1,10,19,0,6,0,1,0.44,0.4394,0.44,0.1642,73,1095,259,2590,332,3685
15520,2012-10-13,4,1,10,20,0,6,0,1,0.4,0.4091,0.54,0.0896,57,855,198,1980,255,2835
15521,2012-10-13,4,1,10,21,0,6,0,1,0.4,0.4091,0.58,0.194,47,705,157,1570,204,2275
15522,2012-10-13,4,1,10,22,0,6,0,1,0.4,0.4091,0.62,0.0,33,495,156,1560,189,2055
15523,2012-10-13,4,1,10,23,0,6,0,1,0.42,0.4242,0.58,0.2985,27,405,98,980,125,1385
15524,2012-10-14,4,1,10,0,0,0,0,1,0.4,0.4091,0.71,0.2537,8,120,103,1030,111,1150
15525,2012-10-14,4,1,10,1,0,0,0,1,0.42,0.4242,0.77,0.2836,16,240,96,960,112,1200
15526,2012-10-14,4,1,10,2,0,0,0,1,0.4,0.4091,0.76,0.0896,8,120,58,580,66,700
15527,2012-10-14,4,1,10,3,0,0,0,1,0.42,0.4242,0.77,0.2985,3,45,25,250,28,295
15528,2012-10-14,4,1,10,4,0,0,0,1,0.42,0.4242,0.77,0.2836,2,30,10,100,12,130
15529,2012-10-14,4,1,10,5,0,0,0,1,0.4,0.4091,0.82,0.194,5,75,6,60,11,135
15530,2012-10-14,4,1,10,6,0,0,0,1,0.4,0.4091,0.82,0.1642,4,60,20,200,24,260
15531,2012-10-14,4,1,10,7,0,0,0,1,0.42,0.4242,0.82,0.2239,7,105,44,440,51,545
15532,2012-10-14,4,1,10,8,0,0,0,1,0.44,0.4394,0.77,0.194,28,420,104,1040,132,1460
15533,2012-10-14,4,1,10,9,0,0,0,2,0.48,0.4697,0.67,0.2836,62,930,161,1610,223,2540
15534,2012-10-14,4,1,10,10,0,0,0,1,0.54,0.5152,0.56,0.194,150,2250,278,2780,428,5030
15535,2012-10-14,4,1,10,11,0,0,0,1,0.56,0.5303,0.52,0.2985,156,2340,338,3380,494,5720
15536,2012-10-14,4,1,10,12,0,0,0,1,0.62,0.6212,0.46,0.3284,200,3000,362,3620,562,6620
15537,2012-10-14,4,1,10,13,0,0,0,1,0.64,0.6212,0.41,0.4478,218,3270,401,4010,619,7280
15538,2012-10-14,4,1,10,14,0,0,0,1,0.66,0.6212,0.39,0.4179,249,3735,368,3680,617,7415
15539,2012-10-14,4,1,10,15,0,0,0,1,0.66,0.6212,0.39,0.4179,213,3195,355,3550,568,6745
15540,2012-10-14,4,1,10,16,0,0,0,1,0.64,0.6212,0.41,0.2985,203,3045,378,3780,581,6825
15541,2012-10-14,4,1,10,17,0,0,0,1,0.64,0.6212,0.44,0.194,193,2895,346,3460,539,6355
15542,2012-10-14,4,1,10,18,0,0,0,1,0.58,0.5455,0.6,0.2537,134,2010,319,3190,453,5200
15543,2012-10-14,4,1,10,19,0,0,0,1,0.56,0.5303,0.64,0.2239,68,1020,268,2680,336,3700
15544,2012-10-14,4,1,10,20,0,0,0,1,0.54,0.5152,0.73,0.2239,48,720,198,1980,246,2700
15545,2012-10-14,4,1,10,21,0,0,0,1,0.56,0.5303,0.73,0.4478,40,600,156,1560,196,2160
15546,2012-10-14,4,1,10,22,0,0,0,1,0.56,0.5303,0.73,0.3881,38,570,87,870,125,1440
15547,2012-10-14,4,1,10,23,0,0,0,2,0.56,0.5303,0.68,0.2836,27,405,78,780,105,1185
15548,2012-10-15,4,1,10,0,0,1,1,2,0.56,0.5303,0.73,0.2537,17,255,31,310,48,565
15549,2012-10-15,4,1,10,1,0,1,1,2,0.58,0.5455,0.64,0.3881,5,75,24,240,29,315
15550,2012-10-15,4,1,10,2,0,1,1,2,0.58,0.5455,0.64,0.3582,1,15,5,50,6,65
15551,2012-10-15,4,1,10,3,0,1,1,2,0.56,0.5303,0.73,0.2537,2,30,2,20,4,50
15552,2012-10-15,4,1,10,4,0,1,1,2,0.56,0.5303,0.68,0.2239,1,15,9,90,10,105
15553,2012-10-15,4,1,10,5,0,1,1,2,0.56,0.5303,0.73,0.2836,2,30,38,380,40,410
15554,2012-10-15,4,1,10,6,0,1,1,2,0.56,0.5303,0.73,0.2985,6,90,141,1410,147,1500
15555,2012-10-15,4,1,10,7,0,1,1,2,0.58,0.5455,0.68,0.3284,15,225,461,4610,476,4835
15556,2012-10-15,4,1,10,8,0,1,1,2,0.6,0.6061,0.64,0.3881,24,360,713,7130,737,7490
15557,2012-10-15,4,1,10,9,0,1,1,3,0.6,0.5909,0.69,0.3881,31,465,328,3280,359,3745
15558,2012-10-15,4,1,10,10,0,1,1,2,0.6,0.5909,0.73,0.3881,43,645,125,1250,168,1895
15559,2012-10-15,4,1,10,11,0,1,1,2,0.6,0.5909,0.73,0.3881,88,1320,175,1750,263,3070
15560,2012-10-15,4,1,10,12,0,1,1,3,0.6,0.5758,0.78,0.3284,73,1095,211,2110,284,3205
15561,2012-10-15,4,1,10,13,0,1,1,2,0.56,0.5303,0.88,0.2239,37,555,109,1090,146,1645
15562,2012-10-15,4,1,10,14,0,1,1,2,0.6,0.5758,0.78,0.2836,57,855,128,1280,185,2135
15563,2012-10-15,4,1,10,15,0,1,1,1,0.6,0.5758,0.78,0.3284,70,1050,190,1900,260,2950
15564,2012-10-15,4,1,10,16,0,1,1,1,0.56,0.5303,0.64,0.2985,76,1140,371,3710,447,4850
15565,2012-10-15,4,1,10,17,0,1,1,1,0.56,0.5303,0.64,0.2537,96,1440,670,6700,766,8140
15566,2012-10-15,4,1,10,18,0,1,1,3,0.54,0.5152,0.77,0.1343,52,780,540,5400,592,6180
15567,2012-10-15,4,1,10,19,0,1,1,3,0.52,0.5,0.83,0.0896,12,180,227,2270,239,2450
15568,2012-10-15,4,1,10,20,0,1,1,2,0.52,0.5,0.72,0.3881,19,285,237,2370,256,2655
15569,2012-10-15,4,1,10,21,0,1,1,1,0.52,0.5,0.59,0.3284,16,240,190,1900,206,2140
15570,2012-10-15,4,1,10,22,0,1,1,1,0.5,0.4848,0.59,0.2836,8,120,118,1180,126,1300
15571,2012-10-15,4,1,10,23,0,1,1,1,0.46,0.4545,0.63,0.2239,9,135,72,720,81,855
15572,2012-10-16,4,1,10,0,0,2,1,1,0.46,0.4545,0.63,0.3881,3,45,45,450,48,495
15573,2012-10-16,4,1,10,1,0,2,1,1,0.44,0.4394,0.67,0.194,4,60,9,90,13,150
15574,2012-10-16,4,1,10,2,0,2,1,1,0.44,0.4394,0.67,0.1343,2,30,1,10,3,40
15575,2012-10-16,4,1,10,3,0,2,1,1,0.42,0.4242,0.67,0.1045,0,0,2,20,2,20
15576,2012-10-16,4,1,10,4,0,2,1,1,0.42,0.4242,0.67,0.1642,0,0,7,70,7,70
15577,2012-10-16,4,1,10,5,0,2,1,1,0.42,0.4242,0.67,0.2537,5,75,47,470,52,545
15578,2012-10-16,4,1,10,6,0,2,1,1,0.42,0.4242,0.67,0.1642,4,60,168,1680,172,1740
15579,2012-10-16,4,1,10,7,0,2,1,1,0.42,0.4242,0.67,0.0896,20,300,505,5050,525,5350
15580,2012-10-16,4,1,10,8,0,2,1,1,0.44,0.4394,0.62,0.0,35,525,800,8000,835,8525
15581,2012-10-16,4,1,10,9,0,2,1,1,0.48,0.4697,0.55,0.2537,32,480,323,3230,355,3710
15582,2012-10-16,4,1,10,10,0,2,1,1,0.5,0.4848,0.48,0.2836,65,975,157,1570,222,2545
15583,2012-10-16,4,1,10,11,0,2,1,1,0.5,0.4848,0.45,0.4179,56,840,172,1720,228,2560
15584,2012-10-16,4,1,10,12,0,2,1,2,0.52,0.5,0.45,0.3284,69,1035,256,2560,325,3595
15585,2012-10-16,4,1,10,13,0,2,1,1,0.52,0.5,0.45,0.2836,68,1020,260,2600,328,3620
15586,2012-10-16,4,1,10,14,0,2,1,1,0.54,0.5152,0.39,0.2537,94,1410,214,2140,308,3550
15587,2012-10-16,4,1,10,15,0,2,1,1,0.54,0.5152,0.41,0.3284,76,1140,270,2700,346,3840
15588,2012-10-16,4,1,10,16,0,2,1,1,0.54,0.5152,0.39,0.2836,79,1185,367,3670,446,4855
15589,2012-10-16,4,1,10,17,0,2,1,1,0.52,0.5,0.39,0.194,104,1560,839,8390,943,9950
15590,2012-10-16,4,1,10,18,0,2,1,1,0.5,0.4848,0.42,0.1642,71,1065,767,7670,838,8735
15591,2012-10-16,4,1,10,19,0,2,1,1,0.48,0.4697,0.48,0.0,40,600,491,4910,531,5510
15592,2012-10-16,4,1,10,20,0,2,1,1,0.46,0.4545,0.55,0.0,35,525,397,3970,432,4495
15593,2012-10-16,4,1,10,21,0,2,1,1,0.46,0.4545,0.63,0.0,19,285,176,1760,195,2045
15594,2012-10-16,4,1,10,22,0,2,1,1,0.4,0.4091,0.71,0.0896,18,270,163,1630,181,1900
15595,2012-10-16,4,1,10,23,0,2,1,1,0.4,0.4091,0.71,0.0,23,345,176,1760,199,2105
15596,2012-10-17,4,1,10,0,0,3,1,1,0.38,0.3939,0.76,0.0,1,15,48,480,49,495
15597,2012-10-17,4,1,10,1,0,3,1,1,0.38,0.3939,0.76,0.0,3,45,14,140,17,185
15598,2012-10-17,4,1,10,2,0,3,1,1,0.38,0.3939,0.76,0.0,4,60,12,120,16,180
15599,2012-10-17,4,1,10,3,0,3,1,1,0.36,0.3788,0.87,0.0,0,0,7,70,7,70
15600,2012-10-17,4,1,10,4,0,3,1,1,0.36,0.3636,0.81,0.0896,0,0,4,40,4,40
15601,2012-10-17,4,1,10,5,0,3,1,2,0.36,0.3788,0.81,0.0,2,30,39,390,41,420
15602,2012-10-17,4,1,10,6,0,3,1,1,0.38,0.3939,0.82,0.0,7,105,171,1710,178,1815
15603,2012-10-17,4,1,10,7,0,3,1,1,0.36,0.3636,0.81,0.1045,15,225,449,4490,464,4715
15604,2012-10-17,4,1,10,8,0,3,1,2,0.4,0.4091,0.76,0.0,38,570,779,7790,817,8360
15605,2012-10-17,4,1,10,9,0,3,1,2,0.42,0.4242,0.77,0.0,38,570,344,3440,382,4010
15606,2012-10-17,4,1,10,10,0,3,1,2,0.46,0.4545,0.67,0.0,60,900,168,1680,228,2580
15607,2012-10-17,4,1,10,11,0,3,1,2,0.5,0.4848,0.51,0.0896,78,1170,156,1560,234,2730
15608,2012-10-17,4,1,10,12,0,3,1,2,0.52,0.5,0.48,0.1642,71,1065,261,2610,332,3675
15609,2012-10-17,4,1,10,13,0,3,1,2,0.54,0.5152,0.49,0.1343,73,1095,237,2370,310,3465
15610,2012-10-17,4,1,10,14,0,3,1,2,0.56,0.5303,0.43,0.1642,82,1230,188,1880,270,3110
15611,2012-10-17,4,1,10,15,0,3,1,2,0.58,0.5455,0.43,0.2239,62,930,239,2390,301,3320
15612,2012-10-17,4,1,10,16,0,3,1,1,0.56,0.5303,0.52,0.194,70,1050,396,3960,466,5010
15613,2012-10-17,4,1,10,17,0,3,1,1,0.54,0.5152,0.56,0.1045,122,1830,766,7660,888,9490
15614,2012-10-17,4,1,10,18,0,3,1,1,0.52,0.5,0.59,0.1642,90,1350,794,7940,884,9290
15615,2012-10-17,4,1,10,19,0,3,1,1,0.5,0.4848,0.72,0.194,49,735,467,4670,516,5405
15616,2012-10-17,4,1,10,20,0,3,1,1,0.5,0.4848,0.72,0.1343,54,810,360,3600,414,4410
15617,2012-10-17,4,1,10,21,0,3,1,1,0.46,0.4545,0.82,0.194,28,420,301,3010,329,3430
15618,2012-10-17,4,1,10,22,0,3,1,1,0.46,0.4545,0.88,0.2537,17,255,198,1980,215,2235
15619,2012-10-17,4,1,10,23,0,3,1,1,0.46,0.4545,0.88,0.2239,15,225,84,840,99,1065
15620,2012-10-18,4,1,10,0,0,4,1,1,0.46,0.4545,0.88,0.194,4,60,53,530,57,590
15621,2012-10-18,4,1,10,1,0,4,1,1,0.46,0.4545,0.82,0.2239,0,0,14,140,14,140
15622,2012-10-18,4,1,10,2,0,4,1,1,0.46,0.4545,0.82,0.194,1,15,13,130,14,145
15623,2012-10-18,4,1,10,3,0,4,1,1,0.44,0.4394,0.88,0.2239,0,0,5,50,5,50
15624,2012-10-18,4,1,10,4,0,4,1,1,0.44,0.4394,0.88,0.2239,0,0,5,50,5,50
15625,2012-10-18,4,1,10,5,0,4,1,1,0.44,0.4394,0.82,0.2239,1,15,41,410,42,425
15626,2012-10-18,4,1,10,6,0,4,1,1,0.44,0.4394,0.88,0.2985,3,45,150,1500,153,1545
15627,2012-10-18,4,1,10,7,0,4,1,1,0.44,0.4394,0.88,0.2537,20,300,488,4880,508,5180
15628,2012-10-18,4,1,10,8,0,4,1,1,0.46,0.4545,0.82,0.2537,31,465,803,8030,834,8495
15629,2012-10-18,4,1,10,9,0,4,1,2,0.5,0.4848,0.77,0.1642,41,615,346,3460,387,4075
15630,2012-10-18,4,1,10,10,0,4,1,2,0.52,0.5,0.68,0.2239,60,900,158,1580,218,2480
15631,2012-10-18,4,1,10,11,0,4,1,2,0.56,0.5303,0.56,0.2239,79,1185,189,1890,268,3075
15632,2012-10-18,4,1,10,12,0,4,1,2,0.6,0.6212,0.53,0.2537,93,1395,284,2840,377,4235
15633,2012-10-18,4,1,10,13,0,4,1,1,0.62,0.6212,0.53,0.3582,96,1440,236,2360,332,3800
15634,2012-10-18,4,1,10,14,0,4,1,2,0.62,0.6212,0.5,0.2985,94,1410,191,1910,285,3320
15635,2012-10-18,4,1,10,15,0,4,1,2,0.6,0.6061,0.6,0.194,69,1035,284,2840,353,3875
15636,2012-10-18,4,1,10,16,0,4,1,1,0.6,0.6212,0.56,0.2836,94,1410,356,3560,450,4970
15637,2012-10-18,4,1,10,17,0,4,1,2,0.58,0.5455,0.64,0.3284,102,1530,788,7880,890,9410
15638,2012-10-18,4,1,10,18,0,4,1,2,0.56,0.5303,0.64,0.3284,68,1020,720,7200,788,8220
15639,2012-10-18,4,1,10,19,0,4,1,2,0.56,0.5303,0.68,0.2985,42,630,471,4710,513,5340
15640,2012-10-18,4,1,10,20,0,4,1,2,0.56,0.5303,0.68,0.2537,39,585,348,3480,387,4065
15641,2012-10-18,4,1,10,21,0,4,1,2,0.54,0.5152,0.77,0.194,38,570,245,2450,283,3020
15642,2012-10-18,4,1,10,22,0,4,1,2,0.54,0.5152,0.83,0.194,27,405,202,2020,229,2425
15643,2012-10-18,4,1,10,23,0,4,1,2,0.54,0.5152,0.83,0.0,6,90,111,1110,117,1200
15644,2012-10-19,4,1,10,0,0,5,1,2,0.56,0.5303,0.83,0.1045,5,75,51,510,56,585
15645,2012-10-19,4,1,10,1,0,5,1,3,0.54,0.5152,0.88,0.0,4,60,12,120,16,180
15646,2012-10-19,4,1,10,2,0,5,1,2,0.54,0.5152,0.88,0.0,1,15,9,90,10,105
15647,2012-10-19,4,1,10,3,0,5,1,2,0.56,0.5303,0.83,0.0,0,0,5,50,5,50
15648,2012-10-19,4,1,10,4,0,5,1,2,0.56,0.5303,0.83,0.0,1,15,5,50,6,65
15649,2012-10-19,4,1,10,5,0,5,1,2,0.54,0.5152,0.88,0.0,1,15,35,350,36,365
15650,2012-10-19,4,1,10,6,0,5,1,3,0.54,0.5152,0.94,0.1642,5,75,126,1260,131,1335
15651,2012-10-19,4,1,10,7,0,5,1,3,0.54,0.5152,0.94,0.0,5,75,149,1490,154,1565
15652,2012-10-19,4,1,10,8,0,5,1,2,0.54,0.5152,0.94,0.1045,20,300,447,4470,467,4770
15653,2012-10-19,4,1,10,9,0,5,1,2,0.54,0.5152,0.94,0.1045,26,390,363,3630,389,4020
15654,2012-10-19,4,1,10,10,0,5,1,2,0.58,0.5455,0.88,0.194,26,390,198,1980,224,2370
15655,2012-10-19,4,1,10,11,0,5,1,1,0.6,0.5606,0.83,0.194,41,615,211,2110,252,2725
15656,2012-10-19,4,1,10,12,0,5,1,1,0.64,0.6061,0.69,0.2239,74,1110,258,2580,332,3690
15657,2012-10-19,4,1,10,13,0,5,1,1,0.62,0.5909,0.73,0.2239,87,1305,288,2880,375,4185
15658,2012-10-19,4,1,10,14,0,5,1,1,0.66,0.6212,0.61,0.2537,88,1320,277,2770,365,4090
15659,2012-10-19,4,1,10,15,0,5,1,1,0.64,0.6061,0.65,0.2985,93,1395,302,3020,395,4415
15660,2012-10-19,4,1,10,16,0,5,1,3,0.62,0.6061,0.69,0.3582,131,1965,434,4340,565,6305
15661,2012-10-19,4,1,10,17,0,5,1,3,0.62,0.6061,0.69,0.3582,48,720,377,3770,425,4490
15662,2012-10-19,4,1,10,18,0,5,1,1,0.56,0.5303,0.83,0.1045,21,315,212,2120,233,2435
15663,2012-10-19,4,1,10,19,0,5,1,1,0.54,0.5152,0.88,0.1642,19,285,213,2130,232,2415
15664,2012-10-19,4,1,10,20,0,5,1,1,0.52,0.5,0.77,0.194,13,195,216,2160,229,2355
15665,2012-10-19,4,1,10,21,0,5,1,1,0.5,0.4848,0.77,0.0,17,255,189,1890,206,2145
15666,2012-10-19,4,1,10,22,0,5,1,1,0.5,0.4848,0.77,0.0896,14,210,176,1760,190,1970
15667,2012-10-19,4,1,10,23,0,5,1,1,0.46,0.4545,0.88,0.1045,13,195,118,1180,131,1375
15668,2012-10-20,4,1,10,0,0,6,0,1,0.46,0.4545,0.82,0.1343,13,195,110,1100,123,1295
15669,2012-10-20,4,1,10,1,0,6,0,1,0.46,0.4545,0.72,0.1343,2,30,93,930,95,960
15670,2012-10-20,4,1,10,2,0,6,0,1,0.44,0.4394,0.77,0.1045,9,135,69,690,78,825
15671,2012-10-20,4,1,10,3,0,6,0,1,0.42,0.4242,0.77,0.1343,2,30,27,270,29,300
15672,2012-10-20,4,1,10,4,0,6,0,1,0.44,0.4394,0.72,0.0,9,135,9,90,18,225
15673,2012-10-20,4,1,10,5,0,6,0,1,0.4,0.4091,0.82,0.0,6,90,7,70,13,160
15674,2012-10-20,4,1,10,6,0,6,0,1,0.42,0.4242,0.71,0.0,5,75,26,260,31,335
15675,2012-10-20,4,1,10,7,0,6,0,1,0.4,0.4091,0.82,0.0,6,90,59,590,65,680
15676,2012-10-20,4,1,10,8,0,6,0,1,0.46,0.4545,0.67,0.1343,29,435,164,1640,193,2075
15677,2012-10-20,4,1,10,9,0,6,0,1,0.5,0.4848,0.59,0.1343,106,1590,257,2570,363,4160
15678,2012-10-20,4,1,10,10,0,6,0,1,0.52,0.5,0.52,0.1343,111,1665,312,3120,423,4785
15679,2012-10-20,4,1,10,11,0,6,0,1,0.54,0.5152,0.52,0.2239,204,3060,408,4080,612,7140
15680,2012-10-20,4,1,10,12,0,6,0,1,0.56,0.5303,0.46,0.1045,267,4005,436,4360,703,8365
15681,2012-10-20,4,1,10,13,0,6,0,1,0.56,0.5303,0.43,0.1642,273,4095,441,4410,714,8505
15682,2012-10-20,4,1,10,14,0,6,0,1,0.56,0.5303,0.4,0.0,335,5025,376,3760,711,8785
15683,2012-10-20,4,1,10,15,0,6,0,1,0.56,0.5303,0.43,0.0,308,4620,403,4030,711,8650
15684,2012-10-20,4,1,10,16,0,6,0,1,0.54,0.5152,0.42,0.2836,325,4875,366,3660,691,8535
15685,2012-10-20,4,1,10,17,0,6,0,1,0.54,0.5152,0.37,0.2239,347,5205,384,3840,731,9045
15686,2012-10-20,4,1,10,18,0,6,0,1,0.52,0.5,0.39,0.2239,165,2475,356,3560,521,6035
15687,2012-10-20,4,1,10,19,0,6,0,1,0.5,0.4848,0.45,0.1343,77,1155,268,2680,345,3835
15688,2012-10-20,4,1,10,20,0,6,0,1,0.5,0.4848,0.39,0.2239,61,915,198,1980,259,2895
15689,2012-10-20,4,1,10,21,0,6,0,1,0.46,0.4545,0.47,0.2239,72,1080,224,2240,296,3320
15690,2012-10-20,4,1,10,22,0,6,0,1,0.44,0.4394,0.51,0.1045,47,705,155,1550,202,2255
15691,2012-10-20,4,1,10,23,0,6,0,1,0.42,0.4242,0.58,0.0,27,405,136,1360,163,1765
15692,2012-10-21,4,1,10,0,0,0,0,1,0.44,0.4394,0.54,0.1642,35,525,119,1190,154,1715
15693,2012-10-21,4,1,10,1,0,0,0,1,0.42,0.4242,0.58,0.2239,20,300,97,970,117,1270
15694,2012-10-21,4,1,10,2,0,0,0,1,0.4,0.4091,0.62,0.1642,44,660,88,880,132,1540
15695,2012-10-21,4,1,10,3,0,0,0,1,0.38,0.3939,0.66,0.0896,12,180,29,290,41,470
15696,2012-10-21,4,1,10,4,0,0,0,1,0.36,0.3485,0.71,0.1642,8,120,13,130,21,250
15697,2012-10-21,4,1,10,5,0,0,0,1,0.38,0.3939,0.66,0.0896,6,90,4,40,10,130
15698,2012-10-21,4,1,10,6,0,0,0,1,0.4,0.4091,0.62,0.0,8,120,18,180,26,300
15699,2012-10-21,4,1,10,7,0,0,0,1,0.4,0.4091,0.62,0.0,13,195,43,430,56,625
15700,2012-10-21,4,1,10,8,0,0,0,1,0.42,0.4242,0.67,0.0,39,585,104,1040,143,1625
15701,2012-10-21,4,1,10,9,0,0,0,1,0.46,0.4545,0.55,0.1642,77,1155,192,1920,269,3075
15702,2012-10-21,4,1,10,10,0,0,0,1,0.5,0.4848,0.48,0.2985,167,2505,276,2760,443,5265
15703,2012-10-21,4,1,10,11,0,0,0,1,0.52,0.5,0.44,0.3284,191,2865,356,3560,547,6425
15704,2012-10-21,4,1,10,12,0,0,0,1,0.54,0.5152,0.39,0.3284,236,3540,439,4390,675,7930
15705,2012-10-21,4,1,10,13,0,0,0,1,0.56,0.5303,0.37,0.2537,243,3645,383,3830,626,7475
15706,2012-10-21,4,1,10,14,0,0,0,1,0.56,0.5303,0.35,0.194,235,3525,405,4050,640,7575
15707,2012-10-21,4,1,10,15,0,0,0,1,0.56,0.5303,0.35,0.3284,240,3600,383,3830,623,7430
15708,2012-10-21,4,1,10,16,0,0,0,1,0.54,0.5152,0.37,0.2239,182,2730,409,4090,591,6820
15709,2012-10-21,4,1,10,17,0,0,0,1,0.52,0.5,0.39,0.2537,153,2295,338,3380,491,5675
15710,2012-10-21,4,1,10,18,0,0,0,1,0.52,0.5,0.39,0.194,71,1065,342,3420,413,4485
15711,2012-10-21,4,1,10,19,0,0,0,1,0.5,0.4848,0.42,0.1642,50,750,216,2160,266,2910
15712,2012-10-21,4,1,10,20,0,0,0,1,0.48,0.4697,0.44,0.194,35,525,160,1600,195,2125
15713,2012-10-21,4,1,10,21,0,0,0,1,0.42,0.4242,0.54,0.1642,42,630,124,1240,166,1870
15714,2012-10-21,4,1,10,22,0,0,0,1,0.42,0.4242,0.54,0.0,18,270,95,950,113,1220
15715,2012-10-21,4,1,10,23,0,0,0,1,0.44,0.4394,0.54,0.0,7,105,59,590,66,695
15716,2012-10-22,4,1,10,0,0,1,1,1,0.4,0.4091,0.62,0.0,3,45,28,280,31,325
15717,2012-10-22,4,1,10,1,0,1,1,1,0.4,0.4091,0.71,0.0,0,0,11,110,11,110
15718,2012-10-22,4,1,10,2,0,1,1,1,0.38,0.3939,0.71,0.0,1,15,4,40,5,55
15719,2012-10-22,4,1,10,3,0,1,1,1,0.4,0.4091,0.62,0.0,1,15,5,50,6,65
15720,2012-10-22,4,1,10,4,0,1,1,1,0.38,0.3939,0.66,0.0,1,15,6,60,7,75
15721,2012-10-22,4,1,10,5,0,1,1,1,0.38,0.3939,0.76,0.0896,2,30,44,440,46,470
15722,2012-10-22,4,1,10,6,0,1,1,1,0.36,0.3636,0.76,0.0896,4,60,140,1400,144,1460
15723,2012-10-22,4,1,10,7,0,1,1,1,0.38,0.3939,0.66,0.0896,15,225,437,4370,452,4595
15724,2012-10-22,4,1,10,8,0,1,1,1,0.44,0.4394,0.67,0.0,32,480,696,6960,728,7440
15725,2012-10-22,4,1,10,9,0,1,1,1,0.46,0.4545,0.63,0.0896,25,375,335,3350,360,3725
15726,2012-10-22,4,1,10,10,0,1,1,1,0.5,0.4848,0.55,0.0,51,765,161,1610,212,2375
15727,2012-10-22,4,1,10,11,0,1,1,1,0.56,0.5303,0.37,0.1642,63,945,148,1480,211,2425
15728,2012-10-22,4,1,10,12,0,1,1,1,0.58,0.5455,0.35,0.0,52,780,231,2310,283,3090
15729,2012-10-22,4,1,10,13,0,1,1,1,0.62,0.6212,0.29,0.1642,88,1320,227,2270,315,3590
15730,2012-10-22,4,1,10,14,0,1,1,1,0.62,0.6061,0.27,0.194,73,1095,209,2090,282,3185
15731,2012-10-22,4,1,10,15,0,1,1,1,0.64,0.6212,0.29,0.1642,74,1110,222,2220,296,3330
15732,2012-10-22,4,1,10,16,0,1,1,1,0.62,0.6212,0.33,0.1642,80,1200,444,4440,524,5640
15733,2012-10-22,4,1,10,17,0,1,1,1,0.62,0.6212,0.33,0.1045,84,1260,838,8380,922,9640
15734,2012-10-22,4,1,10,18,0,1,1,1,0.54,0.5152,0.64,0.1045,60,900,726,7260,786,8160
15735,2012-10-22,4,1,10,19,0,1,1,1,0.52,0.5,0.52,0.1045,36,540,478,4780,514,5320
15736,2012-10-22,4,1,10,20,0,1,1,1,0.5,0.4848,0.59,0.1045,21,315,382,3820,403,4135
15737,2012-10-22,4,1,10,21,0,1,1,1,0.48,0.4697,0.67,0.0896,19,285,155,1550,174,1835
15738,2012-10-22,4,1,10,22,0,1,1,1,0.46,0.4545,0.82,0.1343,25,375,158,1580,183,1955
15739,2012-10-22,4,1,10,23,0,1,1,1,0.46,0.4545,0.82,0.1045,20,300,143,1430,163,1730
15740,2012-10-23,4,1,10,0,0,2,1,1,0.46,0.4545,0.88,0.1642,5,75,32,320,37,395
15741,2012-10-23,4,1,10,1,0,2,1,1,0.46,0.4545,0.77,0.1642,1,15,16,160,17,175
15742,2012-10-23,4,1,10,2,0,2,1,1,0.44,0.4394,0.88,0.1343,1,15,6,60,7,75
15743,2012-10-23,4,1,10,3,0,2,1,1,0.44,0.4394,0.77,0.1343,0,0,1,10,1,10
15744,2012-10-23,4,1,10,4,0,2,1,1,0.42,0.4242,0.77,0.1045,1,15,6,60,7,75
15745,2012-10-23,4,1,10,5,0,2,1,1,0.44,0.4394,0.77,0.0896,1,15,49,490,50,505
15746,2012-10-23,4,1,10,6,0,2,1,1,0.4,0.4091,0.82,0.0896,6,90,152,1520,158,1610
15747,2012-10-23,4,1,10,7,0,2,1,2,0.44,0.4394,0.77,0.1045,12,180,519,5190,531,5370
15748,2012-10-23,4,1,10,8,0,2,1,2,0.46,0.4545,0.72,0.0896,28,420,733,7330,761,7750
15749,2012-10-23,4,1,10,9,0,2,1,2,0.5,0.4848,0.72,0.1045,29,435,305,3050,334,3485
15750,2012-10-23,4,1,10,10,0,2,1,1,0.54,0.5152,0.6,0.0,50,750,171,1710,221,2460
15751,2012-10-23,4,1,10,11,0,2,1,1,0.6,0.6212,0.53,0.0,52,780,201,2010,253,2790
15752,2012-10-23,4,1,10,12,0,2,1,2,0.62,0.6212,0.46,0.0896,80,1200,298,2980,378,4180
15753,2012-10-23,4,1,10,13,0,2,1,2,0.64,0.6212,0.44,0.0,59,885,244,2440,303,3325
15754,2012-10-23,4,1,10,14,0,2,1,1,0.68,0.6364,0.41,0.1642,67,1005,229,2290,296,3295
15755,2012-10-23,4,1,10,15,0,2,1,1,0.68,0.6364,0.41,0.2239,76,1140,270,2700,346,3840
15756,2012-10-23,4,1,10,16,0,2,1,1,0.68,0.6364,0.44,0.0896,108,1620,433,4330,541,5950
15757,2012-10-23,4,1,10,17,0,2,1,1,0.68,0.6364,0.41,0.0,67,1005,871,8710,938,9715
15758,2012-10-23,4,1,10,18,0,2,1,1,0.62,0.6212,0.53,0.0896,64,960,762,7620,826,8580
15759,2012-10-23,4,1,10,19,0,2,1,1,0.62,0.6212,0.57,0.0896,25,375,457,4570,482,4945
15760,2012-10-23,4,1,10,20,0,2,1,1,0.58,0.5455,0.64,0.1343,45,675,334,3340,379,4015
15761,2012-10-23,4,1,10,21,0,2,1,1,0.56,0.5303,0.68,0.0,35,525,260,2600,295,3125
15762,2012-10-23,4,1,10,22,0,2,1,1,0.56,0.5303,0.68,0.1045,20,300,174,1740,194,2040
15763,2012-10-23,4,1,10,23,0,2,1,1,0.54,0.5152,0.73,0.1045,9,135,102,1020,111,1155
15764,2012-10-24,4,1,10,0,0,3,1,1,0.54,0.5152,0.73,0.0896,7,105,39,390,46,495
15765,2012-10-24,4,1,10,1,0,3,1,1,0.54,0.5152,0.68,0.0,4,60,23,230,27,290
15766,2012-10-24,4,1,10,2,0,3,1,1,0.54,0.5152,0.68,0.0,0,0,6,60,6,60
15767,2012-10-24,4,1,10,3,0,3,1,1,0.5,0.4848,0.77,0.0896,0,0,4,40,4,40
15768,2012-10-24,4,1,10,4,0,3,1,1,0.5,0.4848,0.77,0.0896,1,15,5,50,6,65
15769,2012-10-24,4,1,10,5,0,3,1,1,0.5,0.4848,0.82,0.0,1,15,52,520,53,535
15770,2012-10-24,4,1,10,6,0,3,1,1,0.48,0.4697,0.82,0.1045,11,165,162,1620,173,1785
15771,2012-10-24,4,1,10,7,0,3,1,1,0.5,0.4848,0.88,0.0896,20,300,506,5060,526,5360
15772,2012-10-24,4,1,10,8,0,3,1,2,0.52,0.5,0.83,0.1045,24,360,777,7770,801,8130
15773,2012-10-24,4,1,10,9,0,3,1,2,0.52,0.5,0.77,0.0896,24,360,349,3490,373,3850
15774,2012-10-24,4,1,10,10,0,3,1,2,0.54,0.5152,0.73,0.0,29,435,142,1420,171,1855
15775,2012-10-24,4,1,10,11,0,3,1,1,0.58,0.5455,0.64,0.0,47,705,189,1890,236,2595
15776,2012-10-24,4,1,10,12,0,3,1,1,0.62,0.6061,0.61,0.0896,48,720,268,2680,316,3400
15777,2012-10-24,4,1,10,13,0,3,1,1,0.66,0.6212,0.54,0.0,65,975,241,2410,306,3385
15778,2012-10-24,4,1,10,14,0,3,1,1,0.74,0.6515,0.3,0.2537,64,960,237,2370,301,3330
15779,2012-10-24,4,1,10,15,0,3,1,1,0.7,0.6364,0.39,0.1045,63,945,245,2450,308,3395
15780,2012-10-24,4,1,10,16,0,3,1,1,0.74,0.6515,0.33,0.1343,67,1005,465,4650,532,5655
15781,2012-10-24,4,1,10,17,0,3,1,1,0.66,0.6212,0.47,0.0,87,1305,876,8760,963,10065
15782,2012-10-24,4,1,10,18,0,3,1,1,0.66,0.6212,0.44,0.0,63,945,795,7950,858,8895
15783,2012-10-24,4,1,10,19,0,3,1,2,0.64,0.6212,0.53,0.0896,50,750,522,5220,572,5970
15784,2012-10-24,4,1,10,20,0,3,1,2,0.62,0.6061,0.61,0.0896,45,675,396,3960,441,4635
15785,2012-10-24,4,1,10,21,0,3,1,2,0.62,0.6061,0.61,0.1045,33,495,280,2800,313,3295
15786,2012-10-24,4,1,10,22,0,3,1,2,0.6,0.6061,0.64,0.1343,30,450,208,2080,238,2530
15787,2012-10-24,4,1,10,23,0,3,1,2,0.58,0.5455,0.68,0.0896,12,180,111,1110,123,1290
15788,2012-10-25,4,1,10,0,0,4,1,2,0.6,0.6061,0.64,0.1045,19,285,57,570,76,855
15789,2012-10-25,4,1,10,1,0,4,1,1,0.58,0.5455,0.68,0.0,6,90,22,220,28,310
15790,2012-10-25,4,1,10,2,0,4,1,1,0.54,0.5152,0.77,0.0,3,45,15,150,18,195
15791,2012-10-25,4,1,10,3,0,4,1,2,0.52,0.5,0.88,0.1343,0,0,8,80,8,80
15792,2012-10-25,4,1,10,4,0,4,1,2,0.52,0.5,0.88,0.1045,1,15,4,40,5,55
15793,2012-10-25,4,1,10,5,0,4,1,2,0.52,0.5,0.88,0.1642,2,30,53,530,55,560
15794,2012-10-25,4,1,10,6,0,4,1,2,0.52,0.5,0.88,0.194,3,45,168,1680,171,1725
15795,2012-10-25,4,1,10,7,0,4,1,2,0.52,0.5,0.88,0.194,18,270,477,4770,495,5040
15796,2012-10-25,4,1,10,8,0,4,1,2,0.52,0.5,0.83,0.1642,33,495,746,7460,779,7955
15797,2012-10-25,4,1,10,9,0,4,1,2,0.52,0.5,0.83,0.194,23,345,320,3200,343,3545
15798,2012-10-25,4,1,10,10,0,4,1,2,0.54,0.5152,0.83,0.1343,53,795,172,1720,225,2515
15799,2012-10-25,4,1,10,11,0,4,1,2,0.54,0.5152,0.83,0.1045,57,855,181,1810,238,2665
15800,2012-10-25,4,1,10,12,0,4,1,2,0.56,0.5303,0.78,0.1045,61,915,258,2580,319,3495
15801,2012-10-25,4,1,10,13,0,4,1,2,0.56,0.5303,0.78,0.0,49,735,264,2640,313,3375
15802,2012-10-25,4,1,10,14,0,4,1,1,0.6,0.5909,0.73,0.1343,71,1065,214,2140,285,3205
15803,2012-10-25,4,1,10,15,0,4,1,1,0.62,0.6061,0.65,0.1343,63,945,242,2420,305,3365
15804,2012-10-25,4,1,10,16,0,4,1,1,0.6,0.5909,0.69,0.1642,92,1380,407,4070,499,5450
15805,2012-10-25,4,1,10,17,0,4,1,1,0.6,0.5909,0.69,0.1642,112,1680,774,7740,886,9420
15806,2012-10-25,4,1,10,18,0,4,1,1,0.56,0.5303,0.83,0.1045,77,1155,732,7320,809,8475
15807,2012-10-25,4,1,10,19,0,4,1,1,0.54,0.5152,0.83,0.194,45,675,497,4970,542,5645
15808,2012-10-25,4,1,10,20,0,4,1,2,0.52,0.5,0.88,0.1343,28,420,319,3190,347,3610
15809,2012-10-25,4,1,10,21,0,4,1,2,0.52,0.5,0.88,0.1343,24,360,247,2470,271,2830
15810,2012-10-25,4,1,10,22,0,4,1,2,0.54,0.5152,0.83,0.0896,22,330,185,1850,207,2180
15811,2012-10-25,4,1,10,23,0,4,1,2,0.54,0.5152,0.83,0.1343,13,195,122,1220,135,1415
15812,2012-10-26,4,1,10,0,0,5,1,2,0.54,0.5152,0.77,0.0,6,90,65,650,71,740
15813,2012-10-26,4,1,10,1,0,5,1,2,0.52,0.5,0.88,0.0896,4,60,32,320,36,380
15814,2012-10-26,4,1,10,2,0,5,1,2,0.52,0.5,0.88,0.1045,4,60,15,150,19,210
15815,2012-10-26,4,1,10,3,0,5,1,2,0.52,0.5,0.88,0.1642,5,75,8,80,13,155
15816,2012-10-26,4,1,10,4,0,5,1,2,0.52,0.5,0.88,0.1642,1,15,4,40,5,55
15817,2012-10-26,4,1,10,5,0,5,1,2,0.52,0.5,0.88,0.1045,3,45,47,470,50,515
15818,2012-10-26,4,1,10,6,0,5,1,2,0.52,0.5,0.88,0.0896,2,30,142,1420,144,1450
15819,2012-10-26,4,1,10,7,0,5,1,2,0.52,0.5,0.88,0.1045,13,195,408,4080,421,4275
15820,2012-10-26,4,1,10,8,0,5,1,2,0.54,0.5152,0.88,0.1343,20,300,714,7140,734,7440
15821,2012-10-26,4,1,10,9,0,5,1,2,0.54,0.5152,0.88,0.1343,56,840,347,3470,403,4310
15822,2012-10-26,4,1,10,10,0,5,1,2,0.54,0.5152,0.88,0.1045,41,615,156,1560,197,2175
15823,2012-10-26,4,1,10,11,0,5,1,2,0.56,0.5303,0.78,0.1642,68,1020,222,2220,290,3240
15824,2012-10-26,4,1,10,12,0,5,1,2,0.58,0.5455,0.73,0.194,90,1350,302,3020,392,4370
15825,2012-10-26,4,1,10,13,0,5,1,2,0.58,0.5455,0.68,0.1343,77,1155,260,2600,337,3755
15826,2012-10-26,4,1,10,14,0,5,1,2,0.6,0.6061,0.64,0.1343,99,1485,252,2520,351,4005
15827,2012-10-26,4,1,10,15,0,5,1,2,0.62,0.6061,0.61,0.1045,142,2130,306,3060,448,5190
15828,2012-10-26,4,1,10,16,0,5,1,2,0.58,0.5455,0.73,0.1642,137,2055,445,4450,582,6505
15829,2012-10-26,4,1,10,17,0,5,1,2,0.56,0.5303,0.76,0.194,125,1875,692,6920,817,8795
15830,2012-10-26,4,1,10,18,0,5,1,2,0.56,0.5303,0.78,0.1343,81,1215,584,5840,665,7055
15831,2012-10-26,4,1,10,19,0,5,1,2,0.54,0.5152,0.83,0.1642,72,1080,399,3990,471,5070
15832,2012-10-26,4,1,10,20,0,5,1,2,0.54,0.5152,0.83,0.1642,40,600,271,2710,311,3310
15833,2012-10-26,4,1,10,21,0,5,1,2,0.54,0.5152,0.77,0.1343,40,600,252,2520,292,3120
15834,2012-10-26,4,1,10,22,0,5,1,2,0.52,0.5,0.83,0.1343,37,555,180,1800,217,2355
15835,2012-10-26,4,1,10,23,0,5,1,1,0.52,0.5,0.83,0.1642,19,285,159,1590,178,1875
15836,2012-10-27,4,1,10,0,0,6,0,1,0.5,0.4848,0.88,0.1343,10,150,132,1320,142,1470
15837,2012-10-27,4,1,10,1,0,6,0,2,0.5,0.4848,0.88,0.1343,23,345,123,1230,146,1575
15838,2012-10-27,4,1,10,2,0,6,0,2,0.5,0.4848,0.88,0.194,19,285,71,710,90,995
15839,2012-10-27,4,1,10,3,0,6,0,1,0.5,0.4848,0.88,0.1642,5,75,21,210,26,285
15840,2012-10-27,4,1,10,4,0,6,0,2,0.5,0.4848,0.88,0.1642,1,15,12,120,13,135
15841,2012-10-27,4,1,10,5,0,6,0,2,0.5,0.4848,0.82,0.194,2,30,7,70,9,100
15842,2012-10-27,4,1,10,6,0,6,0,2,0.5,0.4848,0.82,0.194,2,30,29,290,31,320
15843,2012-10-27,4,1,10,7,0,6,0,1,0.48,0.4697,0.83,0.194,7,105,79,790,86,895
15844,2012-10-27,4,1,10,8,0,6,0,1,0.5,0.4848,0.77,0.2537,26,390,187,1870,213,2260
15845,2012-10-27,4,1,10,9,0,6,0,1,0.5,0.4848,0.77,0.2537,88,1320,240,2400,328,3720
15846,2012-10-27,4,1,10,10,0,6,0,1,0.54,0.5152,0.73,0.2836,165,2475,314,3140,479,5615
15847,2012-10-27,4,1,10,11,0,6,0,1,0.56,0.5303,0.64,0.2836,197,2955,388,3880,585,6835
15848,2012-10-27,4,1,10,12,0,6,0,1,0.6,0.6212,0.53,0.2537,264,3960,404,4040,668,8000
15849,2012-10-27,4,1,10,13,0,6,0,1,0.6,0.6212,0.43,0.2537,310,4650,450,4500,760,9150
15850,2012-10-27,4,1,10,14,0,6,0,1,0.6,0.6212,0.46,0.2537,325,4875,425,4250,750,9125
15851,2012-10-27,4,1,10,15,0,6,0,2,0.56,0.5303,0.6,0.2836,310,4650,401,4010,711,8660
15852,2012-10-27,4,1,10,16,0,6,0,2,0.56,0.5303,0.64,0.2836,257,3855,355,3550,612,7405
15853,2012-10-27,4,1,10,17,0,6,0,2,0.56,0.5303,0.64,0.2836,248,3720,370,3700,618,7420
15854,2012-10-27,4,1,10,18,0,6,0,2,0.56,0.5303,0.64,0.2836,138,2070,318,3180,456,5250
15855,2012-10-27,4,1,10,19,0,6,0,2,0.52,0.5,0.72,0.2239,67,1005,233,2330,300,3335
15856,2012-10-27,4,1,10,20,0,6,0,2,0.52,0.5,0.72,0.2239,58,870,238,2380,296,3250
15857,2012-10-27,4,1,10,21,0,6,0,2,0.52,0.5,0.72,0.2239,49,735,160,1600,209,2335
15858,2012-10-27,4,1,10,22,0,6,0,2,0.52,0.5,0.72,0.2537,41,615,116,1160,157,1775
15859,2012-10-27,4,1,10,23,0,6,0,2,0.52,0.5,0.68,0.3881,31,465,136,1360,167,1825
15860,2012-10-28,4,1,10,0,0,0,0,3,0.52,0.5,0.68,0.2985,20,300,97,970,117,1270
15861,2012-10-28,4,1,10,1,0,0,0,2,0.5,0.4848,0.72,0.2836,22,330,111,1110,133,1440
15862,2012-10-28,4,1,10,2,0,0,0,2,0.5,0.4848,0.68,0.2985,17,255,99,990,116,1245
15863,2012-10-28,4,1,10,3,0,0,0,2,0.5,0.4848,0.63,0.3284,18,270,61,610,79,880
15864,2012-10-28,4,1,10,4,0,0,0,2,0.5,0.4848,0.63,0.3582,1,15,19,190,20,205
15865,2012-10-28,4,1,10,5,0,0,0,2,0.5,0.4848,0.63,0.2985,6,90,22,220,28,310
15866,2012-10-28,4,1,10,6,0,0,0,2,0.5,0.4848,0.59,0.3284,7,105,32,320,39,425
15867,2012-10-28,4,1,10,7,0,0,0,2,0.5,0.4848,0.59,0.2985,17,255,48,480,65,735
15868,2012-10-28,4,1,10,8,0,0,0,2,0.5,0.4848,0.59,0.5522,55,825,118,1180,173,2005
15869,2012-10-28,4,1,10,9,0,0,0,2,0.5,0.4848,0.55,0.4179,124,1860,206,2060,330,3920
15870,2012-10-28,4,1,10,10,0,0,0,2,0.48,0.4697,0.51,0.4179,120,1800,314,3140,434,4940
15871,2012-10-28,4,1,10,11,0,0,0,2,0.5,0.4848,0.51,0.3881,110,1650,352,3520,462,5170
15872,2012-10-28,4,1,10,12,0,0,0,2,0.48,0.4697,0.59,0.4925,118,1770,373,3730,491,5500
15873,2012-10-28,4,1,10,13,0,0,0,2,0.48,0.4697,0.59,0.4179,75,1125,316,3160,391,4285
15874,2012-10-28,4,1,10,14,0,0,0,2,0.5,0.4848,0.59,0.4478,98,1470,304,3040,402,4510
15875,2012-10-28,4,1,10,15,0,0,0,2,0.5,0.4848,0.63,0.4925,76,1140,225,2250,301,3390
15876,2012-10-28,4,1,10,16,0,0,0,3,0.48,0.4697,0.67,0.4627,42,630,251,2510,293,3140
15877,2012-10-28,4,1,10,17,0,0,0,3,0.46,0.4545,0.77,0.5224,37,555,188,1880,225,2435
15878,2012-10-28,4,1,10,18,0,0,0,3,0.42,0.4242,0.94,0.4925,18,270,136,1360,154,1630
15879,2012-10-28,4,1,10,19,0,0,0,3,0.42,0.4242,0.94,0.3582,7,105,47,470,54,575
15880,2012-10-28,4,1,10,20,0,0,0,3,0.42,0.4242,0.94,0.4627,4,60,51,510,55,570
15881,2012-10-28,4,1,10,21,0,0,0,3,0.44,0.4394,0.88,0.4179,2,30,44,440,46,470
15882,2012-10-28,4,1,10,22,0,0,0,3,0.44,0.4394,0.88,0.3582,2,30,35,350,37,380
15883,2012-10-28,4,1,10,23,0,0,0,3,0.42,0.4242,0.94,0.3582,2,30,12,120,14,150
15884,2012-10-29,4,1,10,0,0,1,1,3,0.44,0.4394,0.88,0.3582,2,30,20,200,22,230
15885,2012-10-30,4,1,10,13,0,2,1,3,0.3,0.2727,0.81,0.3582,11,165,105,1050,116,1215
15886,2012-10-30,4,1,10,14,0,2,1,3,0.3,0.2727,0.81,0.3582,8,120,118,1180,126,1300
15887,2012-10-30,4,1,10,15,0,2,1,3,0.3,0.2879,0.87,0.2537,10,150,114,1140,124,1290
15888,2012-10-30,4,1,10,16,0,2,1,3,0.3,0.2879,0.87,0.2537,15,225,83,830,98,1055
15889,2012-10-30,4,1,10,17,0,2,1,3,0.3,0.2879,0.87,0.2239,19,285,105,1050,124,1335
15890,2012-10-30,4,1,10,18,0,2,1,3,0.3,0.303,0.87,0.1343,4,60,139,1390,143,1450
15891,2012-10-30,4,1,10,19,0,2,1,2,0.5,0.4848,0.68,0.194,6,90,109,1090,115,1180
15892,2012-10-30,4,1,10,20,0,2,1,2,0.3,0.2879,0.81,0.194,5,75,76,760,81,835
15893,2012-10-30,4,1,10,21,0,2,1,2,0.3,0.3182,0.87,0.1045,4,60,60,600,64,660
15894,2012-10-30,4,1,10,22,0,2,1,1,0.3,0.303,0.81,0.1343,2,30,64,640,66,670
15895,2012-10-30,4,1,10,23,0,2,1,1,0.3,0.303,0.81,0.1343,3,45,36,360,39,405
15896,2012-10-31,4,1,10,0,0,3,1,2,0.3,0.3182,0.81,0.1045,0,0,16,160,16,160
15897,2012-10-31,4,1,10,1,0,3,1,2,0.3,0.3182,0.81,0.0896,0,0,8,80,8,80
15898,2012-10-31,4,1,10,2,0,3,1,2,0.3,0.303,0.81,0.1343,0,0,7,70,7,70
15899,2012-10-31,4,1,10,3,0,3,1,2,0.3,0.3182,0.81,0.1045,0,0,3,30,3,30
15900,2012-10-31,4,1,10,4,0,3,1,2,0.3,0.2879,0.87,0.194,0,0,5,50,5,50
15901,2012-10-31,4,1,10,5,0,3,1,2,0.3,0.303,0.81,0.1343,0,0,24,240,24,240
15902,2012-10-31,4,1,10,6,0,3,1,1,0.3,0.303,0.81,0.1642,0,0,116,1160,116,1160
15903,2012-10-31,4,1,10,7,0,3,1,2,0.3,0.303,0.87,0.1343,3,45,334,3340,337,3385
15904,2012-10-31,4,1,10,8,0,3,1,1,0.32,0.3333,0.81,0.1343,6,90,615,6150,621,6240
15905,2012-10-31,4,1,10,9,0,3,1,1,0.34,0.3333,0.76,0.1343,17,255,280,2800,297,3055
15906,2012-10-31,4,1,10,10,0,3,1,1,0.36,0.3333,0.71,0.2836,21,315,147,1470,168,1785
15907,2012-10-31,4,1,10,11,0,3,1,2,0.36,0.3485,0.66,0.2239,37,555,152,1520,189,2075
15908,2012-10-31,4,1,10,12,0,3,1,1,0.4,0.4091,0.58,0.194,44,660,197,1970,241,2630
15909,2012-10-31,4,1,10,13,0,3,1,1,0.42,0.4242,0.5,0.2239,22,330,191,1910,213,2240
15910,2012-10-31,4,1,10,14,0,3,1,2,0.42,0.4242,0.5,0.2239,45,675,179,1790,224,2465
15911,2012-10-31,4,1,10,15,0,3,1,1,0.42,0.4242,0.54,0.1642,33,495,197,1970,230,2465
15912,2012-10-31,4,1,10,16,0,3,1,2,0.42,0.4242,0.54,0.2239,51,765,373,3730,424,4495
15913,2012-10-31,4,1,10,17,0,3,1,2,0.4,0.4091,0.58,0.1642,39,585,684,6840,723,7425
15914,2012-10-31,4,1,10,18,0,3,1,2,0.4,0.4091,0.58,0.1642,28,420,556,5560,584,5980
15915,2012-10-31,4,1,10,19,0,3,1,2,0.4,0.4091,0.5,0.194,27,405,383,3830,410,4235
15916,2012-10-31,4,1,10,20,0,3,1,2,0.4,0.4091,0.5,0.194,9,135,259,2590,268,2725
15917,2012-10-31,4,1,10,21,0,3,1,2,0.4,0.4091,0.5,0.194,12,180,180,1800,192,1980
15918,2012-10-31,4,1,10,22,0,3,1,1,0.36,0.3485,0.57,0.1343,18,270,147,1470,165,1740
15919,2012-10-31,4,1,10,23,0,3,1,1,0.36,0.3636,0.57,0.0896,7,105,94,940,101,1045
15920,2012-11-01,4,1,11,0,0,4,1,1,0.36,0.3636,0.57,0.0896,8,120,52,520,60,640
15921,2012-11-01,4,1,11,1,0,4,1,1,0.3,0.3182,0.75,0.1045,8,120,22,220,30,340
15922,2012-11-01,4,1,11,2,0,4,1,1,0.32,0.3333,0.66,0.1343,10,150,10,100,20,250
15923,2012-11-01,4,1,11,3,0,4,1,1,0.34,0.3333,0.61,0.1343,5,75,10,100,15,175
15924,2012-11-01,4,1,11,4,0,4,1,2,0.34,0.3485,0.66,0.1045,2,30,8,80,10,110
15925,2012-11-01,4,1,11,5,0,4,1,1,0.34,0.3333,0.66,0.1343,1,15,39,390,40,405
15926,2012-11-01,4,1,11,6,0,4,1,1,0.34,0.3333,0.61,0.1642,2,30,146,1460,148,1490
15927,2012-11-01,4,1,11,7,0,4,1,2,0.36,0.3485,0.57,0.1642,6,90,414,4140,420,4230
15928,2012-11-01,4,1,11,8,0,4,1,2,0.36,0.3788,0.56,0.1045,12,180,668,6680,680,6860
15929,2012-11-01,4,1,11,9,0,4,1,3,0.36,0.3636,0.57,0.1045,21,315,310,3100,331,3415
15930,2012-11-01,4,1,11,10,0,4,1,3,0.36,0.3485,0.62,0.194,13,195,133,1330,146,1525
15931,2012-11-01,4,1,11,11,0,4,1,3,0.36,0.3485,0.62,0.194,14,210,156,1560,170,1770
15932,2012-11-01,4,1,11,12,0,4,1,3,0.38,0.3939,0.62,0.1642,23,345,198,1980,221,2325
15933,2012-11-01,4,1,11,13,0,4,1,2,0.4,0.4091,0.58,0.1642,49,735,199,1990,248,2725
15934,2012-11-01,4,1,11,14,0,4,1,2,0.4,0.4091,0.5,0.2239,31,465,154,1540,185,2005
15935,2012-11-01,4,1,11,15,0,4,1,2,0.4,0.4091,0.54,0.1642,35,525,179,1790,214,2315
15936,2012-11-01,4,1,11,16,0,4,1,2,0.4,0.4091,0.54,0.1642,31,465,313,3130,344,3595
15937,2012-11-01,4,1,11,17,0,4,1,3,0.4,0.4091,0.5,0.2239,37,555,652,6520,689,7075
15938,2012-11-01,4,1,11,18,0,4,1,2,0.4,0.4091,0.5,0.1642,50,750,628,6280,678,7030
15939,2012-11-01,4,1,11,19,0,4,1,2,0.4,0.4091,0.5,0.1642,28,420,424,4240,452,4660
15940,2012-11-01,4,1,11,20,0,4,1,2,0.38,0.3939,0.54,0.2537,16,240,280,2800,296,3040
15941,2012-11-01,4,1,11,21,0,4,1,2,0.38,0.3939,0.54,0.1343,29,435,238,2380,267,2815
15942,2012-11-01,4,1,11,22,0,4,1,1,0.36,0.3485,0.57,0.1642,27,405,175,1750,202,2155
15943,2012-11-01,4,1,11,23,0,4,1,1,0.34,0.3333,0.57,0.1642,8,120,112,1120,120,1240
15944,2012-11-02,4,1,11,0,0,5,1,1,0.34,0.3333,0.57,0.1642,10,150,40,400,50,550
15945,2012-11-02,4,1,11,1,0,5,1,1,0.32,0.3182,0.66,0.1642,5,75,19,190,24,265
15946,2012-11-02,4,1,11,2,0,5,1,1,0.32,0.3182,0.66,0.1642,3,45,7,70,10,115
15947,2012-11-02,4,1,11,3,0,5,1,1,0.3,0.303,0.7,0.1642,0,0,3,30,3,30
15948,2012-11-02,4,1,11,4,0,5,1,1,0.3,0.3182,0.7,0.1045,1,15,6,60,7,75
15949,2012-11-02,4,1,11,5,0,5,1,2,0.32,0.3182,0.66,0.1642,1,15,25,250,26,265
15950,2012-11-02,4,1,11,6,0,5,1,1,0.3,0.303,0.7,0.1642,2,30,120,1200,122,1230
15951,2012-11-02,4,1,11,7,0,5,1,2,0.3,0.303,0.7,0.1343,8,120,349,3490,357,3610
15952,2012-11-02,4,1,11,8,0,5,1,1,0.32,0.3333,0.57,0.1045,31,465,656,6560,687,7025
15953,2012-11-02,4,1,11,9,0,5,1,1,0.34,0.3485,0.53,0.1045,27,405,355,3550,382,3955
15954,2012-11-02,4,1,11,10,0,5,1,1,0.38,0.3939,0.46,0.2985,21,315,183,1830,204,2145
15955,2012-11-02,4,1,11,11,0,5,1,1,0.42,0.4242,0.41,0.4179,42,630,179,1790,221,2420
15956,2012-11-02,4,1,11,12,0,5,1,1,0.42,0.4242,0.41,0.3582,52,780,240,2400,292,3180
15957,2012-11-02,4,1,11,13,0,5,1,1,0.4,0.4091,0.43,0.3582,64,960,230,2300,294,3260
15958,2012-11-02,4,1,11,14,0,5,1,2,0.4,0.4091,0.4,0.4925,63,945,199,1990,262,2935
15959,2012-11-02,4,1,11,15,0,5,1,2,0.4,0.4091,0.4,0.4179,51,765,255,2550,306,3315
15960,2012-11-02,4,1,11,16,0,5,1,1,0.38,0.3939,0.4,0.3284,48,720,373,3730,421,4450
15961,2012-11-02,4,1,11,17,0,5,1,1,0.38,0.3939,0.4,0.3284,57,855,581,5810,638,6665
15962,2012-11-02,4,1,11,18,0,5,1,2,0.38,0.3939,0.43,0.3284,32,480,490,4900,522,5380
15963,2012-11-02,4,1,11,19,0,5,1,2,0.38,0.3939,0.43,0.2985,38,570,336,3360,374,3930
15964,2012-11-02,4,1,11,20,0,5,1,2,0.36,0.3333,0.46,0.4179,14,210,207,2070,221,2280
15965,2012-11-02,4,1,11,21,0,5,1,2,0.36,0.3333,0.46,0.3582,23,345,133,1330,156,1675
15966,2012-11-02,4,1,11,22,0,5,1,1,0.36,0.3333,0.46,0.2537,14,210,135,1350,149,1560
15967,2012-11-02,4,1,11,23,0,5,1,1,0.34,0.303,0.53,0.2985,11,165,108,1080,119,1245
15968,2012-11-03,4,1,11,0,0,6,0,1,0.34,0.3333,0.53,0.1642,9,135,99,990,108,1125
15969,2012-11-03,4,1,11,1,0,6,0,2,0.34,0.303,0.49,0.3284,6,90,83,830,89,920
15970,2012-11-03,4,1,11,2,0,6,0,2,0.34,0.3182,0.49,0.2537,10,150,36,360,46,510
15971,2012-11-03,4,1,11,3,0,6,0,2,0.34,0.3182,0.49,0.2537,6,90,22,220,28,310
15972,2012-11-03,4,1,11,4,0,6,0,2,0.32,0.303,0.49,0.2985,8,120,8,80,16,200
15973,2012-11-03,4,1,11,5,0,6,0,2,0.32,0.303,0.49,0.2537,1,15,8,80,9,95
15974,2012-11-03,4,1,11,6,0,6,0,2,0.32,0.3182,0.49,0.194,4,60,17,170,21,230
15975,2012-11-03,4,1,11,7,0,6,0,2,0.32,0.303,0.49,0.2537,1,15,58,580,59,595
15976,2012-11-03,4,1,11,8,0,6,0,2,0.34,0.303,0.46,0.2985,10,150,132,1320,142,1470
15977,2012-11-03,4,1,11,9,0,6,0,2,0.34,0.303,0.49,0.2985,31,465,188,1880,219,2345
15978,2012-11-03,4,1,11,10,0,6,0,1,0.36,0.3333,0.46,0.3881,68,1020,260,2600,328,3620
15979,2012-11-03,4,1,11,11,0,6,0,2,0.36,0.3333,0.46,0.3881,56,840,284,2840,340,3680
15980,2012-11-03,4,1,11,12,0,6,0,2,0.36,0.3182,0.46,0.4627,74,1110,320,3200,394,4310
15981,2012-11-03,4,1,11,13,0,6,0,2,0.36,0.3333,0.46,0.3582,110,1650,339,3390,449,5040
15982,2012-11-03,4,1,11,14,0,6,0,2,0.36,0.3333,0.5,0.3284,136,2040,319,3190,455,5230
15983,2012-11-03,4,1,11,15,0,6,0,2,0.36,0.3182,0.46,0.4478,117,1755,331,3310,448,5065
15984,2012-11-03,4,1,11,16,0,6,0,2,0.36,0.3333,0.46,0.3284,108,1620,292,2920,400,4540
15985,2012-11-03,4,1,11,17,0,6,0,2,0.36,0.3333,0.46,0.2985,112,1680,298,2980,410,4660
15986,2012-11-03,4,1,11,18,0,6,0,2,0.36,0.3333,0.46,0.2836,58,870,239,2390,297,3260
15987,2012-11-03,4,1,11,19,0,6,0,1,0.36,0.3485,0.5,0.1642,22,330,217,2170,239,2500
15988,2012-11-03,4,1,11,20,0,6,0,1,0.34,0.3333,0.53,0.1343,23,345,158,1580,181,1925
15989,2012-11-03,4,1,11,21,0,6,0,1,0.34,0.3485,0.53,0.1045,31,465,135,1350,166,1815
15990,2012-11-03,4,1,11,22,0,6,0,1,0.32,0.3333,0.57,0.1045,13,195,133,1330,146,1525
15991,2012-11-03,4,1,11,23,0,6,0,1,0.32,0.3333,0.57,0.1045,15,225,133,1330,148,1555
15992,2012-11-04,4,1,11,0,0,0,0,1,0.3,0.3182,0.61,0.1045,5,75,97,970,102,1045
15993,2012-11-04,4,1,11,1,0,0,0,1,0.26,0.2879,0.81,0.0896,26,390,139,1390,165,1780
15994,2012-11-04,4,1,11,2,0,0,0,1,0.3,0.3333,0.65,0.0,6,90,31,310,37,400
15995,2012-11-04,4,1,11,3,0,0,0,1,0.28,0.2879,0.61,0.1045,1,15,10,100,11,115
15996,2012-11-04,4,1,11,4,0,0,0,1,0.26,0.2727,0.65,0.1343,2,30,7,70,9,100
15997,2012-11-04,4,1,11,5,0,0,0,1,0.26,0.2727,0.65,0.1045,0,0,5,50,5,50
15998,2012-11-04,4,1,11,6,0,0,0,1,0.28,0.2879,0.61,0.1343,2,30,14,140,16,170
15999,2012-11-04,4,1,11,7,0,0,0,1,0.26,0.2727,0.65,0.1045,11,165,39,390,50,555
16000,2012-11-04,4,1,11,8,0,0,0,1,0.3,0.303,0.56,0.1343,34,510,115,1150,149,1660
16001,2012-11-04,4,1,11,9,0,0,0,1,0.32,0.3333,0.53,0.0,56,840,161,1610,217,2450
16002,2012-11-04,4,1,11,10,0,0,0,1,0.34,0.3333,0.49,0.194,73,1095,287,2870,360,3965
16003,2012-11-04,4,1,11,11,0,0,0,1,0.38,0.3939,0.46,0.2239,134,2010,311,3110,445,5120
16004,2012-11-04,4,1,11,12,0,0,0,1,0.38,0.3939,0.46,0.2239,150,2250,354,3540,504,5790
16005,2012-11-04,4,1,11,13,0,0,0,1,0.4,0.4091,0.43,0.2239,122,1830,371,3710,493,5540
16006,2012-11-04,4,1,11,14,0,0,0,1,0.4,0.4091,0.4,0.194,149,2235,360,3600,509,5835
16007,2012-11-04,4,1,11,15,0,0,0,1,0.4,0.4091,0.4,0.2239,149,2235,300,3000,449,5235
16008,2012-11-04,4,1,11,16,0,0,0,1,0.4,0.4091,0.4,0.3284,119,1785,316,3160,435,4945
16009,2012-11-04,4,1,11,17,0,0,0,1,0.36,0.3485,0.43,0.194,57,855,270,2700,327,3555
16010,2012-11-04,4,1,11,18,0,0,0,1,0.36,0.3485,0.43,0.2239,31,465,206,2060,237,2525
16011,2012-11-04,4,1,11,19,0,0,0,1,0.36,0.3333,0.43,0.2537,24,360,203,2030,227,2390
16012,2012-11-04,4,1,11,20,0,0,0,1,0.32,0.2879,0.53,0.3582,7,105,134,1340,141,1445
16013,2012-11-04,4,1,11,21,0,0,0,1,0.3,0.2727,0.52,0.2985,16,240,71,710,87,950
16014,2012-11-04,4,1,11,22,0,0,0,1,0.3,0.2879,0.52,0.2836,15,225,64,640,79,865
16015,2012-11-04,4,1,11,23,0,0,0,2,0.3,0.303,0.56,0.1642,12,180,41,410,53,590
16016,2012-11-05,4,1,11,0,0,1,1,2,0.3,0.2879,0.56,0.194,3,45,20,200,23,245
16017,2012-11-05,4,1,11,1,0,1,1,2,0.3,0.303,0.56,0.1642,0,0,8,80,8,80
16018,2012-11-05,4,1,11,2,0,1,1,2,0.3,0.303,0.56,0.1642,2,30,4,40,6,70
16019,2012-11-05,4,1,11,3,0,1,1,2,0.3,0.2879,0.56,0.2239,1,15,3,30,4,45
16020,2012-11-05,4,1,11,4,0,1,1,2,0.3,0.2879,0.52,0.2537,5,75,11,110,16,185
16021,2012-11-05,4,1,11,5,0,1,1,2,0.3,0.2727,0.52,0.3284,1,15,38,380,39,395
16022,2012-11-05,4,1,11,6,0,1,1,2,0.3,0.2879,0.49,0.2836,4,60,135,1350,139,1410
16023,2012-11-05,4,1,11,7,0,1,1,2,0.3,0.2879,0.49,0.2537,8,120,453,4530,461,4650
16024,2012-11-05,4,1,11,8,0,1,1,2,0.3,0.2879,0.49,0.2239,19,285,629,6290,648,6575
16025,2012-11-05,4,1,11,9,0,1,1,2,0.3,0.2879,0.52,0.2836,18,270,239,2390,257,2660
16026,2012-11-05,4,1,11,10,0,1,1,1,0.32,0.303,0.49,0.2836,30,450,112,1120,142,1570
16027,2012-11-05,4,1,11,11,0,1,1,1,0.34,0.3182,0.46,0.2239,31,465,119,1190,150,1655
16028,2012-11-05,4,1,11,12,0,1,1,1,0.36,0.3333,0.43,0.3284,38,570,206,2060,244,2630
16029,2012-11-05,4,1,11,13,0,1,1,1,0.36,0.3333,0.4,0.2537,39,585,183,1830,222,2415
16030,2012-11-05,4,1,11,14,0,1,1,1,0.38,0.3939,0.4,0.1642,31,465,165,1650,196,2115
16031,2012-11-05,4,1,11,15,0,1,1,1,0.38,0.3939,0.4,0.2836,24,360,207,2070,231,2430
16032,2012-11-05,4,1,11,16,0,1,1,1,0.36,0.3333,0.43,0.2836,35,525,325,3250,360,3775
16033,2012-11-05,4,1,11,17,0,1,1,1,0.34,0.3182,0.46,0.2239,34,510,604,6040,638,6550
16034,2012-11-05,4,1,11,18,0,1,1,1,0.34,0.3182,0.46,0.2239,19,285,523,5230,542,5515
16035,2012-11-05,4,1,11,19,0,1,1,1,0.32,0.3182,0.49,0.1642,11,165,361,3610,372,3775
16036,2012-11-05,4,1,11,20,0,1,1,1,0.32,0.303,0.49,0.2537,13,195,228,2280,241,2475
16037,2012-11-05,4,1,11,21,0,1,1,1,0.3,0.2879,0.52,0.2836,8,120,144,1440,152,1560
16038,2012-11-05,4,1,11,22,0,1,1,1,0.28,0.2727,0.56,0.194,4,60,111,1110,115,1170
16039,2012-11-05,4,1,11,23,0,1,1,1,0.26,0.2727,0.6,0.1343,0,0,53,530,53,530
16040,2012-11-06,4,1,11,0,0,2,1,1,0.24,0.2576,0.6,0.1045,1,15,18,180,19,195
16041,2012-11-06,4,1,11,1,0,2,1,1,0.24,0.2424,0.6,0.1642,0,0,8,80,8,80
16042,2012-11-06,4,1,11,2,0,2,1,1,0.24,0.2576,0.65,0.0896,0,0,2,20,2,20
16043,2012-11-06,4,1,11,3,0,2,1,1,0.22,0.2424,0.64,0.1045,0,0,4,40,4,40
16044,2012-11-06,4,1,11,4,0,2,1,1,0.22,0.2576,0.69,0.0896,0,0,7,70,7,70
16045,2012-11-06,4,1,11,5,0,2,1,2,0.22,0.2273,0.64,0.194,1,15,40,400,41,415
16046,2012-11-06,4,1,11,6,0,2,1,1,0.22,0.2273,0.69,0.1343,6,90,143,1430,149,1520
16047,2012-11-06,4,1,11,7,0,2,1,1,0.2,0.2121,0.69,0.1642,9,135,378,3780,387,3915
16048,2012-11-06,4,1,11,8,0,2,1,1,0.22,0.2273,0.69,0.1642,20,300,568,5680,588,5980
16049,2012-11-06,4,1,11,9,0,2,1,1,0.26,0.2576,0.6,0.1642,25,375,338,3380,363,3755
16050,2012-11-06,4,1,11,10,0,2,1,1,0.3,0.2879,0.49,0.194,41,615,189,1890,230,2505
16051,2012-11-06,4,1,11,11,0,2,1,1,0.32,0.3333,0.45,0.1343,39,585,177,1770,216,2355
16052,2012-11-06,4,1,11,12,0,2,1,1,0.32,0.3333,0.45,0.1343,31,465,217,2170,248,2635
16053,2012-11-06,4,1,11,13,0,2,1,1,0.34,0.3333,0.46,0.1343,46,690,232,2320,278,3010
16054,2012-11-06,4,1,11,14,0,2,1,1,0.36,0.3636,0.4,0.1045,44,660,196,1960,240,2620
16055,2012-11-06,4,1,11,15,0,2,1,1,0.34,0.3182,0.46,0.2537,45,675,227,2270,272,2945
16056,2012-11-06,4,1,11,16,0,2,1,1,0.34,0.3333,0.46,0.1642,33,495,369,3690,402,4185
16057,2012-11-06,4,1,11,17,0,2,1,1,0.32,0.303,0.53,0.2239,30,450,597,5970,627,6420
16058,2012-11-06,4,1,11,18,0,2,1,1,0.32,0.303,0.57,0.2985,20,300,477,4770,497,5070
16059,2012-11-06,4,1,11,19,0,2,1,1,0.3,0.2879,0.56,0.2239,15,225,356,3560,371,3785
16060,2012-11-06,4,1,11,20,0,2,1,1,0.3,0.2879,0.61,0.2239,10,150,218,2180,228,2330
16061,2012-11-06,4,1,11,21,0,2,1,2,0.3,0.2879,0.56,0.2537,14,210,137,1370,151,1580
16062,2012-11-06,4,1,11,22,0,2,1,2,0.3,0.2879,0.56,0.2239,17,255,136,1360,153,1615
16063,2012-11-06,4,1,11,23,0,2,1,1,0.3,0.2879,0.56,0.2239,19,285,186,1860,205,2145
16064,2012-11-07,4,1,11,0,0,3,1,2,0.3,0.2879,0.56,0.2836,49,735,234,2340,283,3075
16065,2012-11-07,4,1,11,1,0,3,1,2,0.28,0.2727,0.61,0.2537,6,90,86,860,92,950
16066,2012-11-07,4,1,11,2,0,3,1,2,0.28,0.2576,0.56,0.2985,6,90,68,680,74,770
16067,2012-11-07,4,1,11,3,0,3,1,2,0.28,0.2576,0.52,0.3284,2,30,9,90,11,120
16068,2012-11-07,4,1,11,4,0,3,1,2,0.28,0.2576,0.52,0.2985,0,0,9,90,9,90
16069,2012-11-07,4,1,11,5,0,3,1,2,0.28,0.2576,0.52,0.3284,0,0,27,270,27,270
16070,2012-11-07,4,1,11,6,0,3,1,2,0.26,0.2424,0.56,0.2836,3,45,115,1150,118,1195
16071,2012-11-07,4,1,11,7,0,3,1,2,0.26,0.2273,0.56,0.2985,5,75,314,3140,319,3215
16072,2012-11-07,4,1,11,8,0,3,1,2,0.26,0.2424,0.6,0.2836,18,270,583,5830,601,6100
16073,2012-11-07,4,1,11,9,0,3,1,2,0.26,0.2424,0.6,0.2836,17,255,351,3510,368,3765
16074,2012-11-07,4,1,11,10,0,3,1,2,0.28,0.2576,0.56,0.2985,27,405,151,1510,178,1915
16075,2012-11-07,4,1,11,11,0,3,1,2,0.32,0.2879,0.51,0.3582,15,225,132,1320,147,1545
16076,2012-11-07,4,1,11,12,0,3,1,2,0.32,0.303,0.53,0.2836,24,360,188,1880,212,2240
16077,2012-11-07,4,1,11,13,0,3,1,2,0.32,0.303,0.53,0.2537,23,345,158,1580,181,1925
16078,2012-11-07,4,1,11,14,0,3,1,2,0.32,0.2879,0.53,0.3582,19,285,142,1420,161,1705
16079,2012-11-07,4,1,11,15,0,3,1,2,0.32,0.303,0.53,0.2985,20,300,178,1780,198,2080
16080,2012-11-07,4,1,11,16,0,3,1,2,0.32,0.2879,0.53,0.3582,23,345,250,2500,273,2845
16081,2012-11-07,4,1,11,17,0,3,1,2,0.32,0.2879,0.53,0.3881,16,240,501,5010,517,5250
16082,2012-11-07,4,1,11,18,0,3,1,2,0.32,0.2879,0.53,0.3582,17,255,448,4480,465,4735
16083,2012-11-07,4,1,11,19,0,3,1,2,0.3,0.2727,0.56,0.2985,17,255,302,3020,319,3275
16084,2012-11-07,4,1,11,20,0,3,1,2,0.32,0.303,0.49,0.3284,7,105,249,2490,256,2595
16085,2012-11-07,4,1,11,21,0,3,1,2,0.32,0.303,0.49,0.2985,5,75,121,1210,126,1285
16086,2012-11-07,4,1,11,22,0,3,1,3,0.3,0.2879,0.56,0.2537,4,60,56,560,60,620
16087,2012-11-07,4,1,11,23,0,3,1,3,0.28,0.2727,0.65,0.2239,3,45,37,370,40,415
16088,2012-11-08,4,1,11,0,0,4,1,3,0.28,0.2727,0.61,0.2239,1,15,14,140,15,155
16089,2012-11-08,4,1,11,1,0,4,1,3,0.3,0.2727,0.52,0.3582,1,15,11,110,12,125
16090,2012-11-08,4,1,11,2,0,4,1,2,0.3,0.2879,0.49,0.2239,1,15,5,50,6,65
16091,2012-11-08,4,1,11,4,0,4,1,2,0.3,0.2879,0.45,0.2836,1,15,9,90,10,105
16092,2012-11-08,4,1,11,5,0,4,1,2,0.3,0.2879,0.42,0.2239,0,0,35,350,35,350
16093,2012-11-08,4,1,11,6,0,4,1,1,0.3,0.2879,0.39,0.2239,2,30,122,1220,124,1250
16094,2012-11-08,4,1,11,7,0,4,1,1,0.28,0.2576,0.36,0.3881,12,180,411,4110,423,4290
16095,2012-11-08,4,1,11,8,0,4,1,1,0.3,0.2879,0.33,0.2836,16,240,652,6520,668,6760
16096,2012-11-08,4,1,11,9,0,4,1,1,0.32,0.2879,0.31,0.3582,22,330,253,2530,275,2860
16097,2012-11-08,4,1,11,10,0,4,1,1,0.32,0.303,0.31,0.3284,13,195,148,1480,161,1675
16098,2012-11-08,4,1,11,11,0,4,1,1,0.36,0.3333,0.29,0.3881,16,240,155,1550,171,1790
16099,2012-11-08,4,1,11,12,0,4,1,1,0.4,0.4091,0.24,0.4925,33,495,202,2020,235,2515
16100,2012-11-08,4,1,11,13,0,4,1,1,0.44,0.4394,0.18,0.4179,33,495,195,1950,228,2445
16101,2012-11-08,4,1,11,14,0,4,1,1,0.44,0.4394,0.18,0.4179,33,495,149,1490,182,1985
16102,2012-11-08,4,1,11,15,0,4,1,1,0.44,0.4394,0.18,0.4179,32,480,201,2010,233,2490
16103,2012-11-08,4,1,11,16,0,4,1,1,0.42,0.4242,0.16,0.3881,18,270,321,3210,339,3480
16104,2012-11-08,4,1,11,17,0,4,1,1,0.4,0.4091,0.2,0.2985,36,540,556,5560,592,6100
16105,2012-11-08,4,1,11,18,0,4,1,1,0.4,0.4091,0.24,0.4179,16,240,491,4910,507,5150
16106,2012-11-08,4,1,11,19,0,4,1,1,0.38,0.3939,0.27,0.3582,14,210,359,3590,373,3800
16107,2012-11-08,4,1,11,20,0,4,1,1,0.38,0.3939,0.29,0.4627,10,150,235,2350,245,2500
16108,2012-11-08,4,1,11,21,0,4,1,1,0.36,0.3333,0.37,0.3881,11,165,222,2220,233,2385
16109,2012-11-08,4,1,11,22,0,4,1,1,0.34,0.303,0.42,0.2985,14,210,147,1470,161,1680
16110,2012-11-08,4,1,11,23,0,4,1,1,0.34,0.303,0.46,0.3582,5,75,82,820,87,895
16111,2012-11-09,4,1,11,0,0,5,1,1,0.34,0.303,0.49,0.3284,9,135,46,460,55,595
16112,2012-11-09,4,1,11,1,0,5,1,1,0.32,0.303,0.53,0.2836,3,45,17,170,20,215
16113,2012-11-09,4,1,11,2,0,5,1,1,0.32,0.303,0.53,0.2537,1,15,11,110,12,125
16114,2012-11-09,4,1,11,3,0,5,1,1,0.32,0.2879,0.53,0.4179,3,45,6,60,9,105
16115,2012-11-09,4,1,11,4,0,5,1,1,0.32,0.2879,0.53,0.3582,0,0,14,140,14,140
16116,2012-11-09,4,1,11,5,0,5,1,1,0.3,0.2879,0.56,0.194,2,30,25,250,27,280
16117,2012-11-09,4,1,11,6,0,5,1,1,0.26,0.2727,0.65,0.1045,5,75,126,1260,131,1335
16118,2012-11-09,4,1,11,7,0,5,1,1,0.26,0.2727,0.65,0.1343,9,135,332,3320,341,3455
16119,2012-11-09,4,1,11,8,0,5,1,1,0.32,0.3182,0.57,0.1642,25,375,668,6680,693,7055
16120,2012-11-09,4,1,11,9,0,5,1,1,0.34,0.303,0.53,0.4179,23,345,304,3040,327,3385
16121,2012-11-09,4,1,11,10,0,5,1,1,0.36,0.3333,0.5,0.3284,34,510,163,1630,197,2140
16122,2012-11-09,4,1,11,11,0,5,1,1,0.4,0.4091,0.47,0.2985,66,990,185,1850,251,2840
16123,2012-11-09,4,1,11,12,0,5,1,1,0.44,0.4394,0.41,0.3284,48,720,214,2140,262,2860
16124,2012-11-09,4,1,11,13,0,5,1,1,0.46,0.4545,0.38,0.2985,62,930,237,2370,299,3300
16125,2012-11-09,4,1,11,14,0,5,1,1,0.46,0.4545,0.38,0.194,67,1005,207,2070,274,3075
16126,2012-11-09,4,1,11,15,0,5,1,1,0.46,0.4545,0.36,0.2239,78,1170,278,2780,356,3950
16127,2012-11-09,4,1,11,16,0,5,1,1,0.46,0.4545,0.38,0.1642,57,855,377,3770,434,4625
16128,2012-11-09,4,1,11,17,0,5,1,1,0.42,0.4242,0.44,0.1343,61,915,593,5930,654,6845
16129,2012-11-09,4,1,11,18,0,5,1,1,0.42,0.4242,0.44,0.1045,46,690,450,4500,496,5190
16130,2012-11-09,4,1,11,19,0,5,1,1,0.34,0.3485,0.71,0.0896,30,450,331,3310,361,3760
16131,2012-11-09,4,1,11,20,0,5,1,1,0.36,0.3485,0.66,0.1343,20,300,235,2350,255,2650
16132,2012-11-09,4,1,11,21,0,5,1,1,0.34,0.3636,0.76,0.0,23,345,176,1760,199,2105
16133,2012-11-09,4,1,11,22,0,5,1,1,0.34,0.3485,0.71,0.1045,17,255,146,1460,163,1715
16134,2012-11-09,4,1,11,23,0,5,1,1,0.32,0.3333,0.81,0.0896,20,300,142,1420,162,1720
16135,2012-11-10,4,1,11,0,0,6,0,1,0.32,0.3333,0.76,0.0896,16,240,106,1060,122,1300
16136,2012-11-10,4,1,11,1,0,6,0,1,0.3,0.3182,0.81,0.0896,8,120,68,680,76,800
16137,2012-11-10,4,1,11,2,0,6,0,1,0.32,0.3485,0.81,0.0,2,30,42,420,44,450
16138,2012-11-10,4,1,11,3,0,6,0,1,0.3,0.3333,0.81,0.0,9,135,11,110,20,245
16139,2012-11-10,4,1,11,4,0,6,0,1,0.26,0.2727,0.87,0.1045,2,30,4,40,6,70
16140,2012-11-10,4,1,11,5,0,6,0,1,0.28,0.3182,0.87,0.0,1,15,9,90,10,105
16141,2012-11-10,4,1,11,6,0,6,0,1,0.24,0.2576,0.93,0.0896,5,75,11,110,16,185
16142,2012-11-10,4,1,11,7,0,6,0,1,0.26,0.2727,0.87,0.1045,14,210,57,570,71,780
16143,2012-11-10,4,1,11,8,0,6,0,1,0.32,0.3485,0.76,0.0,16,240,130,1300,146,1540
16144,2012-11-10,4,1,11,9,0,6,0,1,0.36,0.3485,0.66,0.194,43,645,216,2160,259,2805
16145,2012-11-10,4,1,11,10,0,6,0,1,0.4,0.4091,0.58,0.0,86,1290,264,2640,350,3930
16146,2012-11-10,4,1,11,11,0,6,0,1,0.4,0.4091,0.58,0.1045,143,2145,323,3230,466,5375
16147,2012-11-10,4,1,11,12,0,6,0,1,0.48,0.4697,0.48,0.0,258,3870,348,3480,606,7350
16148,2012-11-10,4,1,11,13,0,6,0,1,0.52,0.5,0.39,0.0,268,4020,383,3830,651,7850
16149,2012-11-10,4,1,11,14,0,6,0,1,0.54,0.5152,0.37,0.0,280,4200,347,3470,627,7670
16150,2012-11-10,4,1,11,15,0,6,0,1,0.52,0.5,0.45,0.0,216,3240,351,3510,567,6750
16151,2012-11-10,4,1,11,16,0,6,0,1,0.54,0.5152,0.37,0.0,227,3405,378,3780,605,7185
16152,2012-11-10,4,1,11,17,0,6,0,1,0.5,0.4848,0.45,0.194,183,2745,318,3180,501,5925
16153,2012-11-10,4,1,11,18,0,6,0,1,0.44,0.4394,0.54,0.1343,103,1545,256,2560,359,4105
16154,2012-11-10,4,1,11,19,0,6,0,1,0.46,0.4545,0.51,0.0896,55,825,228,2280,283,3105
16155,2012-11-10,4,1,11,20,0,6,0,1,0.44,0.4394,0.54,0.0,39,585,153,1530,192,2115
16156,2012-11-10,4,1,11,21,0,6,0,1,0.4,0.4091,0.66,0.0,51,765,169,1690,220,2455
16157,2012-11-10,4,1,11,22,0,6,0,1,0.38,0.3939,0.71,0.0896,39,585,154,1540,193,2125
16158,2012-11-10,4,1,11,23,0,6,0,1,0.36,0.3636,0.71,0.1045,26,390,120,1200,146,1590
16159,2012-11-11,4,1,11,0,0,0,0,1,0.34,0.3485,0.81,0.0896,14,210,110,1100,124,1310
16160,2012-11-11,4,1,11,1,0,0,0,1,0.34,0.3485,0.76,0.0896,26,390,82,820,108,1210
16161,2012-11-11,4,1,11,2,0,0,0,1,0.32,0.3333,0.87,0.1045,12,180,58,580,70,760
16162,2012-11-11,4,1,11,3,0,0,0,1,0.34,0.3636,0.81,0.0,9,135,39,390,48,525
16163,2012-11-11,4,1,11,4,0,0,0,1,0.32,0.3333,0.81,0.1045,5,75,6,60,11,135
16164,2012-11-11,4,1,11,5,0,0,0,1,0.3,0.303,0.87,0.1343,0,0,12,120,12,120
16165,2012-11-11,4,1,11,6,0,0,0,1,0.3,0.3182,0.87,0.0896,3,45,16,160,19,205
16166,2012-11-11,4,1,11,7,0,0,0,1,0.3,0.3182,0.89,0.0896,12,180,56,560,68,740
16167,2012-11-11,4,1,11,8,0,0,0,1,0.32,0.3333,0.87,0.1045,32,480,87,870,119,1350
16168,2012-11-11,4,1,11,9,0,0,0,1,0.36,0.3788,0.77,0.0,94,1410,179,1790,273,3200
16169,2012-11-11,4,1,11,10,0,0,0,1,0.4,0.4091,0.69,0.1045,133,1995,272,2720,405,4715
16170,2012-11-11,4,1,11,11,0,0,0,1,0.46,0.4545,0.59,0.1343,180,2700,324,3240,504,5940
16171,2012-11-11,4,1,11,12,0,0,0,1,0.5,0.4848,0.48,0.0896,195,2925,390,3900,585,6825
16172,2012-11-11,4,1,11,13,0,0,0,1,0.54,0.5152,0.45,0.1045,262,3930,424,4240,686,8170
16173,2012-11-11,4,1,11,14,0,0,0,1,0.6,0.6212,0.33,0.1642,292,4380,362,3620,654,8000
16174,2012-11-11,4,1,11,15,0,0,0,1,0.56,0.5303,0.37,0.2239,304,4560,420,4200,724,8760
16175,2012-11-11,4,1,11,16,0,0,0,1,0.54,0.5152,0.42,0.2239,260,3900,393,3930,653,7830
16176,2012-11-11,4,1,11,17,0,0,0,1,0.54,0.5152,0.45,0.1642,151,2265,342,3420,493,5685
16177,2012-11-11,4,1,11,18,0,0,0,1,0.52,0.5,0.45,0.1343,102,1530,303,3030,405,4560
16178,2012-11-11,4,1,11,19,0,0,0,1,0.48,0.4697,0.55,0.1343,69,1035,208,2080,277,3115
16179,2012-11-11,4,1,11,20,0,0,0,1,0.44,0.4394,0.62,0.1642,54,810,146,1460,200,2270
16180,2012-11-11,4,1,11,21,0,0,0,1,0.44,0.4394,0.67,0.2239,44,660,127,1270,171,1930
16181,2012-11-11,4,1,11,22,0,0,0,1,0.42,0.4242,0.71,0.194,21,315,113,1130,134,1445
16182,2012-11-11,4,1,11,23,0,0,0,1,0.42,0.4242,0.71,0.194,16,240,93,930,109,1170
16183,2012-11-12,4,1,11,0,1,1,0,1,0.42,0.4242,0.71,0.1045,6,90,43,430,49,520
16184,2012-11-12,4,1,11,1,1,1,0,1,0.4,0.4091,0.76,0.1642,4,60,26,260,30,320
16185,2012-11-12,4,1,11,2,1,1,0,1,0.4,0.4091,0.76,0.1343,6,90,14,140,20,230
16186,2012-11-12,4,1,11,3,1,1,0,1,0.4,0.4091,0.76,0.1343,1,15,3,30,4,45
16187,2012-11-12,4,1,11,4,1,1,0,1,0.4,0.4091,0.76,0.0896,1,15,3,30,4,45
16188,2012-11-12,4,1,11,5,1,1,0,1,0.38,0.3939,0.87,0.0,1,15,23,230,24,245
16189,2012-11-12,4,1,11,6,1,1,0,1,0.38,0.3939,0.87,0.1045,7,105,64,640,71,745
16190,2012-11-12,4,1,11,7,1,1,0,1,0.4,0.4091,0.87,0.0,16,240,248,2480,264,2720
16191,2012-11-12,4,1,11,8,1,1,0,1,0.42,0.4242,0.82,0.1642,50,750,490,4900,540,5650
16192,2012-11-12,4,1,11,9,1,1,0,1,0.44,0.4394,0.88,0.1045,60,900,337,3370,397,4270
16193,2012-11-12,4,1,11,10,1,1,0,1,0.48,0.4697,0.77,0.1642,82,1230,184,1840,266,3070
16194,2012-11-12,4,1,11,11,1,1,0,1,0.52,0.5,0.72,0.1642,112,1680,255,2550,367,4230
16195,2012-11-12,4,1,11,12,1,1,0,1,0.56,0.5303,0.64,0.2239,105,1575,314,3140,419,4715
16196,2012-11-12,4,1,11,13,1,1,0,1,0.6,0.6061,0.6,0.2239,108,1620,312,3120,420,4740
16197,2012-11-12,4,1,11,14,1,1,0,1,0.58,0.5455,0.6,0.2836,134,2010,310,3100,444,5110
16198,2012-11-12,4,1,11,15,1,1,0,1,0.56,0.5303,0.64,0.2537,102,1530,280,2800,382,4330
16199,2012-11-12,4,1,11,16,1,1,0,1,0.56,0.5303,0.64,0.1642,87,1305,347,3470,434,4775
16200,2012-11-12,4,1,11,17,1,1,0,1,0.56,0.5303,0.64,0.2836,66,990,530,5300,596,6290
16201,2012-11-12,4,1,11,18,1,1,0,1,0.52,0.5,0.72,0.1343,65,975,486,4860,551,5835
16202,2012-11-12,4,1,11,19,1,1,0,1,0.54,0.5152,0.73,0.2836,30,450,323,3230,353,3680
16203,2012-11-12,4,1,11,20,1,1,0,2,0.52,0.5,0.77,0.2836,31,465,273,2730,304,3195
16204,2012-11-12,4,1,11,21,1,1,0,3,0.54,0.5152,0.73,0.2239,10,150,145,1450,155,1600
16205,2012-11-12,4,1,11,22,1,1,0,1,0.52,0.5,0.77,0.2537,12,180,100,1000,112,1180
16206,2012-11-12,4,1,11,23,1,1,0,2,0.54,0.5152,0.77,0.2239,1,15,62,620,63,635
16207,2012-11-13,4,1,11,0,0,2,1,2,0.52,0.5,0.83,0.2836,5,75,18,180,23,255
16208,2012-11-13,4,1,11,1,0,2,1,3,0.44,0.4394,0.88,0.6418,0,0,5,50,5,50
16209,2012-11-13,4,1,11,2,0,2,1,3,0.36,0.3182,0.87,0.4478,7,105,4,40,11,145
16210,2012-11-13,4,1,11,3,0,2,1,3,0.36,0.3333,0.87,0.3582,2,30,3,30,5,60
16211,2012-11-13,4,1,11,4,0,2,1,2,0.36,0.3333,0.81,0.3881,0,0,9,90,9,90
16212,2012-11-13,4,1,11,5,0,2,1,2,0.34,0.3182,0.87,0.2836,0,0,18,180,18,180
16213,2012-11-13,4,1,11,6,0,2,1,3,0.32,0.2879,0.81,0.4627,2,30,48,480,50,510
16214,2012-11-13,4,1,11,7,0,2,1,3,0.32,0.303,0.87,0.2537,1,15,106,1060,107,1075
16215,2012-11-13,4,1,11,8,0,2,1,3,0.32,0.303,0.87,0.2537,4,60,207,2070,211,2130
16216,2012-11-13,4,1,11,9,0,2,1,3,0.32,0.303,0.81,0.3284,1,15,109,1090,110,1105
16217,2012-11-13,4,1,11,10,0,2,1,3,0.3,0.2727,0.75,0.3881,10,150,84,840,94,990
16218,2012-11-13,4,1,11,11,0,2,1,1,0.32,0.303,0.7,0.2537,22,330,133,1330,155,1660
16219,2012-11-13,4,1,11,12,0,2,1,1,0.34,0.3182,0.61,0.2836,16,240,180,1800,196,2040
16220,2012-11-13,4,1,11,13,0,2,1,1,0.34,0.3182,0.53,0.2537,30,450,188,1880,218,2330
16221,2012-11-13,4,1,11,14,0,2,1,1,0.38,0.3939,0.46,0.3881,34,510,169,1690,203,2200
16222,2012-11-13,4,1,11,15,0,2,1,1,0.4,0.4091,0.4,0.2985,33,495,184,1840,217,2335
16223,2012-11-13,4,1,11,16,0,2,1,1,0.38,0.3939,0.4,0.2985,28,420,282,2820,310,3240
16224,2012-11-13,4,1,11,17,0,2,1,1,0.34,0.303,0.49,0.3582,33,495,575,5750,608,6245
16225,2012-11-13,4,1,11,18,0,2,1,1,0.34,0.3182,0.49,0.2836,45,675,514,5140,559,5815
16226,2012-11-13,4,1,11,19,0,2,1,1,0.32,0.2879,0.49,0.3582,12,180,344,3440,356,3620
16227,2012-11-13,4,1,11,20,0,2,1,1,0.3,0.2727,0.49,0.3582,12,180,211,2110,223,2290
16228,2012-11-13,4,1,11,21,0,2,1,1,0.3,0.2727,0.49,0.3582,9,135,178,1780,187,1915
16229,2012-11-13,4,1,11,22,0,2,1,1,0.26,0.2273,0.56,0.3284,15,225,120,1200,135,1425
16230,2012-11-13,4,1,11,23,0,2,1,1,0.26,0.2273,0.56,0.2985,6,90,78,780,84,870
16231,2012-11-14,4,1,11,0,0,3,1,1,0.26,0.2424,0.56,0.2836,4,60,20,200,24,260
16232,2012-11-14,4,1,11,1,0,3,1,1,0.24,0.2121,0.6,0.2985,2,30,10,100,12,130
16233,2012-11-14,4,1,11,2,0,3,1,1,0.24,0.2121,0.6,0.2985,0,0,1,10,1,10
16234,2012-11-14,4,1,11,3,0,3,1,1,0.24,0.2273,0.65,0.2239,0,0,5,50,5,50
16235,2012-11-14,4,1,11,4,0,3,1,1,0.22,0.2273,0.69,0.194,0,0,6,60,6,60
16236,2012-11-14,4,1,11,5,0,3,1,1,0.22,0.2273,0.69,0.194,0,0,39,390,39,390
16237,2012-11-14,4,1,11,6,0,3,1,1,0.24,0.2273,0.65,0.194,4,60,142,1420,146,1480
16238,2012-11-14,4,1,11,7,0,3,1,1,0.24,0.2121,0.65,0.2836,10,150,405,4050,415,4200
16239,2012-11-14,4,1,11,8,0,3,1,1,0.28,0.2576,0.56,0.2985,27,405,664,6640,691,7045
16240,2012-11-14,4,1,11,9,0,3,1,1,0.3,0.2727,0.52,0.3881,22,330,310,3100,332,3430
16241,2012-11-14,4,1,11,10,0,3,1,1,0.32,0.2879,0.45,0.3582,18,270,153,1530,171,1800
16242,2012-11-14,4,1,11,11,0,3,1,1,0.32,0.303,0.49,0.2537,25,375,126,1260,151,1635
16243,2012-11-14,4,1,11,12,0,3,1,1,0.34,0.3333,0.46,0.0,40,600,200,2000,240,2600
16244,2012-11-14,4,1,11,13,0,3,1,1,0.36,0.3333,0.43,0.2537,32,480,182,1820,214,2300
16245,2012-11-14,4,1,11,14,0,3,1,1,0.36,0.3485,0.43,0.1343,20,300,161,1610,181,1910
16246,2012-11-14,4,1,11,15,0,3,1,1,0.36,0.3333,0.43,0.2836,32,480,228,2280,260,2760
16247,2012-11-14,4,1,11,16,0,3,1,1,0.34,0.3485,0.46,0.1045,31,465,290,2900,321,3365
16248,2012-11-14,4,1,11,17,0,3,1,1,0.32,0.3182,0.49,0.194,19,285,564,5640,583,5925
16249,2012-11-14,4,1,11,18,0,3,1,1,0.32,0.3182,0.53,0.1642,24,360,543,5430,567,5790
16250,2012-11-14,4,1,11,19,0,3,1,1,0.3,0.303,0.52,0.1642,28,420,368,3680,396,4100
16251,2012-11-14,4,1,11,20,0,3,1,1,0.3,0.3182,0.52,0.0896,15,225,252,2520,267,2745
16252,2012-11-14,4,1,11,21,0,3,1,1,0.3,0.3333,0.56,0.0,5,75,208,2080,213,2155
16253,2012-11-14,4,1,11,22,0,3,1,1,0.28,0.3182,0.61,0.0,6,90,167,1670,173,1760
16254,2012-11-14,4,1,11,23,0,3,1,1,0.24,0.2424,0.7,0.1343,9,135,78,780,87,915
16255,2012-11-15,4,1,11,0,0,4,1,2,0.26,0.303,0.65,0.0,1,15,33,330,34,345
16256,2012-11-15,4,1,11,1,0,4,1,2,0.26,0.2727,0.65,0.1045,2,30,14,140,16,170
16257,2012-11-15,4,1,11,2,0,4,1,2,0.26,0.2576,0.7,0.1642,0,0,7,70,7,70
16258,2012-11-15,4,1,11,3,0,4,1,2,0.26,0.2879,0.7,0.0896,0,0,2,20,2,20
16259,2012-11-15,4,1,11,4,0,4,1,2,0.28,0.2879,0.65,0.1343,0,0,5,50,5,50
16260,2012-11-15,4,1,11,5,0,4,1,2,0.3,0.2879,0.61,0.2239,3,45,34,340,37,385
16261,2012-11-15,4,1,11,6,0,4,1,2,0.3,0.2879,0.65,0.2537,1,15,146,1460,147,1475
16262,2012-11-15,4,1,11,7,0,4,1,2,0.3,0.2879,0.65,0.194,7,105,403,4030,410,4135
16263,2012-11-15,4,1,11,8,0,4,1,2,0.3,0.2879,0.61,0.2239,21,315,625,6250,646,6565
16264,2012-11-15,4,1,11,9,0,4,1,2,0.32,0.3182,0.61,0.194,17,255,306,3060,323,3315
16265,2012-11-15,4,1,11,10,0,4,1,2,0.32,0.3333,0.66,0.1343,11,165,142,1420,153,1585
16266,2012-11-15,4,1,11,11,0,4,1,2,0.34,0.3333,0.61,0.1343,28,420,138,1380,166,1800
16267,2012-11-15,4,1,11,12,0,4,1,2,0.36,0.3636,0.62,0.1045,29,435,184,1840,213,2275
16268,2012-11-15,4,1,11,13,0,4,1,2,0.38,0.3939,0.54,0.1045,20,300,197,1970,217,2270
16269,2012-11-15,4,1,11,14,0,4,1,2,0.38,0.3939,0.54,0.1642,27,405,174,1740,201,2145
16270,2012-11-15,4,1,11,15,0,4,1,2,0.38,0.3939,0.58,0.1642,26,390,191,1910,217,2300
16271,2012-11-15,4,1,11,16,0,4,1,2,0.36,0.3485,0.57,0.194,24,360,318,3180,342,3540
16272,2012-11-15,4,1,11,17,0,4,1,2,0.36,0.3485,0.57,0.2239,22,330,541,5410,563,5740
16273,2012-11-15,4,1,11,18,0,4,1,2,0.36,0.3485,0.57,0.194,10,150,563,5630,573,5780
16274,2012-11-15,4,1,11,19,0,4,1,2,0.34,0.3333,0.61,0.1343,11,165,375,3750,386,3915
16275,2012-11-15,4,1,11,20,0,4,1,1,0.34,0.3485,0.61,0.1045,23,345,262,2620,285,2965
16276,2012-11-15,4,1,11,21,0,4,1,2,0.32,0.3333,0.66,0.1045,20,300,204,2040,224,2340
16277,2012-11-15,4,1,11,22,0,4,1,2,0.32,0.3182,0.66,0.1642,10,150,143,1430,153,1580
16278,2012-11-15,4,1,11,23,0,4,1,2,0.32,0.3182,0.61,0.1642,7,105,118,1180,125,1285
16279,2012-11-16,4,1,11,0,0,5,1,2,0.32,0.3333,0.66,0.1045,7,105,58,580,65,685
16280,2012-11-16,4,1,11,1,0,5,1,2,0.3,0.3182,0.65,0.0896,5,75,16,160,21,235
16281,2012-11-16,4,1,11,2,0,5,1,2,0.3,0.303,0.7,0.1642,0,0,9,90,9,90
16282,2012-11-16,4,1,11,3,0,5,1,2,0.3,0.303,0.65,0.1343,0,0,6,60,6,60
16283,2012-11-16,4,1,11,4,0,5,1,2,0.3,0.3182,0.65,0.1045,0,0,5,50,5,50
16284,2012-11-16,4,1,11,5,0,5,1,2,0.3,0.3182,0.65,0.0896,2,30,34,340,36,370
16285,2012-11-16,4,1,11,6,0,5,1,2,0.3,0.3182,0.61,0.0896,4,60,126,1260,130,1320
16286,2012-11-16,4,1,11,7,0,5,1,2,0.3,0.303,0.61,0.1642,5,75,362,3620,367,3695
16287,2012-11-16,4,1,11,8,0,5,1,2,0.32,0.3333,0.57,0.1343,17,255,694,6940,711,7195
16288,2012-11-16,4,1,11,9,0,5,1,1,0.34,0.3485,0.53,0.1045,21,315,330,3300,351,3615
16289,2012-11-16,4,1,11,10,0,5,1,1,0.34,0.3333,0.53,0.194,33,495,165,1650,198,2145
16290,2012-11-16,4,1,11,11,0,5,1,1,0.38,0.3939,0.43,0.2239,33,495,185,1850,218,2345
16291,2012-11-16,4,1,11,12,0,5,1,1,0.4,0.4091,0.43,0.2836,28,420,262,2620,290,3040
16292,2012-11-16,4,1,11,13,0,5,1,1,0.42,0.4242,0.38,0.194,52,780,226,2260,278,3040
16293,2012-11-16,4,1,11,14,0,5,1,1,0.42,0.4242,0.35,0.1045,47,705,204,2040,251,2745
16294,2012-11-16,4,1,11,15,0,5,1,1,0.42,0.4242,0.38,0.1343,30,450,237,2370,267,2820
16295,2012-11-16,4,1,11,16,0,5,1,1,0.42,0.4242,0.35,0.2836,33,495,350,3500,383,3995
16296,2012-11-16,4,1,11,17,0,5,1,1,0.36,0.3485,0.46,0.194,41,615,539,5390,580,6005
16297,2012-11-16,4,1,11,18,0,5,1,1,0.34,0.3333,0.53,0.1642,22,330,483,4830,505,5160
16298,2012-11-16,4,1,11,19,0,5,1,1,0.36,0.3485,0.46,0.2239,26,390,306,3060,332,3450
16299,2012-11-16,4,1,11,20,0,5,1,1,0.36,0.3333,0.46,0.2537,20,300,207,2070,227,2370
16300,2012-11-16,4,1,11,21,0,5,1,1,0.34,0.3333,0.49,0.194,21,315,157,1570,178,1885
16301,2012-11-16,4,1,11,22,0,5,1,1,0.32,0.303,0.53,0.2537,23,345,139,1390,162,1735
16302,2012-11-16,4,1,11,23,0,5,1,1,0.32,0.303,0.53,0.2239,14,210,114,1140,128,1350
16303,2012-11-17,4,1,11,0,0,6,0,1,0.3,0.303,0.52,0.1642,11,165,95,950,106,1115
16304,2012-11-17,4,1,11,1,0,6,0,1,0.26,0.2576,0.6,0.194,13,195,74,740,87,935
16305,2012-11-17,4,1,11,2,0,6,0,1,0.26,0.2576,0.65,0.194,8,120,41,410,49,530
16306,2012-11-17,4,1,11,3,0,6,0,1,0.26,0.2576,0.65,0.194,2,30,19,190,21,220
16307,2012-11-17,4,1,11,4,0,6,0,1,0.24,0.2273,0.7,0.194,1,15,6,60,7,75
16308,2012-11-17,4,1,11,5,0,6,0,1,0.24,0.2424,0.7,0.1642,1,15,10,100,11,115
16309,2012-11-17,4,1,11,6,0,6,0,1,0.24,0.2273,0.7,0.2239,0,0,21,210,21,210
16310,2012-11-17,4,1,11,7,0,6,0,1,0.24,0.2273,0.7,0.194,8,120,70,700,78,820
16311,2012-11-17,4,1,11,8,0,6,0,1,0.26,0.2576,0.65,0.2239,30,450,138,1380,168,1830
16312,2012-11-17,4,1,11,9,0,6,0,1,0.34,0.3182,0.49,0.2239,48,720,200,2000,248,2720
16313,2012-11-17,4,1,11,10,0,6,0,1,0.36,0.3333,0.46,0.2537,62,930,258,2580,320,3510
16314,2012-11-17,4,1,11,11,0,6,0,1,0.38,0.3939,0.43,0.194,80,1200,343,3430,423,4630
16315,2012-11-17,4,1,11,12,0,6,0,1,0.4,0.4091,0.4,0.1642,117,1755,359,3590,476,5345
16316,2012-11-17,4,1,11,13,0,6,0,1,0.42,0.4242,0.38,0.2537,179,2685,346,3460,525,6145
16317,2012-11-17,4,1,11,14,0,6,0,1,0.42,0.4242,0.38,0.194,175,2625,380,3800,555,6425
16318,2012-11-17,4,1,11,15,0,6,0,1,0.42,0.4242,0.35,0.2985,175,2625,374,3740,549,6365
16319,2012-11-17,4,1,11,16,0,6,0,1,0.4,0.4091,0.4,0.2239,144,2160,325,3250,469,5410
16320,2012-11-17,4,1,11,17,0,6,0,1,0.38,0.3939,0.4,0.1642,101,1515,302,3020,403,4535
16321,2012-11-17,4,1,11,18,0,6,0,1,0.36,0.3636,0.5,0.1045,34,510,237,2370,271,2880
16322,2012-11-17,4,1,11,19,0,6,0,1,0.34,0.3485,0.53,0.0896,45,675,208,2080,253,2755
16323,2012-11-17,4,1,11,20,0,6,0,2,0.34,0.3485,0.66,0.0896,30,450,142,1420,172,1870
16324,2012-11-17,4,1,11,21,0,6,0,2,0.32,0.3333,0.57,0.1045,15,225,124,1240,139,1465
16325,2012-11-17,4,1,11,22,0,6,0,2,0.32,0.3333,0.57,0.1045,15,225,130,1300,145,1525
16326,2012-11-17,4,1,11,23,0,6,0,2,0.3,0.3182,0.7,0.1045,19,285,114,1140,133,1425
16327,2012-11-18,4,1,11,0,0,0,0,2,0.3,0.303,0.7,0.1642,11,165,118,1180,129,1345
16328,2012-11-18,4,1,11,1,0,0,0,1,0.3,0.2879,0.7,0.194,14,210,81,810,95,1020
16329,2012-11-18,4,1,11,2,0,0,0,1,0.28,0.2879,0.81,0.1045,8,120,65,650,73,770
16330,2012-11-18,4,1,11,3,0,0,0,2,0.3,0.303,0.81,0.1642,9,135,37,370,46,505
16331,2012-11-18,4,1,11,4,0,0,0,2,0.3,0.2879,0.81,0.194,4,60,8,80,12,140
16332,2012-11-18,4,1,11,5,0,0,0,1,0.28,0.2879,0.81,0.1343,5,75,7,70,12,145
16333,2012-11-18,4,1,11,6,0,0,0,1,0.28,0.2727,0.81,0.1642,2,30,13,130,15,160
16334,2012-11-18,4,1,11,7,0,0,0,1,0.28,0.2727,0.81,0.194,3,45,39,390,42,435
16335,2012-11-18,4,1,11,8,0,0,0,1,0.3,0.2879,0.75,0.2537,19,285,100,1000,119,1285
16336,2012-11-18,4,1,11,9,0,0,0,1,0.32,0.303,0.7,0.2537,49,735,155,1550,204,2285
16337,2012-11-18,4,1,11,10,0,0,0,1,0.34,0.303,0.66,0.2985,79,1185,250,2500,329,3685
16338,2012-11-18,4,1,11,11,0,0,0,1,0.38,0.3939,0.62,0.2836,92,1380,267,2670,359,4050
16339,2012-11-18,4,1,11,12,0,0,0,1,0.4,0.4091,0.62,0.2836,101,1515,341,3410,442,4925
16340,2012-11-18,4,1,11,13,0,0,0,1,0.4,0.4091,0.62,0.3284,113,1695,334,3340,447,5035
16341,2012-11-18,4,1,11,14,0,0,0,1,0.4,0.4091,0.62,0.2985,125,1875,303,3030,428,4905
16342,2012-11-18,4,1,11,15,0,0,0,1,0.42,0.4242,0.54,0.2836,89,1335,318,3180,407,4515
16343,2012-11-18,4,1,11,16,0,0,0,2,0.4,0.4091,0.62,0.3284,59,885,313,3130,372,4015
16344,2012-11-18,4,1,11,17,0,0,0,2,0.38,0.3939,0.66,0.2537,48,720,232,2320,280,3040
16345,2012-11-18,4,1,11,18,0,0,0,1,0.36,0.3485,0.66,0.2239,36,540,240,2400,276,2940
16346,2012-11-18,4,1,11,19,0,0,0,1,0.36,0.3485,0.66,0.1642,16,240,194,1940,210,2180
16347,2012-11-18,4,1,11,20,0,0,0,1,0.36,0.3485,0.66,0.1642,9,135,120,1200,129,1335
16348,2012-11-18,4,1,11,21,0,0,0,1,0.36,0.3333,0.66,0.2537,17,255,93,930,110,1185
16349,2012-11-18,4,1,11,22,0,0,0,2,0.36,0.3333,0.66,0.2537,8,120,66,660,74,780
16350,2012-11-18,4,1,11,23,0,0,0,1,0.36,0.3485,0.66,0.2239,6,90,53,530,59,620
16351,2012-11-19,4,1,11,0,0,1,1,1,0.36,0.3485,0.66,0.2239,5,75,22,220,27,295
16352,2012-11-19,4,1,11,1,0,1,1,2,0.36,0.3485,0.66,0.2239,0,0,19,190,19,190
16353,2012-11-19,4,1,11,2,0,1,1,2,0.36,0.3333,0.66,0.2537,0,0,5,50,5,50
16354,2012-11-19,4,1,11,3,0,1,1,2,0.36,0.3485,0.66,0.2239,0,0,2,20,2,20
16355,2012-11-19,4,1,11,4,0,1,1,2,0.36,0.3485,0.66,0.2239,1,15,11,110,12,125
16356,2012-11-19,4,1,11,5,0,1,1,2,0.36,0.3485,0.66,0.2239,1,15,38,380,39,395
16357,2012-11-19,4,1,11,6,0,1,1,2,0.36,0.3333,0.66,0.2537,3,45,128,1280,131,1325
16358,2012-11-19,4,1,11,7,0,1,1,2,0.36,0.3333,0.66,0.2985,5,75,381,3810,386,3885
16359,2012-11-19,4,1,11,8,0,1,1,2,0.36,0.3333,0.66,0.2985,13,195,650,6500,663,6695
16360,2012-11-19,4,1,11,9,0,1,1,2,0.36,0.3333,0.66,0.2537,18,270,260,2600,278,2870
16361,2012-11-19,4,1,11,10,0,1,1,2,0.36,0.3333,0.66,0.2537,33,495,106,1060,139,1555
16362,2012-11-19,4,1,11,11,0,1,1,2,0.38,0.3939,0.66,0.2537,33,495,164,1640,197,2135
16363,2012-11-19,4,1,11,12,0,1,1,2,0.4,0.4091,0.62,0.2836,35,525,207,2070,242,2595
16364,2012-11-19,4,1,11,13,0,1,1,1,0.44,0.4394,0.54,0.2537,46,690,205,2050,251,2740
16365,2012-11-19,4,1,11,14,0,1,1,1,0.44,0.4394,0.54,0.2537,47,705,170,1700,217,2405
16366,2012-11-19,4,1,11,15,0,1,1,1,0.44,0.4394,0.54,0.194,44,660,213,2130,257,2790
16367,2012-11-19,4,1,11,16,0,1,1,1,0.42,0.4242,0.58,0.2537,55,825,325,3250,380,4075
16368,2012-11-19,4,1,11,17,0,1,1,2,0.42,0.4242,0.58,0.194,33,495,586,5860,619,6355
16369,2012-11-19,4,1,11,18,0,1,1,2,0.4,0.4091,0.58,0.2537,21,315,559,5590,580,5905
16370,2012-11-19,4,1,11,19,0,1,1,2,0.4,0.4091,0.58,0.2836,25,375,381,3810,406,4185
16371,2012-11-19,4,1,11,20,0,1,1,2,0.38,0.3939,0.62,0.2537,7,105,252,2520,259,2625
16372,2012-11-19,4,1,11,21,0,1,1,2,0.38,0.3939,0.54,0.2239,15,225,188,1880,203,2105
16373,2012-11-19,4,1,11,22,0,1,1,1,0.34,0.3485,0.66,0.1045,7,105,106,1060,113,1165
16374,2012-11-19,4,1,11,23,0,1,1,1,0.34,0.3485,0.66,0.1045,2,30,72,720,74,750
16375,2012-11-20,4,1,11,0,0,2,1,1,0.32,0.3333,0.7,0.1343,3,45,26,260,29,305
16376,2012-11-20,4,1,11,1,0,2,1,1,0.34,0.3485,0.66,0.1045,3,45,10,100,13,145
16377,2012-11-20,4,1,11,2,0,2,1,2,0.32,0.3333,0.76,0.0896,0,0,5,50,5,50
16378,2012-11-20,4,1,11,3,0,2,1,2,0.34,0.3485,0.71,0.1045,0,0,2,20,2,20
16379,2012-11-20,4,1,11,4,0,2,1,2,0.34,0.3333,0.66,0.194,0,0,6,60,6,60
16380,2012-11-20,4,1,11,5,0,2,1,2,0.34,0.3333,0.66,0.1343,2,30,32,320,34,350
16381,2012-11-20,4,1,11,6,0,2,1,2,0.34,0.3333,0.71,0.1642,2,30,146,1460,148,1490
16382,2012-11-20,4,1,11,7,0,2,1,1,0.32,0.3333,0.76,0.0896,7,105,411,4110,418,4215
16383,2012-11-20,4,1,11,8,0,2,1,1,0.34,0.3333,0.71,0.1343,16,240,649,6490,665,6730
16384,2012-11-20,4,1,11,9,0,2,1,2,0.36,0.3788,0.71,0.0,28,420,298,2980,326,3400
16385,2012-11-20,4,1,11,10,0,2,1,2,0.4,0.4091,0.66,0.0896,32,480,144,1440,176,1920
16386,2012-11-20,4,1,11,11,0,2,1,2,0.42,0.4242,0.67,0.0896,45,675,160,1600,205,2275
16387,2012-11-20,4,1,11,12,0,2,1,2,0.42,0.4242,0.67,0.0,70,1050,243,2430,313,3480
16388,2012-11-20,4,1,11,13,0,2,1,2,0.44,0.4394,0.58,0.0,49,735,218,2180,267,2915
16389,2012-11-20,4,1,11,14,0,2,1,2,0.44,0.4394,0.58,0.1045,47,705,177,1770,224,2475
16390,2012-11-20,4,1,11,15,0,2,1,2,0.46,0.4545,0.55,0.1045,61,915,226,2260,287,3175
16391,2012-11-20,4,1,11,16,0,2,1,2,0.42,0.4242,0.62,0.0896,60,900,335,3350,395,4250
16392,2012-11-20,4,1,11,17,0,2,1,2,0.4,0.4091,0.71,0.1642,37,555,553,5530,590,6085
16393,2012-11-20,4,1,11,18,0,2,1,2,0.4,0.4091,0.66,0.0896,16,240,534,5340,550,5580
16394,2012-11-20,4,1,11,19,0,2,1,2,0.4,0.4091,0.71,0.0,23,345,361,3610,384,3955
16395,2012-11-20,4,1,11,20,0,2,1,2,0.38,0.3939,0.76,0.0,11,165,224,2240,235,2405
16396,2012-11-20,4,1,11,21,0,2,1,1,0.36,0.3788,0.71,0.0,14,210,143,1430,157,1640
16397,2012-11-20,4,1,11,22,0,2,1,1,0.36,0.3788,0.71,0.0,7,105,115,1150,122,1255
16398,2012-11-20,4,1,11,23,0,2,1,1,0.32,0.3333,0.81,0.1045,1,15,82,820,83,835
16399,2012-11-21,4,1,11,0,0,3,1,1,0.34,0.3636,0.81,0.0,1,15,25,250,26,265
16400,2012-11-21,4,1,11,1,0,3,1,1,0.32,0.3333,0.81,0.1045,1,15,13,130,14,145
16401,2012-11-21,4,1,11,2,0,3,1,1,0.28,0.2879,0.87,0.1045,2,30,6,60,8,90
16402,2012-11-21,4,1,11,3,0,3,1,1,0.28,0.2879,0.87,0.1045,0,0,2,20,2,20
16403,2012-11-21,4,1,11,4,0,3,1,1,0.28,0.2879,0.87,0.1045,0,0,10,100,10,100
16404,2012-11-21,4,1,11,5,0,3,1,1,0.28,0.2879,0.87,0.1045,1,15,28,280,29,295
16405,2012-11-21,4,1,11,6,0,3,1,1,0.28,0.303,0.87,0.0896,2,30,99,990,101,1020
16406,2012-11-21,4,1,11,7,0,3,1,1,0.26,0.2879,0.87,0.0896,11,165,262,2620,273,2785
16407,2012-11-21,4,1,11,8,0,3,1,2,0.28,0.303,0.81,0.0896,12,180,539,5390,551,5570
16408,2012-11-21,4,1,11,9,0,3,1,1,0.32,0.3333,0.76,0.0896,45,675,320,3200,365,3875
16409,2012-11-21,4,1,11,10,0,3,1,1,0.36,0.3788,0.62,0.0,22,330,150,1500,172,1830
16410,2012-11-21,4,1,11,11,0,3,1,1,0.4,0.4091,0.5,0.194,43,645,198,1980,241,2625
16411,2012-11-21,4,1,11,12,0,3,1,1,0.44,0.4394,0.41,0.194,74,1110,270,2700,344,3810
16412,2012-11-21,4,1,11,13,0,3,1,1,0.44,0.4394,0.35,0.2239,70,1050,295,2950,365,4000
16413,2012-11-21,4,1,11,14,0,3,1,1,0.46,0.4545,0.33,0.194,84,1260,329,3290,413,4550
16414,2012-11-21,4,1,11,15,0,3,1,1,0.46,0.4545,0.36,0.0896,68,1020,381,3810,449,4830
16415,2012-11-21,4,1,11,16,0,3,1,1,0.44,0.4394,0.33,0.1343,59,885,410,4100,469,4985
16416,2012-11-21,4,1,11,17,0,3,1,1,0.4,0.4091,0.4,0.1642,41,615,333,3330,374,3945
16417,2012-11-21,4,1,11,18,0,3,1,1,0.42,0.4242,0.38,0.1045,24,360,287,2870,311,3230
16418,2012-11-21,4,1,11,19,0,3,1,1,0.38,0.3939,0.43,0.194,23,345,220,2200,243,2545
16419,2012-11-21,4,1,11,20,0,3,1,1,0.34,0.3485,0.61,0.1045,11,165,125,1250,136,1415
16420,2012-11-21,4,1,11,21,0,3,1,1,0.36,0.3788,0.5,0.0,8,120,97,970,105,1090
16421,2012-11-21,4,1,11,22,0,3,1,1,0.34,0.3636,0.49,0.0,6,90,82,820,88,910
16422,2012-11-21,4,1,11,23,0,3,1,1,0.32,0.3485,0.61,0.0,7,105,50,500,57,605
16423,2012-11-22,4,1,11,0,1,4,0,1,0.32,0.3333,0.66,0.0896,3,45,43,430,46,475
16424,2012-11-22,4,1,11,1,1,4,0,1,0.28,0.303,0.65,0.0896,5,75,37,370,42,445
16425,2012-11-22,4,1,11,2,1,4,0,1,0.24,0.2576,0.75,0.0896,3,45,15,150,18,195
16426,2012-11-22,4,1,11,3,1,4,0,1,0.24,0.2576,0.75,0.1045,0,0,6,60,6,60
16427,2012-11-22,4,1,11,4,1,4,0,1,0.22,0.2273,0.8,0.1343,1,15,2,20,3,35
16428,2012-11-22,4,1,11,5,1,4,0,1,0.24,0.2576,0.75,0.1045,2,30,6,60,8,90
16429,2012-11-22,4,1,11,6,1,4,0,1,0.26,0.2727,0.7,0.1045,2,30,15,150,17,180
16430,2012-11-22,4,1,11,7,1,4,0,1,0.22,0.2273,0.75,0.1343,7,105,49,490,56,595
16431,2012-11-22,4,1,11,8,1,4,0,1,0.24,0.2424,0.75,0.1343,20,300,77,770,97,1070
16432,2012-11-22,4,1,11,9,1,4,0,1,0.3,0.3333,0.65,0.0,25,375,94,940,119,1315
16433,2012-11-22,4,1,11,10,1,4,0,1,0.36,0.3636,0.57,0.1045,65,975,154,1540,219,2515
16434,2012-11-22,4,1,11,11,1,4,0,1,0.42,0.4242,0.41,0.0896,89,1335,143,1430,232,2765
16435,2012-11-22,4,1,11,12,1,4,0,1,0.44,0.4394,0.35,0.0,117,1755,145,1450,262,3205
16436,2012-11-22,4,1,11,13,1,4,0,1,0.46,0.4545,0.31,0.0,125,1875,144,1440,269,3315
16437,2012-11-22,4,1,11,14,1,4,0,1,0.48,0.4697,0.29,0.0,125,1875,95,950,220,2825
16438,2012-11-22,4,1,11,15,1,4,0,1,0.48,0.4697,0.29,0.0,132,1980,96,960,228,2940
16439,2012-11-22,4,1,11,16,1,4,0,1,0.46,0.4545,0.33,0.0,101,1515,81,810,182,2325
16440,2012-11-22,4,1,11,17,1,4,0,1,0.44,0.4394,0.35,0.0,66,990,43,430,109,1420
16441,2012-11-22,4,1,11,18,1,4,0,1,0.4,0.4091,0.43,0.0,16,240,54,540,70,780
16442,2012-11-22,4,1,11,19,1,4,0,1,0.36,0.3788,0.76,0.0,13,195,31,310,44,505
16443,2012-11-22,4,1,11,20,1,4,0,1,0.34,0.3636,0.71,0.0,15,225,37,370,52,595
16444,2012-11-22,4,1,11,21,1,4,0,1,0.34,0.3485,0.61,0.0896,7,105,39,390,46,495
16445,2012-11-22,4,1,11,22,1,4,0,1,0.32,0.3485,0.61,0.0,8,120,36,360,44,480
16446,2012-11-22,4,1,11,23,1,4,0,1,0.3,0.3333,0.7,0.0,8,120,28,280,36,400
16447,2012-11-23,4,1,11,0,0,5,1,1,0.28,0.3182,0.65,0.0,0,0,32,320,32,320
16448,2012-11-23,4,1,11,1,0,5,1,1,0.28,0.303,0.81,0.0896,2,30,11,110,13,140
16449,2012-11-23,4,1,11,2,0,5,1,1,0.26,0.2879,0.75,0.0896,1,15,4,40,5,55
16450,2012-11-23,4,1,11,3,0,5,1,1,0.26,0.303,0.7,0.0,1,15,0,0,1,15
16451,2012-11-23,4,1,11,4,0,5,1,1,0.24,0.2576,0.75,0.1045,1,15,3,30,4,45
16452,2012-11-23,4,1,11,5,0,5,1,1,0.24,0.2879,0.81,0.0,0,0,10,100,10,100
16453,2012-11-23,4,1,11,6,0,5,1,1,0.24,0.2879,0.81,0.0,0,0,20,200,20,200
16454,2012-11-23,4,1,11,7,0,5,1,1,0.24,0.2879,0.81,0.0,5,75,72,720,77,795
16455,2012-11-23,4,1,11,8,0,5,1,1,0.24,0.2576,0.87,0.0896,11,165,83,830,94,995
16456,2012-11-23,4,1,11,9,0,5,1,1,0.28,0.2879,0.75,0.1045,32,480,80,800,112,1280
16457,2012-11-23,4,1,11,10,0,5,1,1,0.34,0.3333,0.61,0.1642,87,1305,114,1140,201,2445
16458,2012-11-23,4,1,11,11,0,5,1,1,0.4,0.4091,0.5,0.194,121,1815,130,1300,251,3115
16459,2012-11-23,4,1,11,12,0,5,1,1,0.44,0.4394,0.38,0.2537,186,2790,193,1930,379,4720
16460,2012-11-23,4,1,11,13,0,5,1,1,0.46,0.4545,0.38,0.2836,224,3360,200,2000,424,5360
16461,2012-11-23,4,1,11,14,0,5,1,1,0.5,0.4848,0.36,0.2537,240,3600,195,1950,435,5550
16462,2012-11-23,4,1,11,15,0,5,1,1,0.48,0.4697,0.41,0.2537,233,3495,214,2140,447,5635
16463,2012-11-23,4,1,11,16,0,5,1,2,0.48,0.4697,0.41,0.1045,158,2370,199,1990,357,4360
16464,2012-11-23,4,1,11,17,0,5,1,2,0.48,0.4697,0.39,0.0896,117,1755,183,1830,300,3585
16465,2012-11-23,4,1,11,18,0,5,1,2,0.46,0.4545,0.44,0.0,50,750,158,1580,208,2330
16466,2012-11-23,4,1,11,19,0,5,1,2,0.46,0.4545,0.47,0.1642,33,495,121,1210,154,1705
16467,2012-11-23,4,1,11,20,0,5,1,1,0.46,0.4545,0.41,0.0896,42,630,100,1000,142,1630
16468,2012-11-23,4,1,11,21,0,5,1,1,0.46,0.4545,0.47,0.2537,23,345,75,750,98,1095
16469,2012-11-23,4,1,11,22,0,5,1,1,0.44,0.4394,0.33,0.5224,16,240,63,630,79,870
16470,2012-11-23,4,1,11,23,0,5,1,1,0.42,0.4242,0.38,0.4478,20,300,47,470,67,770
16471,2012-11-24,4,1,11,0,0,6,0,1,0.4,0.4091,0.37,0.4179,9,135,33,330,42,465
16472,2012-11-24,4,1,11,1,0,6,0,1,0.34,0.2879,0.42,0.4925,1,15,19,190,20,205
16473,2012-11-24,4,1,11,2,0,6,0,1,0.32,0.2727,0.39,0.6119,10,150,22,220,32,370
16474,2012-11-24,4,1,11,3,0,6,0,1,0.28,0.2576,0.41,0.3582,6,90,5,50,11,140
16475,2012-11-24,4,1,11,4,0,6,0,1,0.26,0.2121,0.41,0.4478,1,15,2,20,3,35
16476,2012-11-24,4,1,11,5,0,6,0,1,0.26,0.2273,0.41,0.3284,1,15,2,20,3,35
16477,2012-11-24,4,1,11,6,0,6,0,1,0.24,0.2121,0.44,0.2836,1,15,9,90,10,105
16478,2012-11-24,4,1,11,7,0,6,0,2,0.26,0.2273,0.41,0.3284,4,60,21,210,25,270
16479,2012-11-24,4,1,11,8,0,6,0,2,0.26,0.2121,0.44,0.4627,7,105,55,550,62,655
16480,2012-11-24,4,1,11,9,0,6,0,2,0.26,0.2121,0.41,0.4478,26,390,96,960,122,1350
16481,2012-11-24,4,1,11,10,0,6,0,2,0.26,0.2273,0.44,0.2985,46,690,96,960,142,1650
16482,2012-11-24,4,1,11,11,0,6,0,2,0.28,0.2576,0.41,0.2985,55,825,131,1310,186,2135
16483,2012-11-24,4,1,11,12,0,6,0,2,0.3,0.2576,0.36,0.6119,53,795,146,1460,199,2255
16484,2012-11-24,4,1,11,13,0,6,0,1,0.32,0.303,0.36,0.3284,64,960,161,1610,225,2570
16485,2012-11-24,4,1,11,14,0,6,0,1,0.32,0.2879,0.33,0.4627,58,870,149,1490,207,2360
16486,2012-11-24,4,1,11,15,0,6,0,1,0.3,0.2727,0.36,0.4627,59,885,139,1390,198,2275
16487,2012-11-24,4,1,11,16,0,6,0,1,0.28,0.2424,0.38,0.4478,43,645,127,1270,170,1915
16488,2012-11-24,4,1,11,17,0,6,0,1,0.26,0.2273,0.41,0.3881,29,435,97,970,126,1405
16489,2012-11-24,4,1,11,18,0,6,0,1,0.26,0.2273,0.38,0.3881,22,330,123,1230,145,1560
16490,2012-11-24,4,1,11,19,0,6,0,1,0.26,0.2424,0.41,0.2537,9,135,74,740,83,875
16491,2012-11-24,4,1,11,20,0,6,0,1,0.24,0.2121,0.44,0.2836,3,45,55,550,58,595
16492,2012-11-24,4,1,11,21,0,6,0,1,0.24,0.2273,0.44,0.194,9,135,66,660,75,795
16493,2012-11-24,4,1,11,22,0,6,0,1,0.24,0.2273,0.44,0.2537,7,105,69,690,76,795
16494,2012-11-24,4,1,11,23,0,6,0,1,0.24,0.2273,0.44,0.194,9,135,48,480,57,615
16495,2012-11-25,4,1,11,0,0,0,0,1,0.22,0.2121,0.47,0.2537,3,45,31,310,34,355
16496,2012-11-25,4,1,11,1,0,0,0,1,0.22,0.2273,0.44,0.194,4,60,32,320,36,380
16497,2012-11-25,4,1,11,2,0,0,0,1,0.22,0.197,0.44,0.3582,1,15,27,270,28,285
16498,2012-11-25,4,1,11,3,0,0,0,1,0.22,0.2727,0.44,0.0,0,0,8,80,8,80
16499,2012-11-25,4,1,11,4,0,0,0,1,0.22,0.2727,0.44,0.0,1,15,1,10,2,25
16500,2012-11-25,4,1,11,5,0,0,0,2,0.22,0.2273,0.47,0.1642,0,0,3,30,3,30
16501,2012-11-25,4,1,11,6,0,0,0,2,0.22,0.2424,0.47,0.1045,1,15,10,100,11,115
16502,2012-11-25,4,1,11,7,0,0,0,2,0.22,0.2424,0.51,0.1045,2,30,19,190,21,220
16503,2012-11-25,4,1,11,8,0,0,0,2,0.22,0.2273,0.51,0.194,2,30,32,320,34,350
16504,2012-11-25,4,1,11,9,0,0,0,2,0.24,0.2273,0.48,0.2239,13,195,83,830,96,1025
16505,2012-11-25,4,1,11,10,0,0,0,1,0.24,0.2273,0.48,0.2537,15,225,124,1240,139,1465
16506,2012-11-25,4,1,11,11,0,0,0,2,0.26,0.2576,0.41,0.2239,49,735,155,1550,204,2285
16507,2012-11-25,4,1,11,12,0,0,0,2,0.26,0.2576,0.41,0.2239,37,555,165,1650,202,2205
16508,2012-11-25,4,1,11,13,0,0,0,2,0.26,0.2576,0.41,0.1642,37,555,158,1580,195,2135
16509,2012-11-25,4,1,11,14,0,0,0,2,0.3,0.2879,0.42,0.2537,33,495,170,1700,203,2195
16510,2012-11-25,4,1,11,15,0,0,0,1,0.3,0.2879,0.42,0.2537,36,540,209,2090,245,2630
16511,2012-11-25,4,1,11,16,0,0,0,1,0.3,0.2879,0.39,0.2239,25,375,203,2030,228,2405
16512,2012-11-25,4,1,11,17,0,0,0,1,0.28,0.2727,0.41,0.1642,11,165,170,1700,181,1865
16513,2012-11-25,4,1,11,18,0,0,0,1,0.26,0.2576,0.44,0.1642,9,135,132,1320,141,1455
16514,2012-11-25,4,1,11,19,0,0,0,1,0.26,0.303,0.41,0.0,13,195,114,1140,127,1335
16515,2012-11-25,4,1,11,20,0,0,0,1,0.24,0.2879,0.6,0.0,9,135,110,1100,119,1235
16516,2012-11-25,4,1,11,21,0,0,0,1,0.26,0.303,0.48,0.0,4,60,60,600,64,660
16517,2012-11-25,4,1,11,22,0,0,0,1,0.24,0.2879,0.6,0.0,3,45,59,590,62,635
16518,2012-11-25,4,1,11,23,0,0,0,1,0.22,0.2576,0.69,0.0896,1,15,40,400,41,415
16519,2012-11-26,4,1,11,0,0,1,1,1,0.22,0.2727,0.69,0.0,4,60,19,190,23,250
16520,2012-11-26,4,1,11,1,0,1,1,1,0.2,0.2576,0.69,0.0,1,15,9,90,10,105
16521,2012-11-26,4,1,11,2,0,1,1,1,0.2,0.2576,0.69,0.0,0,0,5,50,5,50
16522,2012-11-26,4,1,11,3,0,1,1,1,0.2,0.2576,0.69,0.0,1,15,4,40,5,55
16523,2012-11-26,4,1,11,4,0,1,1,1,0.22,0.2727,0.69,0.0,0,0,10,100,10,100
16524,2012-11-26,4,1,11,5,0,1,1,1,0.22,0.2273,0.69,0.1642,0,0,41,410,41,410
16525,2012-11-26,4,1,11,6,0,1,1,1,0.22,0.2727,0.69,0.0,1,15,123,1230,124,1245
16526,2012-11-26,4,1,11,7,0,1,1,1,0.24,0.2879,0.65,0.0,2,30,363,3630,365,3660
16527,2012-11-26,4,1,11,8,0,1,1,1,0.24,0.2879,0.65,0.0,9,135,629,6290,638,6425
16528,2012-11-26,4,1,11,9,0,1,1,1,0.28,0.303,0.56,0.0896,10,150,276,2760,286,2910
16529,2012-11-26,4,1,11,10,0,1,1,1,0.32,0.3485,0.49,0.0,20,300,127,1270,147,1570
16530,2012-11-26,4,1,11,11,0,1,1,1,0.4,0.4091,0.37,0.2985,18,270,112,1120,130,1390
16531,2012-11-26,4,1,11,12,0,1,1,1,0.42,0.4242,0.35,0.1045,22,330,188,1880,210,2210
16532,2012-11-26,4,1,11,13,0,1,1,1,0.42,0.4242,0.35,0.1045,20,300,197,1970,217,2270
16533,2012-11-26,4,1,11,14,0,1,1,1,0.42,0.4242,0.35,0.0,51,765,177,1770,228,2535
16534,2012-11-26,4,1,11,15,0,1,1,1,0.42,0.4242,0.35,0.0896,49,735,181,1810,230,2545
16535,2012-11-26,4,1,11,16,0,1,1,1,0.44,0.4394,0.3,0.0,49,735,297,2970,346,3705
16536,2012-11-26,4,1,11,17,0,1,1,1,0.42,0.4242,0.32,0.0,13,195,540,5400,553,5595
16537,2012-11-26,4,1,11,18,0,1,1,1,0.36,0.3485,0.5,0.1642,19,285,502,5020,521,5305
16538,2012-11-26,4,1,11,19,0,1,1,1,0.34,0.3636,0.53,0.0,16,240,355,3550,371,3790
16539,2012-11-26,4,1,11,20,0,1,1,1,0.34,0.3636,0.49,0.0,12,180,265,2650,277,2830
16540,2012-11-26,4,1,11,21,0,1,1,1,0.34,0.3636,0.49,0.0,9,135,172,1720,181,1855
16541,2012-11-26,4,1,11,22,0,1,1,1,0.32,0.3485,0.61,0.0,3,45,101,1010,104,1055
16542,2012-11-26,4,1,11,23,0,1,1,2,0.32,0.3333,0.66,0.1045,8,120,57,570,65,690
16543,2012-11-27,4,1,11,0,0,2,1,2,0.32,0.3333,0.66,0.0896,2,30,24,240,26,270
16544,2012-11-27,4,1,11,1,0,2,1,2,0.32,0.3333,0.7,0.1343,0,0,6,60,6,60
16545,2012-11-27,4,1,11,2,0,2,1,2,0.32,0.3182,0.7,0.1642,0,0,5,50,5,50
16546,2012-11-27,4,1,11,3,0,2,1,3,0.32,0.3333,0.7,0.1343,1,15,3,30,4,45
16547,2012-11-27,4,1,11,4,0,2,1,3,0.3,0.2879,0.81,0.194,0,0,5,50,5,50
16548,2012-11-27,4,1,11,5,0,2,1,2,0.3,0.2879,0.81,0.2239,0,0,31,310,31,310
16549,2012-11-27,4,1,11,6,0,2,1,2,0.3,0.303,0.81,0.1642,3,45,97,970,100,1015
16550,2012-11-27,4,1,11,7,0,2,1,3,0.3,0.303,0.81,0.1343,4,60,289,2890,293,2950
16551,2012-11-27,4,1,11,8,0,2,1,3,0.32,0.3182,0.81,0.1642,6,90,494,4940,500,5030
16552,2012-11-27,4,1,11,9,0,2,1,2,0.32,0.3333,0.81,0.1343,11,165,257,2570,268,2735
16553,2012-11-27,4,1,11,10,0,2,1,3,0.32,0.3182,0.81,0.194,5,75,52,520,57,595
16554,2012-11-27,4,1,11,11,0,2,1,3,0.3,0.2727,0.87,0.2985,6,90,59,590,65,680
16555,2012-11-27,4,1,11,12,0,2,1,3,0.28,0.2576,0.87,0.3881,6,90,70,700,76,790
16556,2012-11-27,4,1,11,13,0,2,1,3,0.28,0.2727,0.87,0.2537,4,60,73,730,77,790
16557,2012-11-27,4,1,11,14,0,2,1,3,0.28,0.2576,0.87,0.3582,8,120,86,860,94,980
16558,2012-11-27,4,1,11,15,0,2,1,2,0.3,0.2727,0.75,0.2985,9,135,146,1460,155,1595
16559,2012-11-27,4,1,11,16,0,2,1,2,0.3,0.2727,0.75,0.2985,5,75,252,2520,257,2595
16560,2012-11-27,4,1,11,17,0,2,1,2,0.3,0.2727,0.75,0.3881,13,195,514,5140,527,5335
16561,2012-11-27,4,1,11,18,0,2,1,1,0.26,0.2273,0.81,0.3582,13,195,469,4690,482,4885
16562,2012-11-27,4,1,11,19,0,2,1,1,0.26,0.2576,0.73,0.2985,12,180,338,3380,350,3560
16563,2012-11-27,4,1,11,20,0,2,1,1,0.26,0.2273,0.75,0.3284,4,60,228,2280,232,2340
16564,2012-11-27,4,1,11,21,0,2,1,1,0.24,0.2121,0.81,0.2836,6,90,179,1790,185,1880
16565,2012-11-27,4,1,11,22,0,2,1,1,0.24,0.2424,0.81,0.1642,2,30,95,950,97,980
16566,2012-11-27,4,1,11,23,0,2,1,2,0.26,0.2424,0.81,0.2537,3,45,64,640,67,685
16567,2012-11-28,4,1,11,0,0,3,1,2,0.26,0.2424,0.75,0.2537,1,15,22,220,23,235
16568,2012-11-28,4,1,11,1,0,3,1,2,0.26,0.2576,0.75,0.2239,0,0,12,120,12,120
16569,2012-11-28,4,1,11,2,0,3,1,2,0.26,0.2576,0.75,0.2239,0,0,1,10,1,10
16570,2012-11-28,4,1,11,3,0,3,1,2,0.26,0.2576,0.7,0.2239,0,0,3,30,3,30
16571,2012-11-28,4,1,11,4,0,3,1,2,0.26,0.2576,0.7,0.194,0,0,4,40,4,40
16572,2012-11-28,4,1,11,5,0,3,1,2,0.26,0.2727,0.7,0.1343,0,0,39,390,39,390
16573,2012-11-28,4,1,11,6,0,3,1,2,0.26,0.2576,0.65,0.2239,4,60,132,1320,136,1380
16574,2012-11-28,4,1,11,7,0,3,1,2,0.26,0.2576,0.56,0.194,6,90,403,4030,409,4120
16575,2012-11-28,4,1,11,8,0,3,1,1,0.24,0.2121,0.6,0.2836,9,135,683,6830,692,6965
16576,2012-11-28,4,1,11,9,0,3,1,1,0.28,0.2727,0.52,0.194,13,195,309,3090,322,3285
16577,2012-11-28,4,1,11,10,0,3,1,1,0.3,0.3182,0.49,0.1045,17,255,144,1440,161,1695
16578,2012-11-28,4,1,11,11,0,3,1,1,0.32,0.3182,0.45,0.1642,19,285,127,1270,146,1555
16579,2012-11-28,4,1,11,12,0,3,1,1,0.34,0.303,0.42,0.3881,19,285,189,1890,208,2175
16580,2012-11-28,4,1,11,13,0,3,1,1,0.34,0.3333,0.42,0.194,21,315,193,1930,214,2245
16581,2012-11-28,4,1,11,14,0,3,1,1,0.36,0.3333,0.4,0.2985,15,225,161,1610,176,1835
16582,2012-11-28,4,1,11,15,0,3,1,1,0.36,0.3333,0.32,0.3284,7,105,172,1720,179,1825
16583,2012-11-28,4,1,11,16,0,3,1,1,0.36,0.3333,0.29,0.2537,9,135,316,3160,325,3295
16584,2012-11-28,4,1,11,17,0,3,1,1,0.34,0.3333,0.31,0.1343,17,255,546,5460,563,5715
16585,2012-11-28,4,1,11,18,0,3,1,1,0.32,0.303,0.33,0.2836,12,180,530,5300,542,5480
16586,2012-11-28,4,1,11,19,0,3,1,1,0.32,0.3182,0.36,0.1642,9,135,378,3780,387,3915
16587,2012-11-28,4,1,11,20,0,3,1,1,0.32,0.3333,0.36,0.1343,5,75,258,2580,263,2655
16588,2012-11-28,4,1,11,21,0,3,1,1,0.3,0.303,0.39,0.1642,4,60,219,2190,223,2250
16589,2012-11-28,4,1,11,22,0,3,1,1,0.28,0.2727,0.45,0.1642,6,90,148,1480,154,1570
16590,2012-11-28,4,1,11,23,0,3,1,1,0.26,0.2727,0.48,0.1343,5,75,73,730,78,805
16591,2012-11-29,4,1,11,0,0,4,1,1,0.24,0.2576,0.56,0.0896,4,60,25,250,29,310
16592,2012-11-29,4,1,11,1,0,4,1,1,0.22,0.2576,0.64,0.0896,1,15,15,150,16,165
16593,2012-11-29,4,1,11,2,0,4,1,1,0.22,0.2727,0.64,0.0,1,15,6,60,7,75
16594,2012-11-29,4,1,11,4,0,4,1,1,0.2,0.2273,0.75,0.0896,0,0,7,70,7,70
16595,2012-11-29,4,1,11,5,0,4,1,1,0.2,0.2576,0.69,0.0,0,0,42,420,42,420
16596,2012-11-29,4,1,11,6,0,4,1,1,0.22,0.2727,0.69,0.0,1,15,120,1200,121,1215
16597,2012-11-29,4,1,11,7,0,4,1,1,0.2,0.2576,0.64,0.0,8,120,354,3540,362,3660
16598,2012-11-29,4,1,11,8,0,4,1,1,0.2,0.2273,0.69,0.1045,15,225,664,6640,679,6865
16599,2012-11-29,4,1,11,9,0,4,1,1,0.24,0.2879,0.6,0.0,13,195,286,2860,299,3055
16600,2012-11-29,4,1,11,10,0,4,1,1,0.28,0.303,0.65,0.0896,25,375,153,1530,178,1905
16601,2012-11-29,4,1,11,11,0,4,1,1,0.36,0.3485,0.37,0.2239,13,195,150,1500,163,1695
16602,2012-11-29,4,1,11,12,0,4,1,1,0.36,0.3485,0.4,0.1642,11,165,225,2250,236,2415
16603,2012-11-29,4,1,11,13,0,4,1,1,0.38,0.3939,0.32,0.1343,15,225,209,2090,224,2315
16604,2012-11-29,4,1,11,14,0,4,1,1,0.36,0.3485,0.43,0.2239,13,195,174,1740,187,1935
16605,2012-11-29,4,1,11,15,0,4,1,1,0.36,0.3333,0.43,0.2836,19,285,201,2010,220,2295
16606,2012-11-29,4,1,11,16,0,4,1,1,0.36,0.3485,0.4,0.2239,24,360,346,3460,370,3820
16607,2012-11-29,4,1,11,17,0,4,1,1,0.34,0.3333,0.39,0.194,17,255,544,5440,561,5695
16608,2012-11-29,4,1,11,18,0,4,1,1,0.32,0.3182,0.49,0.1642,17,255,520,5200,537,5455
16609,2012-11-29,4,1,11,19,0,4,1,1,0.3,0.2879,0.52,0.194,18,270,326,3260,344,3530
16610,2012-11-29,4,1,11,20,0,4,1,1,0.3,0.303,0.52,0.1642,11,165,241,2410,252,2575
16611,2012-11-29,4,1,11,21,0,4,1,1,0.26,0.2727,0.65,0.1343,7,105,201,2010,208,2115
16612,2012-11-29,4,1,11,22,0,4,1,1,0.26,0.2879,0.7,0.0896,4,60,147,1470,151,1530
16613,2012-11-29,4,1,11,23,0,4,1,1,0.28,0.3182,0.61,0.0,6,90,124,1240,130,1330
16614,2012-11-30,4,1,11,0,0,5,1,1,0.26,0.2576,0.7,0.1642,4,60,48,480,52,540
16615,2012-11-30,4,1,11,1,0,5,1,1,0.24,0.2576,0.7,0.0896,2,30,17,170,19,200
16616,2012-11-30,4,1,11,2,0,5,1,1,0.24,0.2879,0.75,0.0,2,30,10,100,12,130
16617,2012-11-30,4,1,11,3,0,5,1,1,0.24,0.2879,0.75,0.0,0,0,4,40,4,40
16618,2012-11-30,4,1,11,4,0,5,1,1,0.22,0.2727,0.75,0.0,0,0,3,30,3,30
16619,2012-11-30,4,1,11,5,0,5,1,1,0.2,0.2576,0.8,0.0,1,15,39,390,40,405
16620,2012-11-30,4,1,11,6,0,5,1,1,0.2,0.2576,0.86,0.0,2,30,104,1040,106,1070
16621,2012-11-30,4,1,11,7,0,5,1,1,0.22,0.2727,0.8,0.0,6,90,346,3460,352,3550
16622,2012-11-30,4,1,11,8,0,5,1,2,0.22,0.2576,0.8,0.0896,20,300,709,7090,729,7390
16623,2012-11-30,4,1,11,9,0,5,1,1,0.24,0.2576,0.75,0.0896,17,255,313,3130,330,3385
16624,2012-11-30,4,1,11,10,0,5,1,2,0.3,0.3333,0.65,0.0,10,150,159,1590,169,1740
16625,2012-11-30,4,1,11,11,0,5,1,2,0.34,0.3485,0.53,0.0896,31,465,170,1700,201,2165
16626,2012-11-30,4,1,11,12,0,5,1,2,0.38,0.3939,0.46,0.0,25,375,243,2430,268,2805
16627,2012-11-30,4,1,11,13,0,5,1,2,0.4,0.4091,0.4,0.1642,21,315,241,2410,262,2725
16628,2012-11-30,4,1,11,14,0,5,1,2,0.4,0.4091,0.4,0.1045,26,390,225,2250,251,2640
16629,2012-11-30,4,1,11,15,0,5,1,2,0.42,0.4242,0.38,0.1045,34,510,262,2620,296,3130
16630,2012-11-30,4,1,11,16,0,5,1,1,0.4,0.4091,0.43,0.1343,37,555,368,3680,405,4235
16631,2012-11-30,4,1,11,17,0,5,1,1,0.36,0.3485,0.5,0.194,31,465,551,5510,582,5975
16632,2012-11-30,4,1,11,18,0,5,1,2,0.34,0.3636,0.61,0.0,20,300,489,4890,509,5190
16633,2012-11-30,4,1,11,19,0,5,1,1,0.32,0.3485,0.66,0.0,18,270,359,3590,377,3860
16634,2012-11-30,4,1,11,20,0,5,1,1,0.32,0.3485,0.66,0.0,12,180,233,2330,245,2510
16635,2012-11-30,4,1,11,21,0,5,1,1,0.3,0.3182,0.75,0.0896,14,210,169,1690,183,1900
16636,2012-11-30,4,1,11,22,0,5,1,1,0.3,0.3333,0.75,0.0,18,270,145,1450,163,1720
16637,2012-11-30,4,1,11,23,0,5,1,2,0.3,0.3182,0.75,0.0896,11,165,99,990,110,1155
16638,2012-12-01,4,1,12,0,0,6,0,1,0.26,0.303,0.81,0.0,9,135,99,990,108,1125
16639,2012-12-01,4,1,12,1,0,6,0,1,0.26,0.303,0.81,0.0,5,75,64,640,69,715
16640,2012-12-01,4,1,12,2,0,6,0,2,0.26,0.303,0.81,0.0,3,45,47,470,50,515
16641,2012-12-01,4,1,12,3,0,6,0,2,0.26,0.2727,0.81,0.1343,1,15,14,140,15,155
16642,2012-12-01,4,1,12,4,0,6,0,1,0.26,0.2879,0.81,0.0896,0,0,5,50,5,50
16643,2012-12-01,4,1,12,5,0,6,0,1,0.24,0.2576,0.87,0.0896,1,15,12,120,13,135
16644,2012-12-01,4,1,12,6,0,6,0,1,0.24,0.2424,0.87,0.1343,7,105,20,200,27,305
16645,2012-12-01,4,1,12,7,0,6,0,2,0.24,0.2424,0.87,0.1343,7,105,56,560,63,665
16646,2012-12-01,4,1,12,8,0,6,0,2,0.24,0.2424,0.87,0.1343,11,165,133,1330,144,1495
16647,2012-12-01,4,1,12,9,0,6,0,2,0.26,0.2424,0.93,0.2537,34,510,159,1590,193,2100
16648,2012-12-01,4,1,12,10,0,6,0,2,0.28,0.2727,0.89,0.1642,45,675,211,2110,256,2785
16649,2012-12-01,4,1,12,11,0,6,0,2,0.32,0.3333,0.76,0.1045,74,1110,318,3180,392,4290
16650,2012-12-01,4,1,12,12,0,6,0,2,0.32,0.3333,0.81,0.0896,119,1785,327,3270,446,5055
16651,2012-12-01,4,1,12,13,0,6,0,2,0.34,0.3636,0.76,0.0,123,1845,386,3860,509,5705
16652,2012-12-01,4,1,12,14,0,6,0,2,0.36,0.3788,0.71,0.0,110,1650,369,3690,479,5340
16653,2012-12-01,4,1,12,15,0,6,0,2,0.4,0.4091,0.62,0.0,113,1695,371,3710,484,5405
16654,2012-12-01,4,1,12,16,0,6,0,2,0.38,0.3939,0.66,0.0,89,1335,354,3540,443,4875
16655,2012-12-01,4,1,12,17,0,6,0,2,0.34,0.3485,0.76,0.1045,50,750,270,2700,320,3450
16656,2012-12-01,4,1,12,18,0,6,0,2,0.34,0.3636,0.76,0.0,42,630,255,2550,297,3180
16657,2012-12-01,4,1,12,19,0,6,0,2,0.32,0.3485,0.81,0.0,30,450,219,2190,249,2640
16658,2012-12-01,4,1,12,20,0,6,0,1,0.32,0.3485,0.81,0.0,28,420,170,1700,198,2120
16659,2012-12-01,4,1,12,21,0,6,0,2,0.3,0.3333,0.87,0.0,23,345,135,1350,158,1695
16660,2012-12-01,4,1,12,22,0,6,0,2,0.3,0.3333,0.87,0.0,17,255,130,1300,147,1555
16661,2012-12-01,4,1,12,23,0,6,0,2,0.32,0.3485,0.81,0.0,10,150,116,1160,126,1310
16662,2012-12-02,4,1,12,0,0,0,0,2,0.3,0.3182,0.87,0.0896,9,135,108,1080,117,1215
16663,2012-12-02,4,1,12,1,0,0,0,2,0.3,0.3182,0.87,0.0896,10,150,84,840,94,990
16664,2012-12-02,4,1,12,2,0,0,0,2,0.3,0.3333,0.87,0.0,2,30,72,720,74,750
16665,2012-12-02,4,1,12,3,0,0,0,2,0.26,0.303,0.93,0.0,4,60,21,210,25,270
16666,2012-12-02,4,1,12,4,0,0,0,2,0.26,0.303,0.93,0.0,1,15,6,60,7,75
16667,2012-12-02,4,1,12,5,0,0,0,2,0.26,0.303,0.93,0.0,1,15,7,70,8,85
16668,2012-12-02,4,1,12,6,0,0,0,2,0.24,0.2424,0.93,0.1343,1,15,15,150,16,165
16669,2012-12-02,4,1,12,7,0,0,0,2,0.24,0.2424,0.93,0.1343,5,75,26,260,31,335
16670,2012-12-02,4,1,12,8,0,0,0,2,0.26,0.2879,0.93,0.0896,12,180,81,810,93,990
16671,2012-12-02,4,1,12,9,0,0,0,2,0.28,0.2727,0.93,0.1642,37,555,135,1350,172,1905
16672,2012-12-02,4,1,12,10,0,0,0,2,0.3,0.3333,0.87,0.0,63,945,230,2300,293,3245
16673,2012-12-02,4,1,12,11,0,0,0,2,0.32,0.3182,0.81,0.1642,81,1215,274,2740,355,3955
16674,2012-12-02,4,1,12,12,0,0,0,2,0.34,0.3333,0.81,0.1642,111,1665,409,4090,520,5755
16675,2012-12-02,4,1,12,13,0,0,0,1,0.4,0.4091,0.71,0.2239,84,1260,347,3470,431,4730
16676,2012-12-02,4,1,12,14,0,0,0,1,0.44,0.4394,0.62,0.2537,142,2130,331,3310,473,5440
16677,2012-12-02,4,1,12,15,0,0,0,1,0.44,0.4394,0.67,0.1343,106,1590,311,3110,417,4700
16678,2012-12-02,4,1,12,16,0,0,0,2,0.44,0.4394,0.67,0.1045,85,1275,358,3580,443,4855
16679,2012-12-02,4,1,12,17,0,0,0,3,0.4,0.4091,0.76,0.194,59,885,244,2440,303,3325
16680,2012-12-02,4,1,12,18,0,0,0,2,0.44,0.4394,0.72,0.1045,25,375,178,1780,203,2155
16681,2012-12-02,4,1,12,19,0,0,0,2,0.4,0.4091,0.82,0.194,16,240,158,1580,174,1820
16682,2012-12-02,4,1,12,20,0,0,0,2,0.42,0.4242,0.82,0.194,12,180,142,1420,154,1600
16683,2012-12-02,4,1,12,21,0,0,0,2,0.44,0.4394,0.77,0.2239,8,120,91,910,99,1030
16684,2012-12-02,4,1,12,22,0,0,0,2,0.44,0.4394,0.77,0.194,11,165,85,850,96,1015
16685,2012-12-02,4,1,12,23,0,0,0,2,0.42,0.4242,0.82,0.1343,7,105,44,440,51,545
16686,2012-12-03,4,1,12,0,0,1,1,2,0.42,0.4242,0.82,0.1642,3,45,18,180,21,225
16687,2012-12-03,4,1,12,1,0,1,1,1,0.4,0.4091,0.82,0.1343,2,30,11,110,13,140
16688,2012-12-03,4,1,12,2,0,1,1,1,0.42,0.4242,0.77,0.1642,1,15,9,90,10,105
16689,2012-12-03,4,1,12,3,0,1,1,1,0.38,0.3939,0.87,0.0,2,30,6,60,8,90
16690,2012-12-03,4,1,12,4,0,1,1,1,0.36,0.3788,0.93,0.0,1,15,4,40,5,55
16691,2012-12-03,4,1,12,5,0,1,1,1,0.34,0.3485,0.93,0.0896,0,0,38,380,38,380
16692,2012-12-03,4,1,12,6,0,1,1,1,0.36,0.3788,0.93,0.0,2,30,136,1360,138,1390
16693,2012-12-03,4,1,12,7,0,1,1,2,0.34,0.3636,0.93,0.0,9,135,387,3870,396,4005
16694,2012-12-03,4,1,12,8,0,1,1,1,0.36,0.3788,0.93,0.0,19,285,712,7120,731,7405
16695,2012-12-03,4,1,12,9,0,1,1,1,0.4,0.4091,0.87,0.0896,19,285,289,2890,308,3175
16696,2012-12-03,4,1,12,10,0,1,1,1,0.44,0.4394,0.77,0.1343,31,465,105,1050,136,1515
16697,2012-12-03,4,1,12,11,0,1,1,1,0.48,0.4697,0.77,0.1343,51,765,182,1820,233,2585
16698,2012-12-03,4,1,12,12,0,1,1,1,0.52,0.5,0.68,0.1642,40,600,228,2280,268,2880
16699,2012-12-03,4,1,12,13,0,1,1,1,0.58,0.5455,0.56,0.0896,81,1215,240,2400,321,3615
16700,2012-12-03,4,1,12,14,0,1,1,1,0.6,0.6212,0.53,0.0,51,765,209,2090,260,2855
16701,2012-12-03,4,1,12,15,0,1,1,1,0.6,0.6212,0.56,0.0,58,870,210,2100,268,2970
16702,2012-12-03,4,1,12,16,0,1,1,1,0.6,0.6212,0.53,0.1343,45,675,397,3970,442,4645
16703,2012-12-03,4,1,12,17,0,1,1,1,0.52,0.5,0.63,0.1045,43,645,665,6650,708,7295
16704,2012-12-03,4,1,12,18,0,1,1,1,0.5,0.4848,0.68,0.0896,26,390,666,6660,692,7050
16705,2012-12-03,4,1,12,19,0,1,1,1,0.5,0.4848,0.68,0.0896,27,405,444,4440,471,4845
16706,2012-12-03,4,1,12,20,0,1,1,2,0.46,0.4545,0.77,0.0,16,240,284,2840,300,3080
16707,2012-12-03,4,1,12,21,0,1,1,1,0.44,0.4394,0.82,0.194,14,210,207,2070,221,2280
16708,2012-12-03,4,1,12,22,0,1,1,1,0.42,0.4242,0.82,0.1045,5,75,139,1390,144,1465
16709,2012-12-03,4,1,12,23,0,1,1,1,0.42,0.4242,0.82,0.1045,9,135,93,930,102,1065
16710,2012-12-04,4,1,12,0,0,2,1,1,0.42,0.4242,0.88,0.1045,6,90,49,490,55,580
16711,2012-12-04,4,1,12,1,0,2,1,1,0.42,0.4242,0.82,0.1045,3,45,22,220,25,265
16712,2012-12-04,4,1,12,2,0,2,1,1,0.42,0.4242,0.88,0.0896,3,45,5,50,8,95
16713,2012-12-04,4,1,12,3,0,2,1,2,0.4,0.4091,0.87,0.1343,1,15,3,30,4,45
16714,2012-12-04,4,1,12,4,0,2,1,2,0.4,0.4091,0.87,0.1343,0,0,7,70,7,70
16715,2012-12-04,4,1,12,5,0,2,1,2,0.44,0.4394,0.88,0.0,1,15,45,450,46,465
16716,2012-12-04,4,1,12,6,0,2,1,2,0.36,0.3788,0.93,0.0,3,45,150,1500,153,1545
16717,2012-12-04,4,1,12,7,0,2,1,1,0.42,0.4242,0.88,0.1343,7,105,495,4950,502,5055
16718,2012-12-04,4,1,12,8,0,2,1,2,0.44,0.4394,0.88,0.1642,21,315,700,7000,721,7315
16719,2012-12-04,4,1,12,9,0,2,1,1,0.46,0.4545,0.82,0.1045,19,285,317,3170,336,3455
16720,2012-12-04,4,1,12,10,0,2,1,1,0.46,0.4545,0.82,0.194,26,390,130,1300,156,1690
16721,2012-12-04,4,1,12,11,0,2,1,1,0.48,0.4697,0.77,0.194,24,360,183,1830,207,2190
16722,2012-12-04,4,1,12,12,0,2,1,1,0.52,0.5,0.68,0.194,39,585,273,2730,312,3315
16723,2012-12-04,4,1,12,13,0,2,1,2,0.54,0.5152,0.64,0.1642,39,585,233,2330,272,2915
16724,2012-12-04,4,1,12,14,0,2,1,2,0.58,0.5455,0.56,0.2239,39,585,231,2310,270,2895
16725,2012-12-04,4,1,12,15,0,2,1,2,0.6,0.6212,0.49,0.2537,56,840,244,2440,300,3280
16726,2012-12-04,4,1,12,16,0,2,1,1,0.58,0.5455,0.49,0.2836,44,660,391,3910,435,4570
16727,2012-12-04,4,1,12,17,0,2,1,1,0.52,0.5,0.59,0.2239,43,645,700,7000,743,7645
16728,2012-12-04,4,1,12,18,0,2,1,1,0.5,0.4848,0.63,0.2239,38,570,693,6930,731,7500
16729,2012-12-04,4,1,12,19,0,2,1,1,0.48,0.4697,0.67,0.2239,46,690,414,4140,460,4830
16730,2012-12-04,4,1,12,20,0,2,1,2,0.5,0.4848,0.63,0.2239,34,510,272,2720,306,3230
16731,2012-12-04,4,1,12,21,0,2,1,2,0.5,0.4848,0.63,0.2537,28,420,252,2520,280,2940
16732,2012-12-04,4,1,12,22,0,2,1,2,0.5,0.4848,0.63,0.2985,26,390,155,1550,181,1940
16733,2012-12-04,4,1,12,23,0,2,1,1,0.48,0.4697,0.67,0.2537,5,75,91,910,96,985
16734,2012-12-05,4,1,12,0,0,3,1,1,0.5,0.4848,0.59,0.2836,6,90,31,310,37,400
16735,2012-12-05,4,1,12,1,0,3,1,1,0.52,0.5,0.55,0.3284,0,0,11,110,11,110
16736,2012-12-05,4,1,12,2,0,3,1,1,0.46,0.4545,0.67,0.1642,2,30,7,70,9,100
16737,2012-12-05,4,1,12,3,0,3,1,1,0.48,0.4697,0.67,0.1343,0,0,7,70,7,70
16738,2012-12-05,4,1,12,4,0,3,1,1,0.5,0.4848,0.63,0.4478,1,15,9,90,10,105
16739,2012-12-05,4,1,12,5,0,3,1,1,0.5,0.4848,0.59,0.2836,1,15,48,480,49,495
16740,2012-12-05,4,1,12,6,0,3,1,3,0.48,0.4697,0.55,0.3881,5,75,119,1190,124,1265
16741,2012-12-05,4,1,12,7,0,3,1,3,0.46,0.4545,0.59,0.2985,9,135,389,3890,398,4025
16742,2012-12-05,4,1,12,8,0,3,1,2,0.44,0.4394,0.58,0.2836,22,330,737,7370,759,7700
16743,2012-12-05,4,1,12,9,0,3,1,2,0.44,0.4394,0.51,0.2239,26,390,362,3620,388,4010
16744,2012-12-05,4,1,12,10,0,3,1,2,0.44,0.4394,0.47,0.3582,14,210,127,1270,141,1480
16745,2012-12-05,4,1,12,11,0,3,1,1,0.44,0.4394,0.44,0.2836,11,165,161,1610,172,1775
16746,2012-12-05,4,1,12,12,0,3,1,1,0.44,0.4394,0.41,0.2836,24,360,208,2080,232,2440
16747,2012-12-05,4,1,12,13,0,3,1,1,0.46,0.4545,0.41,0.2836,14,210,200,2000,214,2210
16748,2012-12-05,4,1,12,14,0,3,1,1,0.48,0.4697,0.33,0.4925,39,585,179,1790,218,2375
16749,2012-12-05,4,1,12,15,0,3,1,1,0.48,0.4697,0.33,0.2836,20,300,265,2650,285,2950
16750,2012-12-05,4,1,12,16,0,3,1,1,0.46,0.4545,0.33,0.2836,23,345,354,3540,377,3885
16751,2012-12-05,4,1,12,17,0,3,1,1,0.44,0.4394,0.35,0.2836,29,435,576,5760,605,6195
16752,2012-12-05,4,1,12,18,0,3,1,1,0.42,0.4242,0.35,0.4478,29,435,580,5800,609,6235
16753,2012-12-05,4,1,12,19,0,3,1,1,0.38,0.3939,0.43,0.3582,14,210,400,4000,414,4210
16754,2012-12-05,4,1,12,20,0,3,1,1,0.34,0.303,0.46,0.3881,19,285,274,2740,293,3025
16755,2012-12-05,4,1,12,21,0,3,1,1,0.34,0.303,0.46,0.4179,14,210,184,1840,198,2050
16756,2012-12-05,4,1,12,22,0,3,1,1,0.32,0.2879,0.45,0.3881,4,60,101,1010,105,1070
16757,2012-12-05,4,1,12,23,0,3,1,1,0.3,0.2727,0.49,0.3881,5,75,69,690,74,765
16758,2012-12-06,4,1,12,0,0,4,1,1,0.26,0.2424,0.48,0.2836,1,15,43,430,44,445
16759,2012-12-06,4,1,12,1,0,4,1,1,0.26,0.2424,0.48,0.2836,0,0,16,160,16,160
16760,2012-12-06,4,1,12,2,0,4,1,1,0.24,0.2121,0.52,0.2836,0,0,9,90,9,90
16761,2012-12-06,4,1,12,3,0,4,1,1,0.22,0.2273,0.55,0.194,0,0,2,20,2,20
16762,2012-12-06,4,1,12,4,0,4,1,1,0.22,0.2121,0.55,0.2985,1,15,8,80,9,95
16763,2012-12-06,4,1,12,5,0,4,1,1,0.22,0.2121,0.55,0.2836,0,0,32,320,32,320
16764,2012-12-06,4,1,12,6,0,4,1,1,0.22,0.2121,0.55,0.2985,2,30,122,1220,124,1250
16765,2012-12-06,4,1,12,7,0,4,1,1,0.22,0.2121,0.51,0.2985,8,120,381,3810,389,3930
16766,2012-12-06,4,1,12,8,0,4,1,1,0.22,0.2121,0.51,0.2985,13,195,646,6460,659,6655
16767,2012-12-06,4,1,12,9,0,4,1,1,0.24,0.2273,0.48,0.194,19,285,257,2570,276,2855
16768,2012-12-06,4,1,12,10,0,4,1,1,0.24,0.2273,0.52,0.194,23,345,122,1220,145,1565
16769,2012-12-06,4,1,12,11,0,4,1,1,0.26,0.2576,0.48,0.1642,16,240,162,1620,178,1860
16770,2012-12-06,4,1,12,12,0,4,1,1,0.28,0.3182,0.41,0.0,29,435,206,2060,235,2495
16771,2012-12-06,4,1,12,13,0,4,1,1,0.3,0.3333,0.39,0.0,33,495,212,2120,245,2615
16772,2012-12-06,4,1,12,14,0,4,1,1,0.3,0.3182,0.42,0.0896,37,555,175,1750,212,2305
16773,2012-12-06,4,1,12,15,0,4,1,1,0.32,0.3485,0.39,0.0,38,570,232,2320,270,2890
16774,2012-12-06,4,1,12,16,0,4,1,1,0.32,0.3485,0.42,0.0,39,585,292,2920,331,3505
16775,2012-12-06,4,1,12,17,0,4,1,1,0.3,0.3182,0.45,0.1045,31,465,586,5860,617,6325
16776,2012-12-06,4,1,12,18,0,4,1,1,0.28,0.2727,0.45,0.1642,23,345,542,5420,565,5765
16777,2012-12-06,4,1,12,19,0,4,1,1,0.26,0.2576,0.6,0.194,13,195,360,3600,373,3795
16778,2012-12-06,4,1,12,20,0,4,1,2,0.24,0.2576,0.6,0.1045,5,75,222,2220,227,2295
16779,2012-12-06,4,1,12,21,0,4,1,2,0.24,0.2424,0.6,0.1343,7,105,184,1840,191,1945
16780,2012-12-06,4,1,12,22,0,4,1,1,0.24,0.2424,0.65,0.1642,2,30,131,1310,133,1340
16781,2012-12-06,4,1,12,23,0,4,1,1,0.24,0.2424,0.65,0.1642,0,0,93,930,93,930
16782,2012-12-07,4,1,12,0,0,5,1,1,0.24,0.2576,0.7,0.1045,3,45,45,450,48,495
16783,2012-12-07,4,1,12,1,0,5,1,2,0.24,0.2273,0.7,0.194,2,30,26,260,28,290
16784,2012-12-07,4,1,12,2,0,5,1,2,0.26,0.2727,0.7,0.1343,0,0,11,110,11,110
16785,2012-12-07,4,1,12,3,0,5,1,2,0.26,0.2576,0.81,0.194,0,0,5,50,5,50
16786,2012-12-07,4,1,12,4,0,5,1,1,0.26,0.2727,0.75,0.1045,0,0,10,100,10,100
16787,2012-12-07,4,1,12,5,0,5,1,2,0.26,0.2727,0.81,0.1045,1,15,25,250,26,265
16788,2012-12-07,4,1,12,6,0,5,1,2,0.28,0.2727,0.75,0.1642,0,0,84,840,84,840
16789,2012-12-07,4,1,12,7,0,5,1,3,0.28,0.2727,0.81,0.1642,3,45,212,2120,215,2165
16790,2012-12-07,4,1,12,8,0,5,1,2,0.3,0.2879,0.75,0.194,11,165,430,4300,441,4465
16791,2012-12-07,4,1,12,9,0,5,1,2,0.3,0.303,0.81,0.1343,10,150,291,2910,301,3060
16792,2012-12-07,4,1,12,10,0,5,1,2,0.32,0.3182,0.76,0.1642,16,240,150,1500,166,1740
16793,2012-12-07,4,1,12,11,0,5,1,2,0.32,0.3182,0.76,0.194,20,300,183,1830,203,2130
16794,2012-12-07,4,1,12,12,0,5,1,2,0.34,0.3333,0.71,0.194,36,540,204,2040,240,2580
16795,2012-12-07,4,1,12,13,0,5,1,2,0.36,0.3485,0.66,0.1343,23,345,197,1970,220,2315
16796,2012-12-07,4,1,12,14,0,5,1,2,0.36,0.3485,0.71,0.1642,40,600,175,1750,215,2350
16797,2012-12-07,4,1,12,15,0,5,1,2,0.36,0.3485,0.71,0.1642,34,510,269,2690,303,3200
16798,2012-12-07,4,1,12,16,0,5,1,1,0.36,0.3485,0.76,0.1343,39,585,336,3360,375,3945
16799,2012-12-07,4,1,12,17,0,5,1,2,0.38,0.3939,0.66,0.0,29,435,539,5390,568,5825
16800,2012-12-07,4,1,12,18,0,5,1,2,0.38,0.3939,0.71,0.1045,25,375,473,4730,498,5105
16801,2012-12-07,4,1,12,19,0,5,1,2,0.38,0.3939,0.76,0.0,15,225,337,3370,352,3595
16802,2012-12-07,4,1,12,20,0,5,1,3,0.38,0.3939,0.76,0.1045,12,180,229,2290,241,2470
16803,2012-12-07,4,1,12,21,0,5,1,2,0.36,0.3636,0.93,0.1045,9,135,162,1620,171,1755
16804,2012-12-07,4,1,12,22,0,5,1,2,0.36,0.3636,0.93,0.0896,15,225,150,1500,165,1725
16805,2012-12-07,4,1,12,23,0,5,1,2,0.36,0.3636,0.93,0.0896,6,90,116,1160,122,1250
16806,2012-12-08,4,1,12,0,0,6,0,2,0.36,0.3636,0.93,0.0896,5,75,98,980,103,1055
16807,2012-12-08,4,1,12,1,0,6,0,2,0.36,0.3485,0.93,0.1343,16,240,84,840,100,1080
16808,2012-12-08,4,1,12,2,0,6,0,2,0.36,0.3485,0.93,0.1343,3,45,67,670,70,715
16809,2012-12-08,4,1,12,3,0,6,0,2,0.36,0.3636,0.93,0.1045,6,90,23,230,29,320
16810,2012-12-08,4,1,12,4,0,6,0,2,0.36,0.3788,0.93,0.0,3,45,9,90,12,135
16811,2012-12-08,4,1,12,5,0,6,0,2,0.36,0.3636,0.93,0.1045,2,30,4,40,6,70
16812,2012-12-08,4,1,12,6,0,6,0,2,0.36,0.3636,0.93,0.1045,1,15,19,190,20,205
16813,2012-12-08,4,1,12,7,0,6,0,2,0.36,0.3636,1.0,0.0896,3,45,36,360,39,405
16814,2012-12-08,4,1,12,8,0,6,0,2,0.38,0.3939,0.94,0.0896,5,75,106,1060,111,1135
16815,2012-12-08,4,1,12,9,0,6,0,2,0.38,0.3939,0.94,0.0,17,255,153,1530,170,1785
16816,2012-12-08,4,1,12,10,0,6,0,2,0.4,0.4091,0.87,0.1343,43,645,244,2440,287,3085
16817,2012-12-08,4,1,12,11,0,6,0,2,0.4,0.4091,0.87,0.1045,63,945,341,3410,404,4355
16818,2012-12-08,4,1,12,12,0,6,0,2,0.4,0.4091,0.87,0.2239,122,1830,364,3640,486,5470
16819,2012-12-08,4,1,12,13,0,6,0,2,0.4,0.4091,0.87,0.1642,148,2220,399,3990,547,6210
16820,2012-12-08,4,1,12,14,0,6,0,2,0.4,0.4091,0.87,0.2836,164,2460,378,3780,542,6240
16821,2012-12-08,4,1,12,15,0,6,0,1,0.42,0.4242,0.82,0.1642,167,2505,374,3740,541,6245
16822,2012-12-08,4,1,12,16,0,6,0,1,0.42,0.4242,0.82,0.1642,139,2085,368,3680,507,5765
16823,2012-12-08,4,1,12,17,0,6,0,1,0.38,0.3939,0.87,0.1343,77,1155,268,2680,345,3835
16824,2012-12-08,4,1,12,18,0,6,0,1,0.4,0.4091,0.87,0.1045,40,600,264,2640,304,3240
16825,2012-12-08,4,1,12,19,0,6,0,1,0.4,0.4091,0.87,0.0,34,510,212,2120,246,2630
16826,2012-12-08,4,1,12,20,0,6,0,2,0.36,0.3788,1.0,0.0,20,300,162,1620,182,1920
16827,2012-12-08,4,1,12,21,0,6,0,2,0.36,0.3788,1.0,0.0,34,510,175,1750,209,2260
16828,2012-12-08,4,1,12,22,0,6,0,2,0.38,0.3939,0.94,0.1045,23,345,137,1370,160,1715
16829,2012-12-08,4,1,12,23,0,6,0,2,0.4,0.4091,0.94,0.0,18,270,144,1440,162,1710
16830,2012-12-09,4,1,12,0,0,0,0,2,0.4,0.4091,0.87,0.1343,15,225,103,1030,118,1255
16831,2012-12-09,4,1,12,1,0,0,0,2,0.4,0.4091,0.87,0.1045,17,255,85,850,102,1105
16832,2012-12-09,4,1,12,2,0,0,0,2,0.4,0.4091,0.87,0.1045,8,120,70,700,78,820
16833,2012-12-09,4,1,12,3,0,0,0,2,0.4,0.4091,0.87,0.1045,14,210,34,340,48,550
16834,2012-12-09,4,1,12,4,0,0,0,2,0.4,0.4091,0.94,0.1045,1,15,11,110,12,125
16835,2012-12-09,4,1,12,5,0,0,0,2,0.4,0.4091,0.87,0.1045,0,0,8,80,8,80
16836,2012-12-09,4,1,12,6,0,0,0,3,0.4,0.4091,0.94,0.1045,0,0,6,60,6,60
16837,2012-12-09,4,1,12,7,0,0,0,3,0.4,0.4091,0.87,0.2239,1,15,22,220,23,235
16838,2012-12-09,4,1,12,8,0,0,0,3,0.4,0.4091,0.87,0.1642,1,15,68,680,69,695
16839,2012-12-09,4,1,12,9,0,0,0,2,0.4,0.4091,0.87,0.2537,9,135,94,940,103,1075
16840,2012-12-09,4,1,12,10,0,0,0,2,0.4,0.4091,0.87,0.2836,39,585,180,1800,219,2385
16841,2012-12-09,4,1,12,11,0,0,0,2,0.4,0.4091,0.87,0.2985,40,600,210,2100,250,2700
16842,2012-12-09,4,1,12,12,0,0,0,2,0.4,0.4091,0.82,0.2985,60,900,255,2550,315,3450
16843,2012-12-09,4,1,12,13,0,0,0,2,0.38,0.3939,0.87,0.2836,65,975,220,2200,285,3175
16844,2012-12-09,4,1,12,14,0,0,0,2,0.38,0.3939,0.87,0.194,42,630,190,1900,232,2530
16845,2012-12-09,4,1,12,15,0,0,0,3,0.36,0.3485,0.93,0.1642,25,375,200,2000,225,2375
16846,2012-12-09,4,1,12,16,0,0,0,3,0.36,0.3485,0.93,0.1642,33,495,220,2200,253,2695
16847,2012-12-09,4,1,12,17,0,0,0,3,0.36,0.3485,0.93,0.1343,20,300,209,2090,229,2390
16848,2012-12-09,4,1,12,18,0,0,0,3,0.36,0.3636,0.93,0.0896,17,255,181,1810,198,2065
16849,2012-12-09,4,1,12,19,0,0,0,3,0.38,0.3939,0.94,0.0896,12,180,110,1100,122,1280
16850,2012-12-09,4,1,12,20,0,0,0,3,0.36,0.3636,1.0,0.0896,6,90,102,1020,108,1110
16851,2012-12-09,4,1,12,21,0,0,0,2,0.36,0.3636,1.0,0.1045,10,150,86,860,96,1010
16852,2012-12-09,4,1,12,22,0,0,0,3,0.36,0.3636,0.93,0.1045,3,45,75,750,78,795
16853,2012-12-09,4,1,12,23,0,0,0,3,0.36,0.3636,1.0,0.0896,3,45,48,480,51,525
16854,2012-12-10,4,1,12,0,0,1,1,3,0.36,0.3636,1.0,0.0896,0,0,20,200,20,200
16855,2012-12-10,4,1,12,1,0,1,1,2,0.36,0.3788,1.0,0.0,0,0,4,40,4,40
16856,2012-12-10,4,1,12,2,0,1,1,2,0.38,0.3939,0.94,0.1045,2,30,3,30,5,60
16857,2012-12-10,4,1,12,3,0,1,1,2,0.38,0.3939,0.94,0.1045,0,0,4,40,4,40
16858,2012-12-10,4,1,12,4,0,1,1,2,0.38,0.3939,0.94,0.1045,3,45,9,90,12,135
16859,2012-12-10,4,1,12,5,0,1,1,2,0.38,0.3939,0.94,0.1045,0,0,27,270,27,270
16860,2012-12-10,4,1,12,6,0,1,1,2,0.38,0.3939,0.94,0.1642,2,30,121,1210,123,1240
16861,2012-12-10,4,1,12,7,0,1,1,2,0.38,0.3939,0.94,0.2537,3,45,291,2910,294,2955
16862,2012-12-10,4,1,12,8,0,1,1,2,0.42,0.4242,1.0,0.2537,9,135,575,5750,584,5885
16863,2012-12-10,4,1,12,9,0,1,1,2,0.42,0.4242,1.0,0.2239,11,165,273,2730,284,2895
16864,2012-12-10,4,1,12,10,0,1,1,2,0.44,0.4394,0.94,0.2239,12,180,121,1210,133,1390
16865,2012-12-10,4,1,12,11,0,1,1,3,0.46,0.4545,0.94,0.2239,8,120,126,1260,134,1380
16866,2012-12-10,4,1,12,12,0,1,1,3,0.44,0.4394,1.0,0.2239,23,345,150,1500,173,1845
16867,2012-12-10,4,1,12,13,0,1,1,3,0.44,0.4394,1.0,0.2239,30,450,190,1900,220,2350
16868,2012-12-10,4,1,12,14,0,1,1,2,0.5,0.4848,0.94,0.2239,31,465,179,1790,210,2255
16869,2012-12-10,4,1,12,15,0,1,1,2,0.5,0.4848,0.87,0.1642,29,435,207,2070,236,2505
16870,2012-12-10,4,1,12,16,0,1,1,2,0.5,0.4848,0.88,0.1045,37,555,308,3080,345,3635
16871,2012-12-10,4,1,12,17,0,1,1,2,0.48,0.4697,0.82,0.2836,38,570,578,5780,616,6350
16872,2012-12-10,4,1,12,18,0,1,1,2,0.46,0.4545,0.88,0.2836,20,300,544,5440,564,5740
16873,2012-12-10,4,1,12,19,0,1,1,1,0.52,0.5,0.77,0.2836,18,270,409,4090,427,4360
16874,2012-12-10,4,1,12,20,0,1,1,1,0.46,0.4545,0.88,0.2537,13,195,287,2870,300,3065
16875,2012-12-10,4,1,12,21,0,1,1,2,0.46,0.4545,0.94,0.194,21,315,224,2240,245,2555
16876,2012-12-10,4,1,12,22,0,1,1,2,0.5,0.4848,0.82,0.2239,11,165,115,1150,126,1315
16877,2012-12-10,4,1,12,23,0,1,1,1,0.46,0.4545,0.88,0.2537,8,120,76,760,84,880
16878,2012-12-11,4,1,12,0,0,2,1,3,0.46,0.4545,0.77,0.4627,2,30,29,290,31,320
16879,2012-12-11,4,1,12,1,0,2,1,1,0.42,0.4242,0.71,0.4478,1,15,7,70,8,85
16880,2012-12-11,4,1,12,2,0,2,1,2,0.4,0.4091,0.66,0.3284,0,0,1,10,1,10
16881,2012-12-11,4,1,12,3,0,2,1,3,0.36,0.3333,0.76,0.2836,0,0,3,30,3,30
16882,2012-12-11,4,1,12,4,0,2,1,2,0.34,0.3182,0.76,0.2836,0,0,8,80,8,80
16883,2012-12-11,4,1,12,5,0,2,1,3,0.34,0.303,0.71,0.3284,1,15,40,400,41,415
16884,2012-12-11,4,1,12,6,0,2,1,2,0.34,0.303,0.71,0.2985,0,0,118,1180,118,1180
16885,2012-12-11,4,1,12,7,0,2,1,1,0.34,0.303,0.66,0.4179,8,120,372,3720,380,3840
16886,2012-12-11,4,1,12,8,0,2,1,2,0.34,0.303,0.61,0.2985,16,240,708,7080,724,7320
16887,2012-12-11,4,1,12,9,0,2,1,1,0.34,0.303,0.61,0.3881,12,180,322,3220,334,3400
16888,2012-12-11,4,1,12,10,0,2,1,1,0.36,0.3333,0.57,0.3284,12,180,142,1420,154,1600
16889,2012-12-11,4,1,12,11,0,2,1,2,0.36,0.3333,0.53,0.3582,28,420,145,1450,173,1870
16890,2012-12-11,4,1,12,12,0,2,1,2,0.36,0.3182,0.53,0.4478,13,195,213,2130,226,2325
16891,2012-12-11,4,1,12,13,0,2,1,2,0.38,0.3939,0.5,0.2239,28,420,226,2260,254,2680
16892,2012-12-11,4,1,12,14,0,2,1,2,0.38,0.3939,0.5,0.2239,19,285,185,1850,204,2135
16893,2012-12-11,4,1,12,15,0,2,1,2,0.38,0.3939,0.5,0.2239,20,300,250,2500,270,2800
16894,2012-12-11,4,1,12,16,0,2,1,2,0.38,0.3939,0.5,0.2239,24,360,334,3340,358,3700
16895,2012-12-11,4,1,12,17,0,2,1,1,0.32,0.303,0.53,0.2239,21,315,580,5800,601,6115
16896,2012-12-11,4,1,12,18,0,2,1,1,0.32,0.303,0.53,0.2239,23,345,523,5230,546,5575
16897,2012-12-11,4,1,12,19,0,2,1,1,0.32,0.303,0.53,0.2239,21,315,412,4120,433,4435
16898,2012-12-11,4,1,12,20,0,2,1,1,0.32,0.303,0.53,0.2239,9,135,248,2480,257,2615
16899,2012-12-11,4,1,12,21,0,2,1,1,0.32,0.3182,0.53,0.194,14,210,193,1930,207,2140
16900,2012-12-11,4,1,12,22,0,2,1,1,0.3,0.2879,0.56,0.2239,6,90,100,1000,106,1090
16901,2012-12-11,4,1,12,23,0,2,1,1,0.3,0.2879,0.52,0.2239,4,60,60,600,64,660
16902,2012-12-12,4,1,12,0,0,3,1,1,0.3,0.303,0.52,0.1642,1,15,33,330,34,345
16903,2012-12-12,4,1,12,1,0,3,1,1,0.28,0.2727,0.61,0.2239,3,45,18,180,21,225
16904,2012-12-12,4,1,12,2,0,3,1,1,0.28,0.2727,0.56,0.1642,5,75,4,40,9,115
16905,2012-12-12,4,1,12,3,0,3,1,1,0.26,0.2727,0.6,0.1343,3,45,7,70,10,115
16906,2012-12-12,4,1,12,4,0,3,1,1,0.26,0.303,0.6,0.0,0,0,4,40,4,40
16907,2012-12-12,4,1,12,5,0,3,1,1,0.26,0.2576,0.6,0.194,0,0,37,370,37,370
16908,2012-12-12,4,1,12,6,0,3,1,2,0.26,0.2424,0.6,0.2537,2,30,126,1260,128,1290
16909,2012-12-12,4,1,12,7,0,3,1,2,0.26,0.2576,0.6,0.194,3,45,366,3660,369,3705
16910,2012-12-12,4,1,12,8,0,3,1,2,0.26,0.2576,0.65,0.1642,18,270,670,6700,688,6970
16911,2012-12-12,4,1,12,9,0,3,1,2,0.28,0.2879,0.61,0.1343,13,195,272,2720,285,2915
16912,2012-12-12,4,1,12,10,0,3,1,2,0.3,0.303,0.56,0.1642,20,300,116,1160,136,1460
16913,2012-12-12,4,1,12,11,0,3,1,2,0.32,0.303,0.49,0.2239,24,360,148,1480,172,1840
16914,2012-12-12,4,1,12,12,0,3,1,2,0.34,0.3636,0.42,0.0,14,210,218,2180,232,2390
16915,2012-12-12,4,1,12,13,0,3,1,2,0.34,0.3636,0.42,0.0,18,270,220,2200,238,2470
16916,2012-12-12,4,1,12,14,0,3,1,2,0.34,0.3636,0.46,0.0,34,510,191,1910,225,2420
16917,2012-12-12,4,1,12,15,0,3,1,2,0.34,0.3485,0.46,0.1045,21,315,207,2070,228,2385
16918,2012-12-12,4,1,12,16,0,3,1,2,0.34,0.3333,0.46,0.1343,19,285,310,3100,329,3385
16919,2012-12-12,4,1,12,17,0,3,1,2,0.32,0.303,0.53,0.2239,21,315,540,5400,561,5715
16920,2012-12-12,4,1,12,18,0,3,1,2,0.32,0.303,0.49,0.2239,25,375,515,5150,540,5525
16921,2012-12-12,4,1,12,19,0,3,1,2,0.3,0.2879,0.56,0.2239,18,270,384,3840,402,4110
16922,2012-12-12,4,1,12,20,0,3,1,1,0.3,0.2879,0.52,0.2836,25,375,243,2430,268,2805
16923,2012-12-12,4,1,12,21,0,3,1,2,0.3,0.2879,0.52,0.2537,16,240,186,1860,202,2100
16924,2012-12-12,4,1,12,22,0,3,1,2,0.3,0.2879,0.52,0.2239,4,60,118,1180,122,1240
16925,2012-12-12,4,1,12,23,0,3,1,2,0.28,0.2727,0.56,0.2239,3,45,76,760,79,805
16926,2012-12-13,4,1,12,0,0,4,1,2,0.28,0.2727,0.52,0.2239,1,15,31,310,32,325
16927,2012-12-13,4,1,12,1,0,4,1,2,0.28,0.2576,0.52,0.2836,4,60,19,190,23,250
16928,2012-12-13,4,1,12,2,0,4,1,2,0.26,0.2424,0.56,0.2537,3,45,5,50,8,95
16929,2012-12-13,4,1,12,3,0,4,1,2,0.26,0.2424,0.56,0.2836,0,0,2,20,2,20
16930,2012-12-13,4,1,12,4,0,4,1,2,0.26,0.2576,0.56,0.194,0,0,8,80,8,80
16931,2012-12-13,4,1,12,5,0,4,1,2,0.26,0.2576,0.56,0.1642,2,30,31,310,33,340
16932,2012-12-13,4,1,12,6,0,4,1,1,0.26,0.2424,0.56,0.2537,2,30,112,1120,114,1150
16933,2012-12-13,4,1,12,7,0,4,1,1,0.24,0.2273,0.6,0.2239,5,75,380,3800,385,3875
16934,2012-12-13,4,1,12,8,0,4,1,1,0.24,0.2273,0.6,0.194,24,360,655,6550,679,6910
16935,2012-12-13,4,1,12,9,0,4,1,1,0.28,0.2727,0.52,0.2537,25,375,300,3000,325,3375
16936,2012-12-13,4,1,12,10,0,4,1,1,0.32,0.303,0.45,0.2836,28,420,139,1390,167,1810
16937,2012-12-13,4,1,12,11,0,4,1,1,0.34,0.3182,0.42,0.2537,25,375,164,1640,189,2015
16938,2012-12-13,4,1,12,12,0,4,1,1,0.36,0.3333,0.4,0.2537,30,450,252,2520,282,2970
16939,2012-12-13,4,1,12,13,0,4,1,1,0.36,0.3485,0.34,0.194,41,615,230,2300,271,2915
16940,2012-12-13,4,1,12,14,0,4,1,1,0.36,0.3485,0.34,0.1642,31,465,211,2110,242,2575
16941,2012-12-13,4,1,12,15,0,4,1,1,0.36,0.3485,0.34,0.1343,40,600,240,2400,280,3000
16942,2012-12-13,4,1,12,16,0,4,1,1,0.34,0.3485,0.39,0.1045,50,750,356,3560,406,4310
16943,2012-12-13,4,1,12,17,0,4,1,1,0.32,0.3333,0.42,0.1045,43,645,507,5070,550,5715
16944,2012-12-13,4,1,12,18,0,4,1,1,0.32,0.3333,0.42,0.1045,20,300,446,4460,466,4760
16945,2012-12-13,4,1,12,19,0,4,1,1,0.3,0.303,0.45,0.1642,20,300,328,3280,348,3580
16946,2012-12-13,4,1,12,20,0,4,1,1,0.3,0.3333,0.45,0.0,6,90,235,2350,241,2440
16947,2012-12-13,4,1,12,21,0,4,1,1,0.28,0.3182,0.48,0.0,13,195,200,2000,213,2195
16948,2012-12-13,4,1,12,22,0,4,1,1,0.26,0.2879,0.6,0.0896,7,105,141,1410,148,1515
16949,2012-12-13,4,1,12,23,0,4,1,1,0.26,0.303,0.6,0.0,5,75,115,1150,120,1225
16950,2012-12-14,4,1,12,0,0,5,1,1,0.22,0.2576,0.64,0.0896,4,60,43,430,47,490
16951,2012-12-14,4,1,12,1,0,5,1,1,0.22,0.2576,0.69,0.0896,0,0,26,260,26,260
16952,2012-12-14,4,1,12,2,0,5,1,1,0.22,0.2727,0.69,0.0,3,45,6,60,9,105
16953,2012-12-14,4,1,12,3,0,5,1,1,0.2,0.2273,0.69,0.1045,0,0,12,120,12,120
16954,2012-12-14,4,1,12,4,0,5,1,1,0.2,0.2273,0.75,0.0896,1,15,9,90,10,105
16955,2012-12-14,4,1,12,5,0,5,1,1,0.2,0.2273,0.69,0.1045,0,0,34,340,34,340
16956,2012-12-14,4,1,12,6,0,5,1,1,0.16,0.1818,0.8,0.1045,1,15,112,1120,113,1135
16957,2012-12-14,4,1,12,7,0,5,1,1,0.2,0.2121,0.72,0.1045,3,45,305,3050,308,3095
16958,2012-12-14,4,1,12,8,0,5,1,1,0.2,0.2273,0.69,0.0896,13,195,623,6230,636,6425
16959,2012-12-14,4,1,12,9,0,5,1,1,0.24,0.2424,0.75,0.1343,13,195,330,3300,343,3495
16960,2012-12-14,4,1,12,10,0,5,1,1,0.26,0.2576,0.81,0.194,28,420,162,1620,190,2040
16961,2012-12-14,4,1,12,11,0,5,1,1,0.32,0.303,0.65,0.194,31,465,180,1800,211,2265
16962,2012-12-14,4,1,12,12,0,5,1,1,0.36,0.3485,0.5,0.194,29,435,244,2440,273,2875
16963,2012-12-14,4,1,12,13,0,5,1,1,0.36,0.3485,0.5,0.2239,39,585,274,2740,313,3325
16964,2012-12-14,4,1,12,14,0,5,1,1,0.4,0.4091,0.43,0.194,48,720,251,2510,299,3230
16965,2012-12-14,4,1,12,15,0,5,1,1,0.4,0.4091,0.47,0.1642,57,855,252,2520,309,3375
16966,2012-12-14,4,1,12,16,0,5,1,1,0.38,0.3939,0.54,0.194,45,675,372,3720,417,4395
16967,2012-12-14,4,1,12,17,0,5,1,1,0.34,0.3333,0.57,0.1642,40,600,582,5820,622,6420
16968,2012-12-14,4,1,12,18,0,5,1,1,0.36,0.3485,0.46,0.1343,23,345,432,4320,455,4665
16969,2012-12-14,4,1,12,19,0,5,1,1,0.34,0.3485,0.53,0.0896,17,255,302,3020,319,3275
16970,2012-12-14,4,1,12,20,0,5,1,1,0.32,0.3333,0.61,0.1343,12,180,209,2090,221,2270
16971,2012-12-14,4,1,12,21,0,5,1,1,0.3,0.303,0.75,0.1642,7,105,165,1650,172,1755
16972,2012-12-14,4,1,12,22,0,5,1,1,0.28,0.2879,0.75,0.1045,4,60,134,1340,138,1400
16973,2012-12-14,4,1,12,23,0,5,1,1,0.28,0.303,0.75,0.0896,11,165,123,1230,134,1395
16974,2012-12-15,4,1,12,0,0,6,0,1,0.3,0.3333,0.7,0.0,4,60,90,900,94,960
16975,2012-12-15,4,1,12,1,0,6,0,2,0.26,0.2879,0.81,0.0896,9,135,86,860,95,995
16976,2012-12-15,4,1,12,2,0,6,0,1,0.26,0.303,0.81,0.0,6,90,63,630,69,720
16977,2012-12-15,4,1,12,3,0,6,0,2,0.24,0.2879,0.81,0.0,5,75,18,180,23,255
16978,2012-12-15,4,1,12,4,0,6,0,2,0.24,0.2576,0.87,0.1045,1,15,5,50,6,65
16979,2012-12-15,4,1,12,5,0,6,0,2,0.26,0.303,0.75,0.0,0,0,3,30,3,30
16980,2012-12-15,4,1,12,6,0,6,0,2,0.24,0.2879,0.75,0.0,0,0,11,110,11,110
16981,2012-12-15,4,1,12,7,0,6,0,2,0.24,0.2576,0.75,0.0896,1,15,47,470,48,485
16982,2012-12-15,4,1,12,8,0,6,0,2,0.26,0.2879,0.75,0.0896,8,120,111,1110,119,1230
16983,2012-12-15,4,1,12,9,0,6,0,1,0.26,0.2727,0.75,0.1045,17,255,203,2030,220,2285
16984,2012-12-15,4,1,12,10,0,6,0,1,0.32,0.3182,0.61,0.1642,23,345,250,2500,273,2845
16985,2012-12-15,4,1,12,11,0,6,0,1,0.34,0.3485,0.61,0.0896,66,990,327,3270,393,4260
16986,2012-12-15,4,1,12,12,0,6,0,1,0.38,0.3939,0.5,0.0896,89,1335,364,3640,453,4975
16987,2012-12-15,4,1,12,13,0,6,0,1,0.38,0.3939,0.54,0.2537,88,1320,368,3680,456,5000
16988,2012-12-15,4,1,12,14,0,6,0,1,0.4,0.4091,0.5,0.1642,92,1380,334,3340,426,4720
16989,2012-12-15,4,1,12,15,0,6,0,1,0.42,0.4242,0.47,0.0,95,1425,352,3520,447,4945
16990,2012-12-15,4,1,12,16,0,6,0,1,0.4,0.4091,0.5,0.1343,85,1275,328,3280,413,4555
16991,2012-12-15,4,1,12,17,0,6,0,1,0.4,0.4091,0.5,0.2239,35,525,274,2740,309,3265
16992,2012-12-15,4,1,12,18,0,6,0,1,0.38,0.3939,0.58,0.1642,40,600,232,2320,272,2920
16993,2012-12-15,4,1,12,19,0,6,0,1,0.36,0.3485,0.62,0.1343,32,480,225,2250,257,2730
16994,2012-12-15,4,1,12,20,0,6,0,2,0.36,0.3485,0.57,0.194,23,345,178,1780,201,2125
16995,2012-12-15,4,1,12,21,0,6,0,1,0.36,0.3485,0.62,0.1343,15,225,169,1690,184,1915
16996,2012-12-15,4,1,12,22,0,6,0,1,0.36,0.3485,0.62,0.194,22,330,134,1340,156,1670
16997,2012-12-15,4,1,12,23,0,6,0,2,0.36,0.3485,0.62,0.1343,11,165,108,1080,119,1245
16998,2012-12-16,4,1,12,0,0,0,0,2,0.36,0.3788,0.62,0.0,8,120,102,1020,110,1140
16999,2012-12-16,4,1,12,1,0,0,0,3,0.34,0.3485,0.76,0.1045,14,210,82,820,96,1030
17000,2012-12-16,4,1,12,2,0,0,0,2,0.34,0.3485,0.87,0.0896,8,120,79,790,87,910
17001,2012-12-16,4,1,12,3,0,0,0,2,0.34,0.3333,0.87,0.194,1,15,37,370,38,385
17002,2012-12-16,4,1,12,4,0,0,0,2,0.34,0.3636,0.87,0.0,1,15,10,100,11,115
17003,2012-12-16,4,1,12,5,0,0,0,2,0.34,0.3636,0.87,0.0,0,0,9,90,9,90
17004,2012-12-16,4,1,12,6,0,0,0,2,0.34,0.3636,0.87,0.0,0,0,6,60,6,60
17005,2012-12-16,4,1,12,7,0,0,0,2,0.34,0.3485,0.87,0.0896,5,75,22,220,27,295
17006,2012-12-16,4,1,12,8,0,0,0,2,0.36,0.3485,0.87,0.1343,12,180,76,760,88,940
17007,2012-12-16,4,1,12,9,0,0,0,2,0.36,0.3485,0.87,0.1343,19,285,113,1130,132,1415
17008,2012-12-16,4,1,12,10,0,0,0,2,0.36,0.3485,0.87,0.1343,42,630,215,2150,257,2780
17009,2012-12-16,4,1,12,11,0,0,0,2,0.36,0.3485,0.87,0.1343,47,705,248,2480,295,3185
17010,2012-12-16,4,1,12,12,0,0,0,2,0.38,0.3939,0.82,0.194,67,1005,350,3500,417,4505
17011,2012-12-16,4,1,12,13,0,0,0,2,0.38,0.3939,0.76,0.194,67,1005,289,2890,356,3895
17012,2012-12-16,4,1,12,14,0,0,0,2,0.38,0.3939,0.76,0.1343,50,750,260,2600,310,3350
17013,2012-12-16,4,1,12,15,0,0,0,2,0.38,0.3939,0.82,0.1045,46,690,292,2920,338,3610
17014,2012-12-16,4,1,12,16,0,0,0,2,0.38,0.3939,0.82,0.1045,66,990,334,3340,400,4330
17015,2012-12-16,4,1,12,17,0,0,0,2,0.38,0.3939,0.82,0.1045,29,435,214,2140,243,2575
17016,2012-12-16,4,1,12,18,0,0,0,3,0.38,0.3939,0.82,0.1045,8,120,99,990,107,1110
17017,2012-12-16,4,1,12,19,0,0,0,1,0.36,0.3485,0.93,0.1343,10,150,99,990,109,1140
17018,2012-12-16,4,1,12,20,0,0,0,2,0.38,0.3939,0.82,0.0,14,210,108,1080,122,1290
17019,2012-12-16,4,1,12,21,0,0,0,2,0.36,0.3788,0.93,0.0,14,210,92,920,106,1130
17020,2012-12-16,4,1,12,22,0,0,0,2,0.4,0.4091,0.82,0.194,6,90,83,830,89,920
17021,2012-12-16,4,1,12,23,0,0,0,2,0.36,0.3485,0.93,0.1343,4,60,29,290,33,350
17022,2012-12-17,4,1,12,0,0,1,1,2,0.38,0.3939,0.87,0.0,2,30,26,260,28,290
17023,2012-12-17,4,1,12,1,0,1,1,2,0.38,0.3939,0.87,0.1045,1,15,14,140,15,155
17024,2012-12-17,4,1,12,2,0,1,1,2,0.38,0.3939,0.94,0.0,1,15,4,40,5,55
17025,2012-12-17,4,1,12,3,0,1,1,2,0.36,0.3788,0.93,0.0,0,0,3,30,3,30
17026,2012-12-17,4,1,12,4,0,1,1,3,0.36,0.3788,1.0,0.0,2,30,3,30,5,60
17027,2012-12-17,4,1,12,5,0,1,1,2,0.38,0.3939,0.87,0.0,0,0,24,240,24,240
17028,2012-12-17,4,1,12,6,0,1,1,2,0.36,0.3485,0.93,0.1343,1,15,107,1070,108,1085
17029,2012-12-17,4,1,12,7,0,1,1,2,0.36,0.3485,0.93,0.1343,5,75,314,3140,319,3215
17030,2012-12-17,4,1,12,8,0,1,1,2,0.38,0.3939,0.87,0.1045,10,150,582,5820,592,5970
17031,2012-12-17,4,1,12,9,0,1,1,2,0.4,0.4091,0.87,0.0,11,165,271,2710,282,2875
17032,2012-12-17,4,1,12,10,0,1,1,2,0.38,0.3939,0.87,0.0896,15,225,120,1200,135,1425
17033,2012-12-17,4,1,12,11,0,1,1,2,0.4,0.4091,0.87,0.0896,22,330,148,1480,170,1810
17034,2012-12-17,4,1,12,12,0,1,1,2,0.4,0.4091,0.87,0.0,21,315,211,2110,232,2425
17035,2012-12-17,4,1,12,13,0,1,1,2,0.4,0.4091,0.87,0.1343,16,240,194,1940,210,2180
17036,2012-12-17,4,1,12,14,0,1,1,2,0.4,0.4091,0.87,0.0896,12,180,169,1690,181,1870
17037,2012-12-17,4,1,12,15,0,1,1,2,0.42,0.4242,0.88,0.0,15,225,196,1960,211,2185
17038,2012-12-17,4,1,12,16,0,1,1,3,0.4,0.4091,0.94,0.2537,15,225,287,2870,302,3095
17039,2012-12-17,4,1,12,17,0,1,1,2,0.4,0.4091,0.94,0.2537,17,255,478,4780,495,5035
17040,2012-12-17,4,1,12,18,0,1,1,2,0.4,0.4091,0.94,0.0896,14,210,493,4930,507,5140
17041,2012-12-17,4,1,12,19,0,1,1,2,0.42,0.4242,0.88,0.1343,7,105,333,3330,340,3435
17042,2012-12-17,4,1,12,20,0,1,1,2,0.42,0.4242,0.94,0.2537,8,120,192,1920,200,2040
17043,2012-12-17,4,1,12,21,0,1,1,2,0.42,0.4242,0.94,0.1343,6,90,114,1140,120,1230
17044,2012-12-17,4,1,12,22,0,1,1,2,0.42,0.4242,0.94,0.1343,5,75,49,490,54,565
17045,2012-12-17,4,1,12,23,0,1,1,3,0.42,0.4242,0.94,0.2239,6,90,41,410,47,500
17046,2012-12-18,4,1,12,0,0,2,1,2,0.44,0.4394,0.94,0.1343,0,0,18,180,18,180
17047,2012-12-18,4,1,12,1,0,2,1,2,0.44,0.4394,0.94,0.1343,0,0,15,150,15,150
17048,2012-12-18,4,1,12,2,0,2,1,2,0.44,0.4394,0.88,0.2239,2,30,5,50,7,80
17049,2012-12-18,4,1,12,3,0,2,1,1,0.42,0.4242,0.88,0.194,0,0,5,50,5,50
17050,2012-12-18,4,1,12,4,0,2,1,1,0.42,0.4242,0.82,0.1642,3,45,5,50,8,95
17051,2012-12-18,4,1,12,5,0,2,1,1,0.38,0.3939,0.87,0.0896,0,0,36,360,36,360
17052,2012-12-18,4,1,12,6,0,2,1,1,0.36,0.3485,0.93,0.1642,1,15,117,1170,118,1185
17053,2012-12-18,4,1,12,7,0,2,1,1,0.36,0.3485,0.93,0.1343,4,60,351,3510,355,3570
17054,2012-12-18,4,1,12,8,0,2,1,1,0.38,0.3939,0.94,0.0,10,150,652,6520,662,6670
17055,2012-12-18,4,1,12,9,0,2,1,1,0.4,0.4091,0.87,0.0896,19,285,307,3070,326,3355
17056,2012-12-18,4,1,12,10,0,2,1,1,0.44,0.4394,0.77,0.0896,22,330,162,1620,184,1950
17057,2012-12-18,4,1,12,11,0,2,1,1,0.48,0.4697,0.63,0.2239,58,870,211,2110,269,2980
17058,2012-12-18,4,1,12,12,0,2,1,3,0.48,0.4697,0.48,0.2537,49,735,264,2640,313,3375
17059,2012-12-18,4,1,12,13,0,2,1,1,0.5,0.4848,0.42,0.2836,51,765,235,2350,286,3115
17060,2012-12-18,4,1,12,14,0,2,1,1,0.46,0.4545,0.47,0.4478,56,840,191,1910,247,2750
17061,2012-12-18,4,1,12,15,0,2,1,1,0.46,0.4545,0.44,0.4925,28,420,218,2180,246,2600
17062,2012-12-18,4,1,12,16,0,2,1,1,0.44,0.4394,0.41,0.4627,40,600,323,3230,363,3830
17063,2012-12-18,4,1,12,17,0,2,1,1,0.4,0.4091,0.47,0.4478,39,585,533,5330,572,5915
17064,2012-12-18,4,1,12,18,0,2,1,1,0.38,0.3939,0.46,0.3284,13,195,512,5120,525,5315
17065,2012-12-18,4,1,12,19,0,2,1,1,0.38,0.3939,0.46,0.3881,19,285,334,3340,353,3625
17066,2012-12-18,4,1,12,20,0,2,1,1,0.36,0.3333,0.5,0.2537,4,60,264,2640,268,2700
17067,2012-12-18,4,1,12,21,0,2,1,1,0.36,0.3485,0.5,0.2239,9,135,159,1590,168,1725
17068,2012-12-18,4,1,12,22,0,2,1,1,0.34,0.3333,0.49,0.0,5,75,127,1270,132,1345
17069,2012-12-18,4,1,12,23,0,2,1,1,0.34,0.3485,0.49,0.0896,1,15,80,800,81,815
17070,2012-12-19,4,1,12,0,0,3,1,1,0.3,0.3182,0.61,0.0,6,90,35,350,41,440
17071,2012-12-19,4,1,12,1,0,3,1,1,0.3,0.3182,0.65,0.0896,1,15,14,140,15,155
17072,2012-12-19,4,1,12,2,0,3,1,1,0.28,0.303,0.65,0.0896,1,15,2,20,3,35
17073,2012-12-19,4,1,12,3,0,3,1,1,0.26,0.2727,0.75,0.1343,0,0,5,50,5,50
17074,2012-12-19,4,1,12,4,0,3,1,1,0.24,0.2424,0.75,0.1343,1,15,6,60,7,75
17075,2012-12-19,4,1,12,5,0,3,1,1,0.26,0.2879,0.75,0.0896,2,30,29,290,31,320
17076,2012-12-19,4,1,12,6,0,3,1,1,0.24,0.2576,0.75,0.0896,3,45,109,1090,112,1135
17077,2012-12-19,4,1,12,7,0,3,1,1,0.26,0.2727,0.75,0.1343,3,45,360,3600,363,3645
17078,2012-12-19,4,1,12,8,0,3,1,1,0.24,0.2576,0.87,0.1045,13,195,665,6650,678,6845
17079,2012-12-19,4,1,12,9,0,3,1,1,0.28,0.2879,0.75,0.1045,8,120,309,3090,317,3210
17080,2012-12-19,4,1,12,10,0,3,1,1,0.32,0.3333,0.7,0.1045,17,255,147,1470,164,1725
17081,2012-12-19,4,1,12,11,0,3,1,1,0.4,0.4091,0.54,0.2239,31,465,169,1690,200,2155
17082,2012-12-19,4,1,12,12,0,3,1,1,0.4,0.4091,0.54,0.2836,33,495,203,2030,236,2525
17083,2012-12-19,4,1,12,13,0,3,1,1,0.42,0.4242,0.5,0.194,30,450,183,1830,213,2280
17084,2012-12-19,4,1,12,14,0,3,1,1,0.42,0.4242,0.5,0.194,33,495,185,1850,218,2345
17085,2012-12-19,4,1,12,15,0,3,1,1,0.42,0.4242,0.5,0.2836,28,420,209,2090,237,2510
17086,2012-12-19,4,1,12,16,0,3,1,1,0.42,0.4242,0.5,0.3582,37,555,297,2970,334,3525
17087,2012-12-19,4,1,12,17,0,3,1,1,0.4,0.4091,0.5,0.3881,26,390,536,5360,562,5750
17088,2012-12-19,4,1,12,18,0,3,1,1,0.38,0.3939,0.5,0.3582,23,345,546,5460,569,5805
17089,2012-12-19,4,1,12,19,0,3,1,1,0.38,0.3939,0.5,0.3881,7,105,329,3290,336,3395
17090,2012-12-19,4,1,12,20,0,3,1,1,0.36,0.3485,0.57,0.2239,10,150,231,2310,241,2460
17091,2012-12-19,4,1,12,21,0,3,1,1,0.34,0.3182,0.61,0.2239,4,60,164,1640,168,1700
17092,2012-12-19,4,1,12,22,0,3,1,1,0.34,0.3485,0.61,0.0896,12,180,117,1170,129,1350
17093,2012-12-19,4,1,12,23,0,3,1,1,0.32,0.3333,0.66,0.1343,4,60,84,840,88,900
17094,2012-12-20,4,1,12,0,0,4,1,1,0.32,0.3333,0.61,0.1343,2,30,40,400,42,430
17095,2012-12-20,4,1,12,1,0,4,1,1,0.32,0.3485,0.66,0.0,1,15,19,190,20,205
17096,2012-12-20,4,1,12,2,0,4,1,1,0.32,0.3485,0.66,0.0,2,30,6,60,8,90
17097,2012-12-20,4,1,12,3,0,4,1,2,0.3,0.3182,0.7,0.0896,1,15,3,30,4,45
17098,2012-12-20,4,1,12,4,0,4,1,2,0.3,0.3182,0.7,0.0896,0,0,6,60,6,60
17099,2012-12-20,4,1,12,5,0,4,1,2,0.3,0.3182,0.7,0.1045,0,0,35,350,35,350
17100,2012-12-20,4,1,12,6,0,4,1,2,0.3,0.3333,0.65,0.0,4,60,114,1140,118,1200
17101,2012-12-20,4,1,12,7,0,4,1,2,0.3,0.3333,0.7,0.0,4,60,346,3460,350,3520
17102,2012-12-20,4,1,12,8,0,4,1,2,0.3,0.3333,0.7,0.0,14,210,585,5850,599,6060
17103,2012-12-20,4,1,12,9,0,4,1,2,0.3,0.3333,0.7,0.0,14,210,303,3030,317,3240
17104,2012-12-20,4,1,12,10,0,4,1,2,0.32,0.3333,0.66,0.0,23,345,138,1380,161,1725
17105,2012-12-20,4,1,12,11,0,4,1,2,0.34,0.3182,0.57,0.2239,22,330,168,1680,190,2010
17106,2012-12-20,4,1,12,12,0,4,1,2,0.36,0.3485,0.53,0.1642,31,465,181,1810,212,2275
17107,2012-12-20,4,1,12,13,0,4,1,2,0.36,0.3485,0.57,0.194,46,690,171,1710,217,2400
17108,2012-12-20,4,1,12,14,0,4,1,2,0.36,0.3485,0.53,0.194,43,645,171,1710,214,2355
17109,2012-12-20,4,1,12,15,0,4,1,2,0.34,0.3333,0.57,0.194,33,495,216,2160,249,2655
17110,2012-12-20,4,1,12,16,0,4,1,2,0.34,0.303,0.53,0.3284,21,315,281,2810,302,3125
17111,2012-12-20,4,1,12,17,0,4,1,2,0.34,0.3333,0.66,0.194,25,375,450,4500,475,4875
17112,2012-12-20,4,1,12,18,0,4,1,2,0.34,0.3333,0.71,0.194,22,330,359,3590,381,3920
17113,2012-12-20,4,1,12,19,0,4,1,3,0.34,0.3182,0.71,0.2537,3,45,115,1150,118,1195
17114,2012-12-20,4,1,12,20,0,4,1,3,0.34,0.3333,0.76,0.1642,1,15,49,490,50,505
17115,2012-12-20,4,1,12,21,0,4,1,3,0.34,0.3333,0.76,0.1642,1,15,25,250,26,265
17116,2012-12-20,4,1,12,22,0,4,1,3,0.34,0.3333,0.87,0.194,1,15,20,200,21,215
17117,2012-12-20,4,1,12,23,0,4,1,3,0.4,0.4091,0.82,0.2985,0,0,13,130,13,130
17118,2012-12-21,1,1,12,0,0,5,1,3,0.42,0.4242,0.88,0.2985,0,0,17,170,17,170
17119,2012-12-21,1,1,12,1,0,5,1,3,0.44,0.4394,0.88,0.3881,2,30,7,70,9,100
17120,2012-12-21,1,1,12,2,0,5,1,3,0.46,0.4545,0.94,0.3881,0,0,3,30,3,30
17121,2012-12-21,1,1,12,3,0,5,1,3,0.46,0.4545,0.94,0.3881,0,0,3,30,3,30
17122,2012-12-21,1,1,12,4,0,5,1,2,0.36,0.3182,0.71,0.4925,1,15,5,50,6,65
17123,2012-12-21,1,1,12,5,0,5,1,2,0.34,0.303,0.76,0.4179,0,0,13,130,13,130
17124,2012-12-21,1,1,12,6,0,5,1,2,0.34,0.2879,0.57,0.5821,4,60,76,760,80,820
17125,2012-12-21,1,1,12,7,0,5,1,2,0.32,0.3182,0.57,0.194,3,45,205,2050,208,2095
17126,2012-12-21,1,1,12,8,0,5,1,2,0.32,0.303,0.57,0.2836,8,120,464,4640,472,4760
17127,2012-12-21,1,1,12,9,0,5,1,2,0.32,0.2727,0.45,0.5522,2,30,265,2650,267,2680
17128,2012-12-21,1,1,12,10,0,5,1,1,0.32,0.2879,0.42,0.4627,8,120,146,1460,154,1580
17129,2012-12-21,1,1,12,11,0,5,1,2,0.32,0.2879,0.42,0.4179,12,180,150,1500,162,1680
17130,2012-12-21,1,1,12,12,0,5,1,2,0.32,0.2879,0.39,0.3582,25,375,199,1990,224,2365
17131,2012-12-21,1,1,12,13,0,5,1,2,0.32,0.2879,0.39,0.4179,26,390,214,2140,240,2530
17132,2012-12-21,1,1,12,14,0,5,1,2,0.32,0.2879,0.39,0.4478,20,300,199,1990,219,2290
17133,2012-12-21,1,1,12,15,0,5,1,2,0.3,0.2727,0.42,0.3881,29,435,234,2340,263,2775
17134,2012-12-21,1,1,12,16,0,5,1,2,0.3,0.2727,0.39,0.3284,28,420,253,2530,281,2950
17135,2012-12-21,1,1,12,17,0,5,1,2,0.26,0.2273,0.56,0.3284,24,360,297,2970,321,3330
17136,2012-12-21,1,1,12,18,0,5,1,2,0.26,0.2273,0.56,0.2985,7,105,236,2360,243,2465
17137,2012-12-21,1,1,12,19,0,5,1,1,0.28,0.2576,0.45,0.2985,5,75,148,1480,153,1555
17138,2012-12-21,1,1,12,20,0,5,1,1,0.28,0.2727,0.41,0.2537,8,120,104,1040,112,1160
17139,2012-12-21,1,1,12,21,0,5,1,1,0.26,0.2273,0.41,0.4179,2,30,68,680,70,710
17140,2012-12-21,1,1,12,22,0,5,1,1,0.26,0.2273,0.44,0.2985,6,90,57,570,63,660
17141,2012-12-21,1,1,12,23,0,5,1,1,0.26,0.2424,0.44,0.2836,1,15,39,390,40,405
17142,2012-12-22,1,1,12,0,0,6,0,1,0.26,0.2121,0.44,0.5821,1,15,30,300,31,315
17143,2012-12-22,1,1,12,1,0,6,0,1,0.26,0.2121,0.44,0.4478,1,15,34,340,35,355
17144,2012-12-22,1,1,12,2,0,6,0,1,0.26,0.2121,0.44,0.5224,0,0,23,230,23,230
17145,2012-12-22,1,1,12,3,0,6,0,1,0.26,0.2121,0.48,0.4478,0,0,7,70,7,70
17146,2012-12-22,1,1,12,4,0,6,0,1,0.26,0.2576,0.48,0.194,3,45,2,20,5,65
17147,2012-12-22,1,1,12,5,0,6,0,1,0.26,0.2273,0.48,0.4179,0,0,5,50,5,50
17148,2012-12-22,1,1,12,6,0,6,0,1,0.26,0.2273,0.44,0.4179,0,0,13,130,13,130
17149,2012-12-22,1,1,12,7,0,6,0,1,0.26,0.2273,0.44,0.4179,2,30,18,180,20,210
17150,2012-12-22,1,1,12,8,0,6,0,1,0.26,0.2121,0.44,0.6119,0,0,29,290,29,290
17151,2012-12-22,1,1,12,9,0,6,0,1,0.26,0.2273,0.48,0.3881,13,195,77,770,90,965
17152,2012-12-22,1,1,12,10,0,6,0,1,0.26,0.2273,0.48,0.3284,13,195,105,1050,118,1245
17153,2012-12-22,1,1,12,11,0,6,0,1,0.28,0.2576,0.41,0.3582,29,435,130,1300,159,1735
17154,2012-12-22,1,1,12,12,0,6,0,1,0.3,0.2576,0.36,0.6567,18,270,128,1280,146,1550
17155,2012-12-22,1,1,12,13,0,6,0,1,0.32,0.2879,0.36,0.4478,23,345,135,1350,158,1695
17156,2012-12-22,1,1,12,14,0,6,0,1,0.32,0.2879,0.36,0.4627,20,300,141,1410,161,1710
17157,2012-12-22,1,1,12,15,0,6,0,1,0.32,0.2727,0.33,0.5821,14,210,139,1390,153,1600
17158,2012-12-22,1,1,12,16,0,6,0,1,0.3,0.2727,0.39,0.4478,23,345,124,1240,147,1585
17159,2012-12-22,1,1,12,17,0,6,0,1,0.28,0.2576,0.41,0.2985,15,225,99,990,114,1215
17160,2012-12-22,1,1,12,18,0,6,0,1,0.26,0.2121,0.44,0.4627,7,105,75,750,82,855
17161,2012-12-22,1,1,12,19,0,6,0,1,0.24,0.2121,0.48,0.3582,9,135,51,510,60,645
17162,2012-12-22,1,1,12,20,0,6,0,1,0.24,0.2424,0.48,0.1642,6,90,55,550,61,640
17163,2012-12-22,1,1,12,21,0,6,0,1,0.22,0.2121,0.51,0.2836,4,60,49,490,53,550
17164,2012-12-22,1,1,12,22,0,6,0,1,0.22,0.2121,0.51,0.2836,1,15,38,380,39,395
17165,2012-12-22,1,1,12,23,0,6,0,1,0.22,0.2273,0.51,0.194,3,45,37,370,40,415
17166,2012-12-23,1,1,12,0,0,0,0,1,0.22,0.2121,0.47,0.2836,3,45,24,240,27,285
17167,2012-12-23,1,1,12,1,0,0,0,1,0.22,0.2273,0.47,0.194,1,15,19,190,20,205
17168,2012-12-23,1,1,12,2,0,0,0,1,0.2,0.2121,0.51,0.1642,1,15,17,170,18,185
17169,2012-12-23,1,1,12,3,0,0,0,1,0.2,0.2121,0.51,0.1343,0,0,9,90,9,90
17170,2012-12-23,1,1,12,4,0,0,0,1,0.2,0.2121,0.47,0.1343,1,15,3,30,4,45
17171,2012-12-23,1,1,12,5,0,0,0,1,0.2,0.2576,0.51,0.0,0,0,6,60,6,60
17172,2012-12-23,1,1,12,6,0,0,0,1,0.16,0.197,0.64,0.0896,4,60,5,50,9,110
17173,2012-12-23,1,1,12,7,0,0,0,1,0.16,0.197,0.64,0.0896,3,45,16,160,19,205
17174,2012-12-23,1,1,12,8,0,0,0,1,0.14,0.1667,0.69,0.1045,5,75,43,430,48,505
17175,2012-12-23,1,1,12,9,0,0,0,1,0.2,0.2273,0.59,0.1045,7,105,49,490,56,595
17176,2012-12-23,1,1,12,10,0,0,0,1,0.22,0.2273,0.64,0.194,26,390,67,670,93,1060
17177,2012-12-23,1,1,12,11,0,0,0,1,0.24,0.2273,0.52,0.194,48,720,104,1040,152,1760
17178,2012-12-23,1,1,12,12,0,0,0,1,0.3,0.2879,0.42,0.194,52,780,144,1440,196,2220
17179,2012-12-23,1,1,12,13,0,0,0,1,0.32,0.303,0.39,0.2239,63,945,123,1230,186,2175
17180,2012-12-23,1,1,12,14,0,0,0,1,0.34,0.303,0.31,0.2985,57,855,118,1180,175,2035
17181,2012-12-23,1,1,12,15,0,0,0,1,0.34,0.3333,0.34,0.1343,39,585,98,980,137,1565
17182,2012-12-23,1,1,12,16,0,0,0,1,0.34,0.3333,0.34,0.194,53,795,137,1370,190,2165
17183,2012-12-23,1,1,12,17,0,0,0,1,0.32,0.3182,0.49,0.194,21,315,93,930,114,1245
17184,2012-12-23,1,1,12,18,0,0,0,1,0.3,0.303,0.45,0.1642,8,120,85,850,93,970
17185,2012-12-23,1,1,12,19,0,0,0,1,0.3,0.3333,0.42,0.0,4,60,54,540,58,600
17186,2012-12-23,1,1,12,20,0,0,0,1,0.26,0.303,0.65,0.0,0,0,52,520,52,520
17187,2012-12-23,1,1,12,21,0,0,0,1,0.24,0.2879,0.7,0.0,4,60,38,380,42,440
17188,2012-12-23,1,1,12,22,0,0,0,1,0.24,0.2576,0.6,0.1045,5,75,53,530,58,605
17189,2012-12-23,1,1,12,23,0,0,0,1,0.24,0.2879,0.6,0.0,3,45,22,220,25,265
17190,2012-12-24,1,1,12,0,0,1,1,1,0.22,0.2727,0.69,0.0,0,0,12,120,12,120
17191,2012-12-24,1,1,12,1,0,1,1,1,0.22,0.2727,0.69,0.0,0,0,11,110,11,110
17192,2012-12-24,1,1,12,2,0,1,1,1,0.2,0.2576,0.75,0.0,0,0,5,50,5,50
17193,2012-12-24,1,1,12,3,0,1,1,1,0.2,0.2576,0.75,0.0,1,15,2,20,3,35
17194,2012-12-24,1,1,12,5,0,1,1,1,0.18,0.197,0.8,0.1343,0,0,9,90,9,90
17195,2012-12-24,1,1,12,6,0,1,1,1,0.2,0.2576,0.75,0.0,1,15,16,160,17,175
17196,2012-12-24,1,1,12,7,0,1,1,1,0.2,0.2576,0.69,0.0,3,45,27,270,30,315
17197,2012-12-24,1,1,12,8,0,1,1,1,0.22,0.2727,0.69,0.0,4,60,62,620,66,680
17198,2012-12-24,1,1,12,9,0,1,1,2,0.24,0.2576,0.65,0.1045,17,255,68,680,85,935
17199,2012-12-24,1,1,12,10,0,1,1,2,0.26,0.303,0.65,0.0,21,315,82,820,103,1135
17200,2012-12-24,1,1,12,11,0,1,1,2,0.26,0.2576,0.6,0.1642,20,300,104,1040,124,1340
17201,2012-12-24,1,1,12,12,0,1,1,2,0.28,0.303,0.56,0.0896,22,330,113,1130,135,1460
17202,2012-12-24,1,1,12,13,0,1,1,3,0.24,0.2576,0.81,0.1045,16,240,54,540,70,780
17203,2012-12-24,1,1,12,14,0,1,1,3,0.24,0.2576,0.87,0.1045,13,195,33,330,46,525
17204,2012-12-24,1,1,12,15,0,1,1,3,0.24,0.2273,0.87,0.2239,6,90,27,270,33,360
17205,2012-12-24,1,1,12,16,0,1,1,3,0.24,0.2273,0.87,0.2239,6,90,27,270,33,360
17206,2012-12-24,1,1,12,17,0,1,1,3,0.24,0.2424,0.93,0.1642,7,105,19,190,26,295
17207,2012-12-24,1,1,12,18,0,1,1,3,0.24,0.2576,0.93,0.1045,6,90,20,200,26,290
17208,2012-12-24,1,1,12,19,0,1,1,2,0.24,0.2424,0.93,0.1343,4,60,14,140,18,200
17209,2012-12-24,1,1,12,20,0,1,1,3,0.24,0.2424,0.93,0.1343,6,90,17,170,23,260
17210,2012-12-24,1,1,12,21,0,1,1,3,0.24,0.2576,0.93,0.0896,13,195,9,90,22,285
17211,2012-12-24,1,1,12,22,0,1,1,2,0.24,0.2879,0.93,0.0,7,105,5,50,12,155
17212,2012-12-24,1,1,12,23,0,1,1,3,0.24,0.2879,0.93,0.0,1,15,10,100,11,115
17213,2012-12-25,1,1,12,0,1,2,0,3,0.24,0.2576,0.93,0.0896,3,45,10,100,13,145
17214,2012-12-25,1,1,12,1,1,2,0,2,0.26,0.2576,0.87,0.1642,0,0,13,130,13,130
17215,2012-12-25,1,1,12,2,1,2,0,2,0.26,0.2576,0.87,0.1642,0,0,7,70,7,70
17216,2012-12-25,1,1,12,4,1,2,0,2,0.24,0.2576,0.87,0.0896,0,0,1,10,1,10
17217,2012-12-25,1,1,12,5,1,2,0,2,0.22,0.2273,0.93,0.1343,2,30,1,10,3,40
17218,2012-12-25,1,1,12,6,1,2,0,2,0.22,0.2273,0.93,0.1343,1,15,6,60,7,75
17219,2012-12-25,1,1,12,7,1,2,0,2,0.22,0.2273,0.93,0.1642,0,0,6,60,6,60
17220,2012-12-25,1,1,12,8,1,2,0,2,0.24,0.2879,0.87,0.0,1,15,10,100,11,115
17221,2012-12-25,1,1,12,9,1,2,0,2,0.24,0.2576,0.87,0.0,7,105,21,210,28,315
17222,2012-12-25,1,1,12,10,1,2,0,1,0.28,0.3182,0.81,0.0,11,165,21,210,32,375
17223,2012-12-25,1,1,12,11,1,2,0,1,0.3,0.3182,0.75,0.0896,43,645,43,430,86,1075
17224,2012-12-25,1,1,12,12,1,2,0,1,0.32,0.3333,0.76,0.0896,62,930,52,520,114,1450
17225,2012-12-25,1,1,12,13,1,2,0,1,0.4,0.4091,0.5,0.3284,75,1125,46,460,121,1585
17226,2012-12-25,1,1,12,14,1,2,0,1,0.38,0.3939,0.46,0.2985,58,870,68,680,126,1550
17227,2012-12-25,1,1,12,15,1,2,0,1,0.36,0.3333,0.5,0.2537,51,765,56,560,107,1325
17228,2012-12-25,1,1,12,16,1,2,0,2,0.36,0.3333,0.5,0.2537,48,720,38,380,86,1100
17229,2012-12-25,1,1,12,17,1,2,0,2,0.32,0.303,0.57,0.2537,16,240,34,340,50,580
17230,2012-12-25,1,1,12,18,1,2,0,2,0.32,0.303,0.66,0.2537,20,300,23,230,43,530
17231,2012-12-25,1,1,12,19,1,2,0,2,0.32,0.303,0.66,0.2239,16,240,20,200,36,440
17232,2012-12-25,1,1,12,20,1,2,0,2,0.32,0.303,0.66,0.2836,11,165,29,290,40,455
17233,2012-12-25,1,1,12,21,1,2,0,2,0.3,0.2879,0.65,0.194,8,120,26,260,34,380
17234,2012-12-25,1,1,12,22,1,2,0,2,0.3,0.303,0.7,0.1642,3,45,16,160,19,205
17235,2012-12-25,1,1,12,23,1,2,0,2,0.28,0.2727,0.65,0.2537,4,60,26,260,30,320
17236,2012-12-26,1,1,12,0,0,3,1,2,0.28,0.2727,0.65,0.2537,1,15,8,80,9,95
17237,2012-12-26,1,1,12,1,0,3,1,2,0.26,0.2273,0.65,0.2985,0,0,7,70,7,70
17238,2012-12-26,1,1,12,2,0,3,1,2,0.26,0.2273,0.65,0.2985,0,0,1,10,1,10
17239,2012-12-26,1,1,12,3,0,3,1,2,0.24,0.2121,0.7,0.3582,0,0,2,20,2,20
17240,2012-12-26,1,1,12,4,0,3,1,1,0.22,0.197,0.69,0.3582,0,0,2,20,2,20
17241,2012-12-26,1,1,12,5,0,3,1,2,0.22,0.2121,0.69,0.2836,0,0,11,110,11,110
17242,2012-12-26,1,1,12,6,0,3,1,2,0.22,0.2121,0.69,0.2239,0,0,36,360,36,360
17243,2012-12-26,1,1,12,7,0,3,1,3,0.2,0.1818,0.86,0.3284,0,0,26,260,26,260
17244,2012-12-26,1,1,12,8,0,3,1,3,0.2,0.1818,0.86,0.3284,0,0,31,310,31,310
17245,2012-12-26,1,1,12,9,0,3,1,3,0.2,0.1818,0.86,0.3284,1,15,22,220,23,235
17246,2012-12-26,1,1,12,10,0,3,1,3,0.2,0.1818,0.86,0.2985,0,0,8,80,8,80
17247,2012-12-26,1,1,12,11,0,3,1,3,0.2,0.1667,0.86,0.4627,0,0,10,100,10,100
17248,2012-12-26,1,1,12,12,0,3,1,3,0.22,0.197,0.87,0.3284,0,0,10,100,10,100
17249,2012-12-26,1,1,12,13,0,3,1,3,0.22,0.197,0.87,0.3284,0,0,15,150,15,150
17250,2012-12-26,1,1,12,14,0,3,1,3,0.22,0.2121,0.93,0.2537,0,0,20,200,20,200
17251,2012-12-26,1,1,12,15,0,3,1,3,0.26,0.2273,0.87,0.3582,0,0,13,130,13,130
17252,2012-12-26,1,1,12,16,0,3,1,3,0.26,0.2273,0.87,0.3582,0,0,13,130,13,130
17253,2012-12-26,1,1,12,17,0,3,1,3,0.26,0.2273,0.93,0.3582,2,30,51,510,53,540
17254,2012-12-26,1,1,12,18,0,3,1,3,0.28,0.2576,0.93,0.2985,1,15,42,420,43,435
17255,2012-12-26,1,1,12,19,0,3,1,3,0.3,0.2879,0.87,0.194,2,30,33,330,35,360
17256,2012-12-26,1,1,12,20,0,3,1,3,0.32,0.303,0.93,0.2537,0,0,32,320,32,320
17257,2012-12-26,1,1,12,21,0,3,1,2,0.3,0.2727,0.87,0.2985,0,0,20,200,20,200
17258,2012-12-26,1,1,12,22,0,3,1,3,0.24,0.197,0.93,0.4478,0,0,11,110,11,110
17259,2012-12-26,1,1,12,23,0,3,1,3,0.26,0.2273,0.87,0.2985,2,30,8,80,10,110
17260,2012-12-27,1,1,12,0,0,4,1,3,0.26,0.2273,0.87,0.2985,0,0,3,30,3,30
17261,2012-12-27,1,1,12,1,0,4,1,3,0.24,0.197,0.93,0.4478,0,0,5,50,5,50
17262,2012-12-27,1,1,12,2,0,4,1,2,0.24,0.197,0.87,0.4478,0,0,2,20,2,20
17263,2012-12-27,1,1,12,3,0,4,1,2,0.24,0.2273,0.87,0.2239,0,0,1,10,1,10
17264,2012-12-27,1,1,12,4,0,4,1,2,0.24,0.2121,0.87,0.3284,0,0,3,30,3,30
17265,2012-12-27,1,1,12,5,0,4,1,1,0.24,0.2424,0.75,0.1642,1,15,10,100,11,115
17266,2012-12-27,1,1,12,6,0,4,1,1,0.24,0.197,0.7,0.4925,0,0,45,450,45,450
17267,2012-12-27,1,1,12,7,0,4,1,1,0.24,0.2273,0.7,0.2239,0,0,90,900,90,900
17268,2012-12-27,1,1,12,8,0,4,1,1,0.26,0.2273,0.65,0.3582,2,30,206,2060,208,2090
17269,2012-12-27,1,1,12,9,0,4,1,1,0.26,0.2121,0.6,0.4925,6,90,127,1270,133,1360
17270,2012-12-27,1,1,12,10,0,4,1,1,0.28,0.2273,0.56,0.5224,8,120,67,670,75,790
17271,2012-12-27,1,1,12,11,0,4,1,2,0.28,0.2424,0.56,0.4478,23,345,80,800,103,1145
17272,2012-12-27,1,1,12,12,0,4,1,1,0.3,0.2727,0.49,0.4627,22,330,87,870,109,1200
17273,2012-12-27,1,1,12,13,0,4,1,1,0.3,0.2727,0.49,0.4627,19,285,99,990,118,1275
17274,2012-12-27,1,1,12,14,0,4,1,2,0.26,0.2121,0.56,0.5224,25,375,94,940,119,1315
17275,2012-12-27,1,1,12,15,0,4,1,2,0.26,0.2121,0.56,0.4478,31,465,89,890,120,1355
17276,2012-12-27,1,1,12,16,0,4,1,2,0.26,0.2424,0.52,0.2836,23,345,151,1510,174,1855
17277,2012-12-27,1,1,12,17,0,4,1,2,0.26,0.2424,0.52,0.2836,30,450,227,2270,257,2720
17278,2012-12-27,1,1,12,18,0,4,1,2,0.24,0.2273,0.6,0.2537,9,135,188,1880,197,2015
17279,2012-12-27,1,1,12,19,0,4,1,1,0.24,0.2121,0.6,0.2836,11,165,106,1060,117,1225
17280,2012-12-27,1,1,12,20,0,4,1,1,0.24,0.2424,0.6,0.1642,12,180,79,790,91,970
17281,2012-12-27,1,1,12,21,0,4,1,2,0.24,0.2273,0.6,0.2537,12,180,51,510,63,690
17282,2012-12-27,1,1,12,22,0,4,1,2,0.24,0.2121,0.6,0.2836,11,165,33,330,44,495
17283,2012-12-27,1,1,12,23,0,4,1,2,0.24,0.2273,0.6,0.2537,2,30,24,240,26,270
17284,2012-12-28,1,1,12,0,0,5,1,2,0.24,0.2424,0.6,0.1642,3,45,22,220,25,265
17285,2012-12-28,1,1,12,1,0,5,1,1,0.24,0.2273,0.6,0.194,0,0,9,90,9,90
17286,2012-12-28,1,1,12,2,0,5,1,1,0.24,0.2273,0.6,0.2537,0,0,5,50,5,50
17287,2012-12-28,1,1,12,3,0,5,1,2,0.24,0.2424,0.6,0.1642,0,0,2,20,2,20
17288,2012-12-28,1,1,12,4,0,5,1,2,0.24,0.2576,0.6,0.1045,0,0,4,40,4,40
17289,2012-12-28,1,1,12,5,0,5,1,2,0.24,0.2576,0.6,0.0896,0,0,15,150,15,150
17290,2012-12-28,1,1,12,6,0,5,1,1,0.22,0.2121,0.64,0.2836,2,30,49,490,51,520
17291,2012-12-28,1,1,12,7,0,5,1,1,0.22,0.2273,0.64,0.1642,1,15,111,1110,112,1125
17292,2012-12-28,1,1,12,8,0,5,1,2,0.24,0.2424,0.6,0.1343,1,15,238,2380,239,2395
17293,2012-12-28,1,1,12,9,0,5,1,2,0.24,0.2121,0.6,0.2836,18,270,173,1730,191,2000
17294,2012-12-28,1,1,12,10,0,5,1,2,0.26,0.2424,0.56,0.2537,77,1155,85,850,162,2005
17295,2012-12-28,1,1,12,11,0,5,1,2,0.28,0.2727,0.52,0.2239,71,1065,107,1070,178,2135
17296,2012-12-28,1,1,12,12,0,5,1,2,0.3,0.303,0.49,0.1343,72,1080,150,1500,222,2580
17297,2012-12-28,1,1,12,13,0,5,1,2,0.3,0.303,0.49,0.1343,76,1140,146,1460,222,2600
17298,2012-12-28,1,1,12,14,0,5,1,2,0.3,0.303,0.49,0.1343,84,1260,177,1770,261,3030
17299,2012-12-28,1,1,12,15,0,5,1,2,0.3,0.3182,0.49,0.0,74,1110,151,1510,225,2620
17300,2012-12-28,1,1,12,16,0,5,1,1,0.3,0.303,0.49,0.1343,42,630,208,2080,250,2710
17301,2012-12-28,1,1,12,17,0,5,1,1,0.24,0.2424,0.6,0.1343,43,645,228,2280,271,2925
17302,2012-12-28,1,1,12,18,0,5,1,1,0.24,0.2424,0.6,0.1343,16,240,197,1970,213,2210
17303,2012-12-28,1,1,12,19,0,5,1,2,0.24,0.2273,0.65,0.194,15,225,113,1130,128,1355
17304,2012-12-28,1,1,12,20,0,5,1,2,0.24,0.2576,0.65,0.1045,14,210,83,830,97,1040
17305,2012-12-28,1,1,12,21,0,5,1,2,0.24,0.2424,0.7,0.1343,17,255,75,750,92,1005
17306,2012-12-28,1,1,12,22,0,5,1,2,0.24,0.2576,0.7,0.0896,13,195,49,490,62,685
17307,2012-12-28,1,1,12,23,0,5,1,2,0.24,0.2576,0.65,0.0896,5,75,54,540,59,615
17308,2012-12-29,1,1,12,0,0,6,0,2,0.24,0.2424,0.7,0.0,1,15,25,250,26,265
17309,2012-12-29,1,1,12,1,0,6,0,2,0.24,0.2424,0.75,0.0896,6,90,31,310,37,400
17310,2012-12-29,1,1,12,2,0,6,0,2,0.24,0.2424,0.7,0.0,1,15,18,180,19,195
17311,2012-12-29,1,1,12,3,0,6,0,2,0.24,0.2424,0.75,0.0,1,15,5,50,6,65
17312,2012-12-29,1,1,12,4,0,6,0,2,0.24,0.2424,0.75,0.0896,0,0,3,30,3,30
17313,2012-12-29,1,1,12,5,0,6,0,2,0.24,0.2424,0.75,0.0896,0,0,3,30,3,30
17314,2012-12-29,1,1,12,6,0,6,0,2,0.26,0.2424,0.7,0.1045,0,0,7,70,7,70
17315,2012-12-29,1,1,12,7,0,6,0,2,0.26,0.2424,0.7,0.1343,1,15,17,170,18,185
17316,2012-12-29,1,1,12,8,0,6,0,2,0.26,0.2424,0.81,0.0,9,135,35,350,44,485
17317,2012-12-29,1,1,12,9,0,6,0,2,0.26,0.2424,0.81,0.0,16,240,33,330,49,570
17318,2012-12-29,1,1,12,10,0,6,0,3,0.26,0.2424,0.81,0.1343,6,90,35,350,41,440
17319,2012-12-29,1,1,12,11,0,6,0,3,0.2,0.2424,0.93,0.0896,7,105,38,380,45,485
17320,2012-12-29,1,1,12,12,0,6,0,3,0.2,0.2424,1.0,0.0,5,75,43,430,48,505
17321,2012-12-29,1,1,12,13,0,6,0,3,0.2,0.2424,1.0,0.0,13,195,71,710,84,905
17322,2012-12-29,1,1,12,14,0,6,0,2,0.24,0.2424,0.87,0.0896,10,150,88,880,98,1030
17323,2012-12-29,1,1,12,15,0,6,0,2,0.24,0.2424,0.87,0.0,19,285,110,1100,129,1385
17324,2012-12-29,1,1,12,16,0,6,0,1,0.3,0.2424,0.75,0.1045,22,330,125,1250,147,1580
17325,2012-12-29,1,1,12,17,0,6,0,1,0.26,0.2424,0.79,0.1045,18,270,100,1000,118,1270
17326,2012-12-29,1,1,12,18,0,6,0,1,0.3,0.2424,0.7,0.194,8,120,102,1020,110,1140
17327,2012-12-29,1,1,12,19,0,6,0,2,0.3,0.2424,0.61,0.2537,7,105,90,900,97,1005
17328,2012-12-29,1,1,12,20,0,6,0,2,0.3,0.2424,0.56,0.5522,2,30,64,640,66,670
17329,2012-12-29,1,1,12,21,0,6,0,2,0.28,0.2424,0.56,0.4925,4,60,56,560,60,620
17330,2012-12-29,1,1,12,22,0,6,0,2,0.26,0.2424,0.6,0.4627,3,45,51,510,54,555
17331,2012-12-29,1,1,12,23,0,6,0,2,0.26,0.2424,0.6,0.0,0,0,32,320,32,320
17332,2012-12-30,1,1,12,0,0,0,0,2,0.26,0.2576,0.6,0.1642,0,0,41,410,41,410
17333,2012-12-30,1,1,12,1,0,0,0,2,0.26,0.2273,0.56,0.4179,1,15,27,270,28,285
17334,2012-12-30,1,1,12,2,0,0,0,2,0.26,0.2424,0.56,0.2836,0,0,19,190,19,190
17335,2012-12-30,1,1,12,3,0,0,0,2,0.26,0.2273,0.56,0.4179,1,15,14,140,15,155
17336,2012-12-30,1,1,12,4,0,0,0,2,0.26,0.2576,0.56,0.2239,0,0,7,70,7,70
17337,2012-12-30,1,1,12,5,0,0,0,2,0.26,0.2273,0.48,0.2985,0,0,2,20,2,20
17338,2012-12-30,1,1,12,6,0,0,0,2,0.24,0.197,0.52,0.4179,1,15,7,70,8,85
17339,2012-12-30,1,1,12,7,0,0,0,1,0.24,0.2121,0.56,0.3582,0,0,13,130,13,130
17340,2012-12-30,1,1,12,8,0,0,0,1,0.24,0.197,0.52,0.4627,1,15,32,320,33,335
17341,2012-12-30,1,1,12,9,0,0,0,1,0.24,0.2121,0.52,0.3881,9,135,65,650,74,785
17342,2012-12-30,1,1,12,10,0,0,0,1,0.26,0.2121,0.41,0.5821,31,465,91,910,122,1375
17343,2012-12-30,1,1,12,11,0,0,0,1,0.26,0.2273,0.41,0.4179,33,495,103,1030,136,1525
17344,2012-12-30,1,1,12,12,0,0,0,1,0.28,0.2273,0.36,0.5821,47,705,97,970,144,1675
17345,2012-12-30,1,1,12,13,0,0,0,1,0.3,0.2576,0.36,0.6567,49,735,120,1200,169,1935
17346,2012-12-30,1,1,12,14,0,0,0,1,0.3,0.2727,0.36,0.4627,39,585,121,1210,160,1795
17347,2012-12-30,1,1,12,15,0,0,0,1,0.28,0.2576,0.38,0.3284,37,555,101,1010,138,1565
17348,2012-12-30,1,1,12,16,0,0,0,1,0.28,0.2424,0.38,0.4179,31,465,102,1020,133,1485
17349,2012-12-30,1,1,12,17,0,0,0,1,0.26,0.2273,0.41,0.3284,26,390,97,970,123,1360
17350,2012-12-30,1,1,12,18,0,0,0,2,0.24,0.2121,0.44,0.2985,12,180,113,1130,125,1310
17351,2012-12-30,1,1,12,19,0,0,0,1,0.34,0.3636,0.61,0.0,16,240,86,860,102,1100
17352,2012-12-30,1,1,12,20,0,0,0,1,0.22,0.197,0.47,0.3284,9,135,63,630,72,765
17353,2012-12-30,1,1,12,21,0,0,0,1,0.2,0.2121,0.51,0.1642,5,75,42,420,47,495
17354,2012-12-30,1,1,12,22,0,0,0,1,0.2,0.197,0.55,0.194,6,90,30,300,36,390
17355,2012-12-30,1,1,12,23,0,0,0,1,0.2,0.197,0.51,0.2239,10,150,39,390,49,540
17356,2012-12-31,1,1,12,0,0,1,1,1,0.18,0.1818,0.55,0.194,4,60,30,300,34,360
17357,2012-12-31,1,1,12,1,0,1,1,1,0.18,0.1818,0.55,0.194,6,90,13,130,19,220
17358,2012-12-31,1,1,12,2,0,1,1,1,0.16,0.1667,0.59,0.1642,3,45,8,80,11,125
17359,2012-12-31,1,1,12,3,0,1,1,1,0.16,0.1818,0.59,0.1045,0,0,1,10,1,10
17360,2012-12-31,1,1,12,4,0,1,1,1,0.14,0.1667,0.69,0.1045,0,0,3,30,3,30
17361,2012-12-31,1,1,12,5,0,1,1,1,0.16,0.1515,0.64,0.194,0,0,9,90,9,90
17362,2012-12-31,1,1,12,6,0,1,1,1,0.16,0.1667,0.64,0.1642,0,0,40,400,40,400
17363,2012-12-31,1,1,12,7,0,1,1,1,0.16,0.1818,0.64,0.1343,2,30,83,830,85,860
17364,2012-12-31,1,1,12,8,0,1,1,1,0.14,0.1515,0.69,0.1343,9,135,187,1870,196,2005
17365,2012-12-31,1,1,12,9,0,1,1,2,0.18,0.2121,0.64,0.1045,13,195,144,1440,157,1635
17366,2012-12-31,1,1,12,10,0,1,1,2,0.2,0.2121,0.69,0.1343,33,495,87,870,120,1365
17367,2012-12-31,1,1,12,11,0,1,1,2,0.22,0.2273,0.6,0.194,43,645,114,1140,157,1785
17368,2012-12-31,1,1,12,12,0,1,1,2,0.24,0.2273,0.56,0.194,52,780,172,1720,224,2500
17369,2012-12-31,1,1,12,13,0,1,1,2,0.26,0.2576,0.44,0.1642,38,570,165,1650,203,2220
17370,2012-12-31,1,1,12,14,0,1,1,2,0.28,0.2727,0.45,0.2239,62,930,185,1850,247,2780
17371,2012-12-31,1,1,12,15,0,1,1,2,0.28,0.2879,0.45,0.1343,69,1035,246,2460,315,3495
17372,2012-12-31,1,1,12,16,0,1,1,2,0.26,0.2576,0.48,0.194,30,450,184,1840,214,2290
17373,2012-12-31,1,1,12,17,0,1,1,2,0.26,0.2879,0.48,0.0896,14,210,150,1500,164,1710
17374,2012-12-31,1,1,12,18,0,1,1,2,0.26,0.2727,0.48,0.1343,10,150,112,1120,122,1270
17375,2012-12-31,1,1,12,19,0,1,1,2,0.26,0.2576,0.6,0.1642,11,165,108,1080,119,1245
17376,2012-12-31,1,1,12,20,0,1,1,2,0.26,0.2576,0.6,0.1642,8,120,81,810,89,930
17377,2012-12-31,1,1,12,21,0,1,1,1,0.26,0.2576,0.6,0.1642,7,105,83,830,90,935
17378,2012-12-31,1,1,12,22,0,1,1,1,0.26,0.2727,0.56,0.1343,13,195,48,480,61,675
17379,2012-12-31,1,1,12,23,0,1,1,1,0.26,0.2727,0.65,0.1343,12,180,37,370,49,550
